Region,LOCALITY,FIPS,HOUSEHOLDS PA,HOUSEHOLDS NPA,HOUSEHOLDS TOTAL,PERSONS PA,PERSONS NPA,PERSONS TOTAL,ISSUANCE AMOUNT PA,ISSUANCE AMOUNT NPA,ISSUANCE AMOUNT TOTAL,Year-Month,PA Avg# Per Household,NPA Avg# Per Household,All SNAP Avg# Per Household
Central,Amelia County,51007,131,554,685,163,1153,1316,36192,244758,280950,03/01/2021 12:00:00 AM,276,442,410
Central,Amelia County,51007,133,540,673,148,1187,1335,11302,131799,143101,06/01/2019 12:00:00 AM,85,244,213
Central,Amelia County,51007,133,559,692,162,1177,1339,38021,258358.42,296379.42,02/01/2021 12:00:00 AM,286,462,428
Central,Amelia County,51007,134,536,670,151,1166,1317,12326,129421,141747,07/01/2019 12:00:00 AM,92,241,212
Central,Amelia County,51007,135,497,632,161,1043,1204,13886,118946,132832,01/01/2020 12:00:00 AM,103,239,210
Central,Amelia County,51007,136,529,665,173,1076,1249,40413,239603,280016,06/01/2021 12:00:00 AM,297,453,421
Central,Amelia County,51007,136,538,674,151,1190,1341,12217,131792,144009,05/01/2019 12:00:00 AM,90,245,214
Central,Amelia County,51007,137,521,658,159,1117,1276,13625,127323,140948,10/01/2019 12:00:00 AM,99,244,214
Central,Amelia County,51007,137,530,667,159,1135,1294,13391,127840,141231,09/01/2019 12:00:00 AM,98,241,212
Central,Amelia County,51007,137,543,680,158,1164,1322,13444,130344,143788,08/01/2019 12:00:00 AM,98,240,211
Central,Amelia County,51007,138,489,627,165,1029,1194,14518,115375,129893,02/01/2020 12:00:00 AM,105,236,207
Central,Amelia County,51007,138,508,646,167,1084,1251,15305,122918,138223,12/01/2019 12:00:00 AM,111,242,214
Central,Amelia County,51007,138,510,648,164,1051,1215,30268,181146,211414,03/01/2020 12:00:00 AM,219,355,326
Central,Amelia County,51007,138,530,668,179,1081,1260,41849,244069,285918,05/01/2021 12:00:00 AM,303,461,428
Central,Amelia County,51007,139,514,653,169,1091,1260,15013,120933,135946,11/01/2019 12:00:00 AM,108,235,208
Central,Amelia County,51007,139,534,673,179,1108,1287,42161,252267,294428,04/01/2021 12:00:00 AM,303,472,437
Central,Amelia County,51007,139,548,687,179,1150,1329,33904,210749,244653,11/01/2020 12:00:00 AM,244,385,356
Central,Amelia County,51007,139,555,694,167,1174,1341,31164,201598,232762,05/01/2020 12:00:00 AM,224,363,335
Central,Amelia County,51007,139,564,703,166,1198,1364,31035,208319,239354,06/01/2020 12:00:00 AM,223,369,340
Central,Amelia County,51007,141,545,686,181,1146,1327,41044,238041,279085,01/01/2021 12:00:00 AM,291,437,407
Central,Amelia County,51007,141,551,692,181,1151,1332,35295,212299,247594,12/01/2020 12:00:00 AM,250,385,358
Central,Amelia County,51007,141,576,717,164,1294,1458,13536,146210,159746,04/01/2018 12:00:00 AM,96,254,223
Central,Amelia County,51007,141,583,724,175,1236,1411,33171,213811,246982,08/01/2020 12:00:00 AM,235,367,341
Central,Amelia County,51007,141,656,797,178,1466,1644,16484,161919,178403,09/01/2015 12:00:00 AM,117,247,224
Central,Amelia County,51007,141,676,817,178,1499,1677,16047,169320,185367,07/01/2015 12:00:00 AM,114,250,227
Central,Amelia County,51007,142,538,680,170,1154,1324,32222,197513,229735,04/01/2020 12:00:00 AM,227,367,338
Central,Amelia County,51007,142,580,722,176,1228,1404,32656,209325,241981,07/01/2020 12:00:00 AM,230,361,335
Central,Amelia County,51007,142,666,808,181,1489,1670,16877,169109,185986,08/01/2015 12:00:00 AM,119,254,230
Central,Amelia County,51007,142,669,811,199,1471,1670,17089,167205,184294,03/01/2015 12:00:00 AM,120,250,227
Central,Amelia County,51007,143,552,695,167,1235,1402,14143,132889,147032,03/01/2019 12:00:00 AM,99,241,212
Central,Amelia County,51007,143,563,706,164,1270,1434,12802,142021,154823,05/01/2018 12:00:00 AM,90,252,219
Central,Amelia County,51007,143,653,796,172,1452,1624,14845,164675,179520,03/01/2016 12:00:00 AM,104,252,226
Central,Amelia County,51007,143,658,801,175,1451,1626,14535,164235,178770,02/01/2016 12:00:00 AM,102,250,223
Central,Amelia County,51007,143,716,859,198,1585,1783,18198,185258,203456,12/01/2014 12:00:00 AM,127,259,237
Central,Amelia County,51007,143,724,867,200,1589,1789,18191,186602,204793,11/01/2014 12:00:00 AM,127,258,236
Central,Amelia County,51007,144,543,687,169,1164,1333,14159,126765,140924,02/01/2019 12:00:00 AM,98,233,205
Central,Amelia County,51007,144,543,687,170,1191,1361,14531,130598,145129,04/01/2019 12:00:00 AM,101,241,211
Central,Amelia County,51007,144,551,695,184,1148,1332,36094,212863,248957,10/01/2020 12:00:00 AM,251,386,358
Central,Amelia County,51007,144,642,786,177,1423,1600,15216,159580,174796,11/01/2015 12:00:00 AM,106,249,222
Central,Amelia County,51007,144,655,799,174,1459,1633,14024,163309,177333,01/01/2016 12:00:00 AM,97,249,222
Central,Amelia County,51007,144,670,814,184,1493,1677,15837,169987,185824,05/01/2015 12:00:00 AM,110,254,228
Central,Amelia County,51007,144,675,819,190,1494,1684,16158,172963,189121,04/01/2015 12:00:00 AM,112,256,231
Central,Amelia County,51007,144,692,836,202,1531,1733,18452,173577,192029,01/01/2015 12:00:00 AM,128,251,230
Central,Amelia County,51007,145,572,717,167,1281,1448,13161,139949,153110,03/01/2018 12:00:00 AM,91,245,214
Central,Amelia County,51007,145,655,800,189,1458,1647,16860,161805,178665,10/01/2015 12:00:00 AM,116,247,223
Central,Amelia County,51007,145,663,808,202,1464,1666,17896,167914,185810,02/01/2015 12:00:00 AM,123,253,230
Central,Amelia County,51007,146,569,715,167,1276,1443,12862,144466,157328,02/01/2018 12:00:00 AM,88,254,220
Central,Amelia County,51007,146,650,796,181,1439,1620,15404,162259,177663,12/01/2015 12:00:00 AM,106,250,223
Central,Amelia County,51007,146,676,822,185,1512,1697,16032,171096,187128,06/01/2015 12:00:00 AM,110,253,228
Central,Amelia County,51007,146,749,895,204,1642,1846,18535,193157,211692,10/01/2014 12:00:00 AM,127,258,237
Central,Amelia County,51007,148,564,712,184,1200,1384,33938,203123,237061,09/01/2020 12:00:00 AM,229,360,333
Central,Amelia County,51007,148,577,725,172,1297,1469,14090,151056,165146,09/01/2017 12:00:00 AM,95,262,228
Central,Amelia County,51007,148,643,791,182,1426,1608,15328,159281,174609,05/01/2016 12:00:00 AM,104,248,221
Central,Amelia County,51007,148,772,920,225,1632,1857,19003,186441,205444,07/01/2014 12:00:00 AM,128,242,223
Central,Amelia County,51007,149,575,724,175,1269,1444,16082,143797,159879,01/01/2019 12:00:00 AM,108,250,221
Central,Amelia County,51007,149,578,727,176,1273,1449,15023,144745,159768,06/01/2018 12:00:00 AM,101,250,220
Central,Amelia County,51007,149,659,808,181,1465,1646,15207,166978,182185,04/01/2016 12:00:00 AM,102,253,225
Central,Amelia County,51007,149,758,907,216,1617,1833,18029,186280,204309,08/01/2014 12:00:00 AM,121,246,225
Central,Amelia County,51007,149,785,934,225,1642,1867,19748,189101,208849,06/01/2014 12:00:00 AM,133,241,224
Central,Amelia County,51007,150,570,720,173,1258,1431,13407,141979,155386,01/01/2018 12:00:00 AM,89,249,216
Central,Amelia County,51007,151,548,699,184,1189,1373,18476,154115,172591,10/01/2018 12:00:00 AM,122,281,247
Central,Amelia County,51007,151,561,712,180,1229,1409,16235,136213,152448,12/01/2018 12:00:00 AM,108,243,214
Central,Amelia County,51007,151,564,715,177,1220,1397,15157,141084,156241,09/01/2018 12:00:00 AM,100,250,219
Central,Amelia County,51007,151,629,780,189,1394,1583,16948,154942,171890,06/01/2016 12:00:00 AM,112,246,220
Central,Amelia County,51007,152,564,716,177,1240,1417,15443,144492,159935,08/01/2018 12:00:00 AM,102,256,223
Central,Amelia County,51007,152,571,723,178,1280,1458,15719,144264,159983,07/01/2018 12:00:00 AM,103,253,221
Central,Amelia County,51007,152,576,728,176,1282,1458,14968,148015,162983,12/01/2017 12:00:00 AM,98,257,224
Central,Amelia County,51007,152,582,734,176,1297,1473,14815,154676,169491,08/01/2017 12:00:00 AM,97,266,231
Central,Amelia County,51007,152,585,737,177,1297,1474,14906,147683,162589,11/01/2017 12:00:00 AM,98,252,221
Central,Amelia County,51007,152,622,774,190,1402,1592,17486,159355,176841,07/01/2016 12:00:00 AM,115,256,228
Central,Amelia County,51007,152,750,902,220,1630,1850,18137,184558,202695,09/01/2014 12:00:00 AM,119,246,225
Central,Amelia County,51007,152,795,947,225,1668,1893,19969,190836,210805,05/01/2014 12:00:00 AM,131,240,223
Central,Amelia County,51007,153,548,701,185,1195,1380,16796,132352,149148,11/01/2018 12:00:00 AM,110,242,213
Central,Amelia County,51007,153,584,737,180,1297,1477,15373,150898,166271,06/01/2017 12:00:00 AM,100,258,226
Central,Amelia County,51007,154,580,734,185,1297,1482,16016,148633,164649,10/01/2017 12:00:00 AM,104,256,224
Central,Amelia County,51007,155,629,784,195,1402,1597,18453,156034,174487,09/01/2016 12:00:00 AM,119,248,223
Central,Amelia County,51007,156,570,726,184,1262,1446,15429,149042,164471,07/01/2017 12:00:00 AM,99,261,227
Central,Amelia County,51007,157,796,953,240,1654,1894,21617,189417,211034,04/01/2014 12:00:00 AM,138,238,221
Central,Amelia County,51007,157,839,996,250,1766,2016,27209,218024,245233,10/01/2013 12:00:00 AM,173,260,246
Central,Amelia County,51007,158,621,779,203,1380,1583,19042,153808,172850,08/01/2016 12:00:00 AM,121,248,222
Central,Amelia County,51007,160,579,739,193,1279,1472,17921,147267,165188,05/01/2017 12:00:00 AM,112,254,224
Central,Amelia County,51007,160,803,963,253,1665,1918,23984,192384,216368,03/01/2014 12:00:00 AM,150,240,225
Central,Amelia County,51007,160,824,984,258,1726,1984,26195,196164,222359,11/01/2013 12:00:00 AM,164,238,226
Central,Amelia County,51007,161,583,744,194,1289,1483,17001,147166,164167,04/01/2017 12:00:00 AM,106,252,221
Central,Amelia County,51007,162,630,792,206,1416,1622,19671,157578,177249,10/01/2016 12:00:00 AM,121,250,224
Central,Amelia County,51007,162,799,961,262,1659,1921,25300,186849,212149,01/01/2014 12:00:00 AM,156,234,221
Central,Amelia County,51007,162,802,964,258,1672,1930,24521,190861,215382,02/01/2014 12:00:00 AM,151,238,223
Central,Amelia County,51007,163,598,761,198,1362,1560,17118,151371,168489,02/01/2017 12:00:00 AM,105,253,221
Central,Amelia County,51007,164,596,760,198,1329,1527,16940,153880,170820,03/01/2017 12:00:00 AM,103,258,225
Central,Amelia County,51007,164,814,978,256,1714,1970,24049,195128,219177,12/01/2013 12:00:00 AM,147,240,224
Central,Amelia County,51007,164,814,978,273,1759,2032,30119,219383,249502,08/01/2013 12:00:00 AM,184,270,255
Central,Amelia County,51007,165,798,963,261,1730,1991,29832,222512,252344,02/01/2013 12:00:00 AM,181,279,262
Central,Amelia County,51007,165,804,969,262,1738,2000,29176,222527,251703,03/01/2013 12:00:00 AM,177,277,260
Central,Amelia County,51007,165,820,985,270,1769,2039,27796,220272,248068,06/01/2013 12:00:00 AM,168,269,252
Central,Amelia County,51007,165,843,1008,269,1782,2051,29427,218315,247742,09/01/2013 12:00:00 AM,178,259,246
Central,Amelia County,51007,166,609,775,211,1401,1612,19448,155243,174691,11/01/2016 12:00:00 AM,117,255,225
Central,Amelia County,51007,166,612,778,208,1385,1593,18389,152386,170775,12/01/2016 12:00:00 AM,111,249,220
Central,Amelia County,51007,166,797,963,261,1730,1991,29003,220066,249069,01/01/2013 12:00:00 AM,175,276,259
Central,Amelia County,51007,166,802,968,273,1722,1995,29780,217069,246849,04/01/2013 12:00:00 AM,179,271,255
Central,Amelia County,51007,166,814,980,277,1761,2038,29604,216568,246172,07/01/2013 12:00:00 AM,178,266,251
Central,Amelia County,51007,167,600,767,204,1359,1563,17061,147203,164264,01/01/2017 12:00:00 AM,102,245,214
Central,Amelia County,51007,167,791,958,261,1739,2000,30049,222761,252810,12/01/2012 12:00:00 AM,180,282,264
Central,Amelia County,51007,167,811,978,278,1740,2018,29092,219320,248412,05/01/2013 12:00:00 AM,174,270,254
Central,Amelia County,51007,173,804,977,281,1780,2061,31839,227385,259224,11/01/2012 12:00:00 AM,184,283,265
Central,Amelia County,51007,176,812,988,285,1803,2088,32251,229560,261811,10/01/2012 12:00:00 AM,183,283,265
Central,Amelia County,51007,178,824,1002,284,1836,2120,32504,237423,269927,04/01/2012 12:00:00 AM,183,288,269
Central,Amelia County,51007,180,821,1001,289,1799,2088,33667,231992,265659,05/01/2012 12:00:00 AM,187,283,265
Central,Amelia County,51007,180,835,1015,292,1868,2160,33368,241859,275227,03/01/2012 12:00:00 AM,185,290,271
Central,Amelia County,51007,184,828,1012,315,1831,2146,37716,234861,272577,01/01/2012 12:00:00 AM,205,284,269
Central,Amelia County,51007,185,797,982,309,1755,2064,36462,226845,263307,09/01/2012 12:00:00 AM,197,285,268
Central,Amelia County,51007,185,818,1003,312,1791,2103,37841,228443,266284,06/01/2012 12:00:00 AM,205,279,265
Central,Amelia County,51007,186,814,1000,309,1778,2087,37359,229488,266847,08/01/2012 12:00:00 AM,201,282,267
Central,Amelia County,51007,187,818,1005,304,1789,2093,36602,232495,269097,07/01/2012 12:00:00 AM,196,284,268
Central,Amelia County,51007,187,820,1007,325,1809,2134,39088,235399,274487,02/01/2012 12:00:00 AM,209,287,273
Central,Buckingham County,51029,235,1081,1316,266,2293,2559,64419,514716,579135,04/01/2021 12:00:00 AM,274,476,440
Central,Buckingham County,51029,236,1070,1306,270,2255,2525,64277,525306,589583,05/01/2021 12:00:00 AM,272,491,451
Central,Buckingham County,51029,236,964,1200,285,2065,2350,24979,232762,257741,02/01/2020 12:00:00 AM,106,241,215
Central,Buckingham County,51029,237,1064,1301,282,2319,2601,28509,285483,313992,12/01/2017 12:00:00 AM,120,268,241
Central,Buckingham County,51029,237,1067,1304,271,2222,2493,67559,500074,567633,06/01/2021 12:00:00 AM,285,469,435
Central,Buckingham County,51029,237,987,1224,292,2108,2400,26611,248234,274845,01/01/2020 12:00:00 AM,112,252,225
Central,Buckingham County,51029,238,1085,1323,271,2306,2577,61596,491825.53,553421.53,02/01/2021 12:00:00 AM,259,453,418
Central,Buckingham County,51029,238,999,1237,291,2167,2458,27264,253238,280502,07/01/2019 12:00:00 AM,115,253,227
Central,Buckingham County,51029,239,1053,1292,290,2290,2580,28811,279993,308804,02/01/2018 12:00:00 AM,121,266,239
Central,Buckingham County,51029,239,1072,1311,286,2292,2578,53842,391706,445548,04/01/2020 12:00:00 AM,225,365,340
Central,Buckingham County,51029,239,994,1233,301,2175,2476,30286,260673,290959,12/01/2018 12:00:00 AM,127,262,236
Central,Buckingham County,51029,240,1017,1257,291,2168,2459,54088,370600,424688,03/01/2020 12:00:00 AM,225,364,338
Central,Buckingham County,51029,240,1020,1260,290,2207,2497,28414,263355,291769,04/01/2018 12:00:00 AM,118,258,232
Central,Buckingham County,51029,240,1020,1260,292,2198,2490,28278,258928,287206,08/01/2019 12:00:00 AM,118,254,228
Central,Buckingham County,51029,240,1039,1279,293,2245,2538,29792,271329,301121,01/01/2018 12:00:00 AM,124,261,235
Central,Buckingham County,51029,240,1076,1316,273,2274,2547,63259.15,473354,536613.15,03/01/2021 12:00:00 AM,264,440,408
Central,Buckingham County,51029,240,990,1230,291,2090,2381,27145,240775,267920,09/01/2019 12:00:00 AM,113,243,218
Central,Buckingham County,51029,241,1035,1276,295,2232,2527,30017,271374,301391,03/01/2018 12:00:00 AM,125,262,236
Central,Buckingham County,51029,241,986,1227,298,2106,2404,27736,244432,272168,11/01/2019 12:00:00 AM,115,248,222
Central,Buckingham County,51029,242,1005,1247,302,2150,2452,28830,250866,279696,03/01/2019 12:00:00 AM,119,250,224
Central,Buckingham County,51029,242,1054,1296,291,2326,2617,30333,278137,308470,11/01/2017 12:00:00 AM,125,264,238
Central,Buckingham County,51029,242,976,1218,301,2093,2394,29537,249132,278669,02/01/2019 12:00:00 AM,122,255,229
Central,Buckingham County,51029,242,988,1230,306,2132,2438,30159,264251,294410,01/01/2019 12:00:00 AM,125,267,239
Central,Buckingham County,51029,243,988,1231,297,2108,2405,28517,246249,274766,12/01/2019 12:00:00 AM,117,249,223
Central,Buckingham County,51029,244,1003,1247,309,2153,2462,29918,253216,283134,04/01/2019 12:00:00 AM,123,252,227
Central,Buckingham County,51029,244,995,1239,305,2155,2460,28745,252165,280910,06/01/2019 12:00:00 AM,118,253,227
Central,Buckingham County,51029,244,997,1241,302,2116,2418,28303,245110,273413,10/01/2019 12:00:00 AM,116,246,220
Central,Buckingham County,51029,245,1005,1250,292,2190,2482,28867,262237,291104,09/01/2018 12:00:00 AM,118,261,233
Central,Buckingham County,51029,245,1013,1258,297,2190,2487,31731,282980,314711,10/01/2018 12:00:00 AM,130,279,250
Central,Buckingham County,51029,245,1095,1340,296,2346,2642,55236,405502,460738,05/01/2020 12:00:00 AM,225,370,344
Central,Buckingham County,51029,245,1098,1343,283,2333,2616,64464,493468,557932,01/01/2021 12:00:00 AM,263,449,415
Central,Buckingham County,51029,246,1016,1262,303,2213,2516,31407,265603,297010,11/01/2018 12:00:00 AM,128,261,235
Central,Buckingham County,51029,246,1024,1270,299,2216,2515,29530,265558,295088,05/01/2018 12:00:00 AM,120,259,232
Central,Buckingham County,51029,246,1093,1339,291,2340,2631,57189,435561,492750,11/01/2020 12:00:00 AM,232,399,368
Central,Buckingham County,51029,246,1107,1353,284,2375,2659,56163,426698,482861,12/01/2020 12:00:00 AM,228,385,357
Central,Buckingham County,51029,247,1032,1279,302,2254,2556,29940,276471,306411,05/01/2017 12:00:00 AM,121,268,240
Central,Buckingham County,51029,247,1108,1355,296,2343,2639,55635,404929,460564,06/01/2020 12:00:00 AM,225,365,340
Central,Buckingham County,51029,248,1103,1351,295,2348,2643,58571,423499,482070,10/01/2020 12:00:00 AM,236,384,357
Central,Buckingham County,51029,248,990,1238,321,2130,2451,31823,249007,280830,05/01/2019 12:00:00 AM,128,252,227
Central,Buckingham County,51029,249,1023,1272,304,2213,2517,30864,270874,301738,08/01/2018 12:00:00 AM,124,265,237
Central,Buckingham County,51029,249,1029,1278,305,2222,2527,30334,272877,303211,06/01/2018 12:00:00 AM,122,265,237
Central,Buckingham County,51029,250,1051,1301,301,2300,2601,30505,279864,310369,10/01/2017 12:00:00 AM,122,266,239
Central,Buckingham County,51029,250,1068,1318,304,2355,2659,30394,291530,321924,09/01/2017 12:00:00 AM,122,273,244
Central,Buckingham County,51029,251,1121,1372,303,2388,2691,57051,408412,465463,08/01/2020 12:00:00 AM,227,364,339
Central,Buckingham County,51029,251,1134,1385,298,2415,2713,55511,419846,475357,09/01/2020 12:00:00 AM,221,370,343
Central,Buckingham County,51029,252,1008,1260,306,2164,2470,30972,262659,293631,07/01/2018 12:00:00 AM,123,261,233
Central,Buckingham County,51029,252,1034,1286,309,2259,2568,29716,280477,310193,06/01/2017 12:00:00 AM,118,271,241
Central,Buckingham County,51029,252,1038,1290,316,2255,2571,30622,278229,308851,07/01/2017 12:00:00 AM,122,268,239
Central,Buckingham County,51029,252,1103,1355,325,2467,2792,30675,289237,319912,11/01/2016 12:00:00 AM,122,262,236
Central,Buckingham County,51029,252,1138,1390,300,2404,2704,57119,420459,477578,07/01/2020 12:00:00 AM,227,369,344
Central,Buckingham County,51029,253,1065,1318,309,2330,2639,29789,289619,319408,04/01/2017 12:00:00 AM,118,272,242
Central,Buckingham County,51029,253,1102,1355,329,2428,2757,31308,284858,316166,10/01/2016 12:00:00 AM,124,258,233
Central,Buckingham County,51029,255,1052,1307,315,2303,2618,30548,282450,312998,08/01/2017 12:00:00 AM,120,268,239
Central,Buckingham County,51029,257,1054,1311,313,2288,2601,29560,281079,310639,03/01/2017 12:00:00 AM,115,267,237
Central,Buckingham County,51029,259,1077,1336,339,2406,2745,33286,283033,316319,07/01/2016 12:00:00 AM,129,263,237
Central,Buckingham County,51029,261,1090,1351,344,2421,2765,33277,281743,315020,09/01/2016 12:00:00 AM,127,258,233
Central,Buckingham County,51029,262,1076,1338,361,2412,2773,35665,279157,314822,06/01/2016 12:00:00 AM,136,259,235
Central,Buckingham County,51029,262,1090,1352,344,2412,2756,33278,280869,314147,08/01/2016 12:00:00 AM,127,258,232
Central,Buckingham County,51029,262,1095,1357,336,2437,2773,31598,285432,317030,12/01/2016 12:00:00 AM,121,261,234
Central,Buckingham County,51029,264,1097,1361,333,2429,2762,30128,288414,318542,01/01/2017 12:00:00 AM,114,263,234
Central,Buckingham County,51029,266,1096,1362,335,2444,2779,31279,289824,321103,02/01/2017 12:00:00 AM,118,264,236
Central,Buckingham County,51029,268,1117,1385,375,2518,2893,35657,292090,327747,10/01/2015 12:00:00 AM,133,261,237
Central,Buckingham County,51029,269,1081,1350,371,2453,2824,36102,284929,321031,05/01/2016 12:00:00 AM,134,264,238
Central,Buckingham County,51029,269,1116,1385,366,2500,2866,35975,287254,323229,12/01/2015 12:00:00 AM,134,257,233
Central,Buckingham County,51029,270,1098,1368,376,2488,2864,37299,286730,324029,04/01/2016 12:00:00 AM,138,261,237
Central,Buckingham County,51029,270,1111,1381,376,2519,2895,36638,294593,331231,08/01/2015 12:00:00 AM,136,265,240
Central,Buckingham County,51029,270,1166,1436,368,2622,2990,36691,301853,338544,04/01/2015 12:00:00 AM,136,259,236
Central,Buckingham County,51029,271,1108,1379,376,2491,2867,36821,284952,321773,11/01/2015 12:00:00 AM,136,257,233
Central,Buckingham County,51029,271,1125,1396,375,2525,2900,36643,294826,331469,05/01/2015 12:00:00 AM,135,262,237
Central,Buckingham County,51029,272,1097,1369,376,2471,2847,37663,282985,320648,01/01/2016 12:00:00 AM,138,258,234
Central,Buckingham County,51029,272,1122,1394,382,2520,2902,36979,295440,332419,07/01/2015 12:00:00 AM,136,263,238
Central,Buckingham County,51029,272,1288,1560,369,2801,3170,33848,323742,357590,08/01/2014 12:00:00 AM,124,251,229
Central,Buckingham County,51029,273,1087,1360,381,2452,2833,39203,284013,323216,02/01/2016 12:00:00 AM,144,261,238
Central,Buckingham County,51029,274,1110,1384,386,2512,2898,38307,294380,332687,09/01/2015 12:00:00 AM,140,265,240
Central,Buckingham County,51029,274,1120,1394,379,2525,2904,37733,295924,333657,06/01/2015 12:00:00 AM,138,264,239
Central,Buckingham County,51029,275,1158,1433,371,2612,2983,37633,303965,341598,03/01/2015 12:00:00 AM,137,262,238
Central,Buckingham County,51029,275,1351,1626,372,2885,3257,34712,337261,371973,05/01/2014 12:00:00 AM,126,250,229
Central,Buckingham County,51029,276,1263,1539,378,2754,3132,34852,314724,349576,09/01/2014 12:00:00 AM,126,249,227
Central,Buckingham County,51029,277,1092,1369,392,2470,2862,40044,284324,324368,03/01/2016 12:00:00 AM,145,260,237
Central,Buckingham County,51029,278,1227,1505,373,2737,3110,37338,323563,360901,10/01/2014 12:00:00 AM,134,264,240
Central,Buckingham County,51029,279,1161,1440,363,2600,2963,36872,304641,341513,12/01/2014 12:00:00 AM,132,262,237
Central,Buckingham County,51029,280,1163,1443,365,2607,2972,36008,299299,335307,01/01/2015 12:00:00 AM,129,257,232
Central,Buckingham County,51029,280,1163,1443,368,2624,2992,35932,305448,341380,02/01/2015 12:00:00 AM,128,263,237
Central,Buckingham County,51029,280,1501,1781,392,3142,3534,41220,409103,450323,12/01/2012 12:00:00 AM,147,273,253
Central,Buckingham County,51029,281,1407,1688,405,2975,3380,42722,378142,420864,07/01/2013 12:00:00 AM,152,269,249
Central,Buckingham County,51029,281,1450,1731,387,3054,3441,40976,393277,434253,04/01/2013 12:00:00 AM,146,271,251
Central,Buckingham County,51029,281,1514,1795,411,3160,3571,43976,412836,456812,11/01/2012 12:00:00 AM,156,273,254
Central,Buckingham County,51029,283,1184,1467,383,2640,3023,38925,307534,346459,11/01/2014 12:00:00 AM,138,260,236
Central,Buckingham County,51029,283,1309,1592,394,2814,3208,36784,327960,364744,07/01/2014 12:00:00 AM,130,251,229
Central,Buckingham County,51029,283,1350,1633,400,2888,3288,38397,339700,378097,06/01/2014 12:00:00 AM,136,252,232
Central,Buckingham County,51029,283,1416,1699,402,2996,3398,42952,378944,421896,06/01/2013 12:00:00 AM,152,268,248
Central,Buckingham County,51029,284,1415,1699,404,3004,3408,42306,382163,424469,05/01/2013 12:00:00 AM,149,270,250
Central,Buckingham County,51029,284,1446,1730,404,3027,3431,41902,392268,434170,08/01/2012 12:00:00 AM,148,271,251
Central,Buckingham County,51029,284,1512,1796,391,3180,3571,40625,405726,446351,01/01/2013 12:00:00 AM,143,268,249
Central,Buckingham County,51029,285,1376,1661,404,2900,3304,39165,339554,378719,04/01/2014 12:00:00 AM,137,247,228
Central,Buckingham County,51029,285,1445,1730,402,3024,3426,42603,404401,447004,07/01/2012 12:00:00 AM,149,280,258
Central,Buckingham County,51029,285,1510,1795,392,3172,3564,40860,412367,453227,02/01/2013 12:00:00 AM,143,273,252
Central,Buckingham County,51029,286,1493,1779,416,3144,3560,44690,410205,454895,10/01/2012 12:00:00 AM,156,275,256
Central,Buckingham County,51029,287,1464,1751,404,3069,3473,43522,398171,441693,03/01/2013 12:00:00 AM,152,272,252
Central,Buckingham County,51029,288,1431,1719,416,3013,3429,45148,401271,446419,06/01/2012 12:00:00 AM,157,280,260
Central,Buckingham County,51029,291,1417,1708,425,2985,3410,46050,393443,439493,05/01/2012 12:00:00 AM,158,278,257
Central,Buckingham County,51029,291,1418,1709,423,2971,3394,45371,392648,438019,04/01/2012 12:00:00 AM,156,277,256
Central,Buckingham County,51029,291,1471,1762,425,3080,3505,45117,400298,445415,09/01/2012 12:00:00 AM,155,272,253
Central,Buckingham County,51029,292,1409,1701,414,2938,3352,45820,374716,420536,10/01/2013 12:00:00 AM,157,266,247
Central,Buckingham County,51029,293,1387,1680,422,2902,3324,40965,340937,381902,02/01/2014 12:00:00 AM,140,246,227
Central,Buckingham County,51029,294,1376,1670,427,2880,3307,41874,337848,379722,03/01/2014 12:00:00 AM,142,246,227
Central,Buckingham County,51029,294,1404,1698,428,2970,3398,46950,375905,422855,08/01/2013 12:00:00 AM,160,268,249
Central,Buckingham County,51029,296,1391,1687,434,2927,3361,48822,369613,418435,09/01/2013 12:00:00 AM,165,266,248
Central,Buckingham County,51029,296,1406,1702,423,2924,3347,42379,344128,386507,11/01/2013 12:00:00 AM,143,245,227
Central,Buckingham County,51029,298,1382,1680,427,2871,3298,42346,343077,385423,12/01/2013 12:00:00 AM,142,248,229
Central,Buckingham County,51029,298,1388,1686,428,2893,3321,41075,334089,375164,01/01/2014 12:00:00 AM,138,241,223
Central,Buckingham County,51029,299,1435,1734,450,3016,3466,50104,395940,446044,03/01/2012 12:00:00 AM,168,276,257
Central,Buckingham County,51029,301,1457,1758,451,3045,3496,48988,404352,453340,02/01/2012 12:00:00 AM,163,278,258
Central,Buckingham County,51029,305,1450,1755,480,3018,3498,53018,395826,448844,01/01/2012 12:00:00 AM,174,273,256
Central,Caroline County,51033,224,1519,1743,292,3317,3609,65846,705517,771363,02/01/2021 12:00:00 AM,294,464,443
Central,Caroline County,51033,230,1353,1583,327,2940,3267,36749,360005,396754,07/01/2019 12:00:00 AM,160,266,251
Central,Caroline County,51033,230,1511,1741,306,3249,3555,73332,745422,818754,06/01/2021 12:00:00 AM,319,493,470
Central,Caroline County,51033,231,1510,1741,310,3267,3577,73401,749394,822795,05/01/2021 12:00:00 AM,318,496,473
Central,Caroline County,51033,231,1533,1764,306,3333,3639,67563,698504,766067,03/01/2021 12:00:00 AM,292,456,434
Central,Caroline County,51033,232,1327,1559,337,2876,3213,37379,345874,383253,05/01/2019 12:00:00 AM,161,261,246
Central,Caroline County,51033,232,1332,1564,322,2885,3207,36865,352933,389798,08/01/2019 12:00:00 AM,159,265,249
Central,Caroline County,51033,232,1511,1743,309,3248,3557,75013,740397,815410,04/01/2021 12:00:00 AM,323,490,468
Central,Caroline County,51033,233,1313,1546,336,2906,3242,36234,350114,386348,02/01/2019 12:00:00 AM,156,267,250
Central,Caroline County,51033,234,1312,1546,339,2871,3210,39487,348524,388011,04/01/2019 12:00:00 AM,169,266,251
Central,Caroline County,51033,234,1387,1621,344,3098,3442,38564,383099,421663,01/01/2019 12:00:00 AM,165,276,260
Central,Caroline County,51033,236,1345,1581,338,2904,3242,36972,349245,386217,06/01/2019 12:00:00 AM,157,260,244
Central,Caroline County,51033,237,1495,1732,327,3272,3599,63833,600063,663896,12/01/2020 12:00:00 AM,269,401,383
Central,Caroline County,51033,238,1337,1575,343,2944,3287,38143,354404,392547,03/01/2019 12:00:00 AM,160,265,249
Central,Caroline County,51033,240,1294,1534,348,2870,3218,40272,351144,391416,02/01/2020 12:00:00 AM,168,271,255
Central,Caroline County,51033,240,1396,1636,351,3145,3496,38926,377869,416795,08/01/2018 12:00:00 AM,162,271,255
Central,Caroline County,51033,240,1407,1647,361,3171,3532,40392,383534,423926,03/01/2018 12:00:00 AM,168,273,257
Central,Caroline County,51033,240,1416,1656,362,3168,3530,42046,387111,429157,02/01/2018 12:00:00 AM,175,273,259
Central,Caroline County,51033,240,1510,1750,330,3351,3681,64917,616768,681685,11/01/2020 12:00:00 AM,270,408,390
Central,Caroline County,51033,240,1527,1767,335,3378,3713,64384,616822,681206,10/01/2020 12:00:00 AM,268,404,386
Central,Caroline County,51033,241,1336,1577,340,2911,3251,38476,354366.68,392842.68,09/01/2019 12:00:00 AM,160,265,249
Central,Caroline County,51033,241,1376,1617,357,3066,3423,40151,370670,410821,12/01/2018 12:00:00 AM,167,269,254
Central,Caroline County,51033,241,1394,1635,363,3140,3503,43068,386663,429731,04/01/2018 12:00:00 AM,179,277,263
Central,Caroline County,51033,242,1338,1580,350,2964,3314,63442,505198,568640,03/01/2020 12:00:00 AM,262,378,360
Central,Caroline County,51033,242,1345,1587,342,2951,3293,38623,364525,403148,10/01/2019 12:00:00 AM,160,271,254
Central,Caroline County,51033,243,1363,1606,361,3040,3401,40737,362504,403241,09/01/2018 12:00:00 AM,168,266,251
Central,Caroline County,51033,244,1324,1568,356,2929,3285,39789,359504,399293,11/01/2019 12:00:00 AM,163,272,255
Central,Caroline County,51033,244,1373,1617,363,3084,3447,40659.31,379527.67,420186.98,05/01/2018 12:00:00 AM,167,276,260
Central,Caroline County,51033,244,1386,1630,356,3156,3512,40949,383176,424125,07/01/2018 12:00:00 AM,168,276,260
Central,Caroline County,51033,244,1480,1724,328,3247,3575,71122,679625,750747,01/01/2021 12:00:00 AM,291,459,435
Central,Caroline County,51033,246,1533,1779,352,3402,3754,63827,592597,656424,09/01/2020 12:00:00 AM,259,387,369
Central,Caroline County,51033,247,1361,1608,361,3065,3426,40623,364818,405441,11/01/2018 12:00:00 AM,164,268,252
Central,Caroline County,51033,247,1386,1633,365,3153,3518,42172,383150,425322,06/01/2018 12:00:00 AM,171,276,260
Central,Caroline County,51033,248,1431,1679,384,3227,3611,43802,392942,436744,01/01/2018 12:00:00 AM,177,275,260
Central,Caroline County,51033,249,1347,1596,371,3011,3382,42124,361481,403605,10/01/2018 12:00:00 AM,169,268,253
Central,Caroline County,51033,250,1314,1564,365,2908,3273,41317,357852,399169,01/01/2020 12:00:00 AM,165,272,255
Central,Caroline County,51033,251,1309,1560,369,2891,3260,42315,353505,395820,12/01/2019 12:00:00 AM,169,270,254
Central,Caroline County,51033,252,1445,1697,363,3193,3556,66630,547606,614236,04/01/2020 12:00:00 AM,264,379,362
Central,Caroline County,51033,252,1537,1789,365,3384,3749,65616,576520,642136,08/01/2020 12:00:00 AM,260,375,359
Central,Caroline County,51033,253,1572,1825,352,3637,3989,39790,446811,486601,02/01/2017 12:00:00 AM,157,284,267
Central,Caroline County,51033,254,1422,1676,388,3187,3575,46470,387232,433702,11/01/2017 12:00:00 AM,183,272,259
Central,Caroline County,51033,255,1495,1750,370,3295,3665,68145,568792,636937,05/01/2020 12:00:00 AM,267,380,364
Central,Caroline County,51033,256,1478,1734,391,3400,3791,44415,424194,468609,05/01/2017 12:00:00 AM,173,287,270
Central,Caroline County,51033,259,1397,1656,401,3210,3611,45530,406673,452203,07/01/2017 12:00:00 AM,176,291,273
Central,Caroline County,51033,260,1419,1679,411,3202,3613,49121,385764,434885,12/01/2017 12:00:00 AM,189,272,259
Central,Caroline County,51033,260,1426,1686,408,3249,3657,49935,405004,454939,10/01/2017 12:00:00 AM,192,284,270
Central,Caroline County,51033,260,1434,1694,401,3296,3697,46249,416014,462263,08/01/2017 12:00:00 AM,178,290,273
Central,Caroline County,51033,260,1504,1764,393,3469,3862,43856,436527,480383,04/01/2017 12:00:00 AM,169,290,272
Central,Caroline County,51033,260,1511,1771,375,3318,3693,68883,573600,642483,06/01/2020 12:00:00 AM,265,380,363
Central,Caroline County,51033,260,1524,1784,379,3343,3722,69748,578568,648316,07/01/2020 12:00:00 AM,268,380,363
Central,Caroline County,51033,261,1549,1810,372,3603,3975,42120,447344,489464,03/01/2017 12:00:00 AM,161,289,270
Central,Caroline County,51033,261,1583,1844,372,3677,4049,42102,449524,491626,01/01/2017 12:00:00 AM,161,284,267
Central,Caroline County,51033,262,1424,1686,410,3260,3670,49439,406505,455944,09/01/2017 12:00:00 AM,189,285,270
Central,Caroline County,51033,263,1579,1842,382,3690,4072,43231,455431,498662,12/01/2016 12:00:00 AM,164,288,271
Central,Caroline County,51033,264,1652,1916,399,3856,4255,41823,468732,510555,06/01/2016 12:00:00 AM,158,284,266
Central,Caroline County,51033,265,1881,2146,464,4247,4711,53628,509040,562668,09/01/2014 12:00:00 AM,202,271,262
Central,Caroline County,51033,266,1455,1721,407,3357,3764,46988,427295,474283,06/01/2017 12:00:00 AM,177,294,276
Central,Caroline County,51033,267,1825,2092,458,4173,4631,52821,510346,563167,03/01/2015 12:00:00 AM,198,280,269
Central,Caroline County,51033,268,1791,2059,446,4109,4555,51978,508908,560886,04/01/2015 12:00:00 AM,194,284,272
Central,Caroline County,51033,270,1626,1896,400,3809,4209,42770,459925,502695,07/01/2016 12:00:00 AM,158,283,265
Central,Caroline County,51033,270,1778,2048,449,4100,4549,53119,502138,555257,05/01/2015 12:00:00 AM,197,282,271
Central,Caroline County,51033,270,1861,2131,468,4227,4695,54155,526031,580186,10/01/2014 12:00:00 AM,201,283,272
Central,Caroline County,51033,272,1585,1857,404,3655,4059,44704,447261,491965,09/01/2016 12:00:00 AM,164,282,265
Central,Caroline County,51033,272,1609,1881,415,3756,4171,45686,454823,500509,08/01/2016 12:00:00 AM,168,283,266
Central,Caroline County,51033,273,1680,1953,421,3926,4347,44354,473698,518052,05/01/2016 12:00:00 AM,162,282,265
Central,Caroline County,51033,273,1689,1962,404,3959,4363,43618,480171,523789,04/01/2016 12:00:00 AM,160,284,267
Central,Caroline County,51033,273,1745,2018,433,4052,4485,48400,500326,548726,08/01/2015 12:00:00 AM,177,287,272
Central,Caroline County,51033,273,1781,2054,457,4111,4568,51447,506262,557709,06/01/2015 12:00:00 AM,188,284,272
Central,Caroline County,51033,274,1575,1849,402,3650,4052,46309,452021,498330,11/01/2016 12:00:00 AM,169,287,270
Central,Caroline County,51033,274,1836,2110,471,4191,4662,55191,519452,574643,11/01/2014 12:00:00 AM,201,283,272
Central,Caroline County,51033,274,1893,2167,492,4202,4694,57182,508725,565907,08/01/2014 12:00:00 AM,209,269,261
Central,Caroline County,51033,275,1567,1842,415,3592,4007,45943,445364,491307,10/01/2016 12:00:00 AM,167,284,267
Central,Caroline County,51033,275,1842,2117,471,4230,4701,54289,522567,576856,12/01/2014 12:00:00 AM,197,284,272
Central,Caroline County,51033,278,1738,2016,429,4028,4457,47224,501420,548644,09/01/2015 12:00:00 AM,170,289,272
Central,Caroline County,51033,278,1772,2050,427,4101,4528,48632,505374,554006,10/01/2015 12:00:00 AM,175,285,270
Central,Caroline County,51033,279,1721,2000,429,4021,4450,46883,489958,536841,03/01/2016 12:00:00 AM,168,285,268
Central,Caroline County,51033,279,1756,2035,452,4061,4513,51936,499933,551869,07/01/2015 12:00:00 AM,186,285,271
Central,Caroline County,51033,279,1832,2111,483,4194,4677,56187,516329,572516,02/01/2015 12:00:00 AM,201,282,271
Central,Caroline County,51033,280,2035,2315,514,4412,4926,60243,547588,607831,03/01/2014 12:00:00 AM,215,269,263
Central,Caroline County,51033,281,1745,2026,432,4063,4495,48441,499194,547635,01/01/2016 12:00:00 AM,172,286,270
Central,Caroline County,51033,282,1832,2114,489,4197,4686,57528,514107,571635,01/01/2015 12:00:00 AM,204,281,270
Central,Caroline County,51033,282,1991,2273,509,4309,4818,57991,533962,591953,05/01/2014 12:00:00 AM,206,268,260
Central,Caroline County,51033,285,1933,2218,515,4256,4771,59737,514241,573978,07/01/2014 12:00:00 AM,210,266,259
Central,Caroline County,51033,285,1948,2233,520,4218,4738,60021,521885,581906,06/01/2014 12:00:00 AM,211,268,261
Central,Caroline County,51033,287,1781,2068,456,4096,4552,52271,507789,560060,11/01/2015 12:00:00 AM,182,285,271
Central,Caroline County,51033,289,1762,2051,451,4089,4540,51235,503037,554272,12/01/2015 12:00:00 AM,177,285,270
Central,Caroline County,51033,289,1998,2287,532,4306,4838,61231,534878,596109,04/01/2014 12:00:00 AM,212,268,261
Central,Caroline County,51033,291,1718,2009,455,4016,4471,50506,495212,545718,02/01/2016 12:00:00 AM,174,288,272
Central,Caroline County,51033,291,2014,2305,534,4379,4913,62185,540209,602394,02/01/2014 12:00:00 AM,214,268,261
Central,Caroline County,51033,295,2026,2321,554,4422,4976,64778,545671,610449,12/01/2013 12:00:00 AM,220,269,263
Central,Caroline County,51033,298,2014,2312,549,4392,4941,62243,537412,599655,01/01/2014 12:00:00 AM,209,267,259
Central,Caroline County,51033,299,2016,2315,562,4390,4952,67123,542385,609508,11/01/2013 12:00:00 AM,224,269,263
Central,Caroline County,51033,299,2081,2380,553,4521,5074,71338,602466,673804,09/01/2013 12:00:00 AM,239,290,283
Central,Caroline County,51033,303,2057,2360,550,4506,5056,71019,601703,672722,08/01/2013 12:00:00 AM,234,293,285
Central,Caroline County,51033,310,2060,2370,571,4504,5075,72715,601642,674357,07/01/2013 12:00:00 AM,235,292,285
Central,Caroline County,51033,312,2040,2352,598,4430,5028,76969,588850,665819,10/01/2013 12:00:00 AM,247,289,283
Central,Caroline County,51033,313,2050,2363,577,4450,5027,74257,602388,676645,05/01/2013 12:00:00 AM,237,294,286
Central,Caroline County,51033,314,2040,2354,576,4483,5059,73429,596628,670057,06/01/2013 12:00:00 AM,234,292,285
Central,Caroline County,51033,314,2046,2360,557,4430,4987,71601,599395,670996,03/01/2013 12:00:00 AM,228,293,284
Central,Caroline County,51033,318,2022,2340,594,4496,5090,77010,601146,678156,04/01/2012 12:00:00 AM,242,297,290
Central,Caroline County,51033,319,2025,2344,605,4480,5085,79220,596733,675953,03/01/2012 12:00:00 AM,248,295,288
Central,Caroline County,51033,319,2076,2395,575,4500,5075,74759,601334,676093,02/01/2013 12:00:00 AM,234,290,282
Central,Caroline County,51033,320,2040,2360,614,4495,5109,79913,594955,674868,01/01/2012 12:00:00 AM,250,292,286
Central,Caroline County,51033,321,2015,2336,577,4446,5023,73983,596255,670238,08/01/2012 12:00:00 AM,230,296,287
Central,Caroline County,51033,321,2048,2369,573,4430,5003,74549,595231,669780,01/01/2013 12:00:00 AM,232,291,283
Central,Caroline County,51033,322,1993,2315,582,4389,4971,74137,591857,665994,06/01/2012 12:00:00 AM,230,297,288
Central,Caroline County,51033,323,2008,2331,581,4431,5012,73938,596412,670350,07/01/2012 12:00:00 AM,229,297,288
Central,Caroline County,51033,323,2035,2358,579,4400,4979,75190,596241,671431,04/01/2013 12:00:00 AM,233,293,285
Central,Caroline County,51033,323,2066,2389,580,4543,5123,74091,607851,681942,10/01/2012 12:00:00 AM,229,294,285
Central,Caroline County,51033,324,2021,2345,629,4463,5092,82144,596221,678365,02/01/2012 12:00:00 AM,254,295,289
Central,Caroline County,51033,324,2066,2390,585,4499,5084,76415,604879,681294,12/01/2012 12:00:00 AM,236,293,285
Central,Caroline County,51033,326,2056,2382,582,4533,5115,74763,609342,684105,09/01/2012 12:00:00 AM,229,296,287
Central,Caroline County,51033,329,1982,2311,620,4374,4994,79977,587212,667189,05/01/2012 12:00:00 AM,243,296,289
Central,Caroline County,51033,330,2067,2397,616,4506,5122,80867,601056,681923,11/01/2012 12:00:00 AM,245,291,284
Central,Charles City County,51036,46,349,395,49,673,722,4323,80749,85072,12/01/2019 12:00:00 AM,94,231,215
Central,Charles City County,51036,46,352,398,50,665,715,9561,116684,126245,03/01/2020 12:00:00 AM,208,331,317
Central,Charles City County,51036,46,356,402,49,675,724,4336,82595,86931,10/01/2019 12:00:00 AM,94,232,216
Central,Charles City County,51036,46,396,442,52,728,780,12722,171283,184005,04/01/2021 12:00:00 AM,277,433,416
Central,Charles City County,51036,46,412,458,51,794,845,4687,102326,107013,06/01/2017 12:00:00 AM,102,248,234
Central,Charles City County,51036,47,347,394,52,665,717,4845,81850,86695,11/01/2019 12:00:00 AM,103,236,220
Central,Charles City County,51036,47,358,405,50,683,733,4489,83802,88291,09/01/2019 12:00:00 AM,96,234,218
Central,Charles City County,51036,47,402,449,54,738,792,12094,162409,174503,03/01/2021 12:00:00 AM,257,404,389
Central,Charles City County,51036,47,413,460,53,775,828,5012,94976,99988,01/01/2019 12:00:00 AM,107,230,217
Central,Charles City County,51036,48,348,396,52,660,712,4206,80690,84896,02/01/2020 12:00:00 AM,88,232,214
Central,Charles City County,51036,48,349,397,52,668,720,4320,80062,84382,01/01/2020 12:00:00 AM,90,229,213
Central,Charles City County,51036,48,390,438,52,737,789,4758,90756,95514,04/01/2019 12:00:00 AM,99,233,218
Central,Charles City County,51036,48,390,438,54,701,755,13029,165835,178864,06/01/2021 12:00:00 AM,271,425,408
Central,Charles City County,51036,48,392,440,54,709,763,13342,170914,184256,05/01/2021 12:00:00 AM,278,436,419
Central,Charles City County,51036,48,398,446,52,753,805,10143,132152,142295,04/01/2020 12:00:00 AM,211,332,319
Central,Charles City County,51036,48,398,446,55,729,784,12554,157043,169597,02/01/2021 12:00:00 AM,262,395,380
Central,Charles City County,51036,48,405,453,55,758,813,10401,136749,147150,05/01/2020 12:00:00 AM,217,338,325
Central,Charles City County,51036,48,410,458,55,754,809,10401,132361,142762,06/01/2020 12:00:00 AM,217,323,312
Central,Charles City County,51036,48,411,459,53,780,833,4530,98231,102761,03/01/2018 12:00:00 AM,94,239,224
Central,Charles City County,51036,48,422,470,52,816,868,4175,103522,107697,05/01/2017 12:00:00 AM,87,245,229
Central,Charles City County,51036,49,371,420,54,704,758,5515,86846,92361,08/01/2019 12:00:00 AM,113,234,220
Central,Charles City County,51036,49,389,438,55,721,776,5272,89458,94730,03/01/2019 12:00:00 AM,108,230,216
Central,Charles City County,51036,49,395,444,55,727,782,5272,90915,96187,02/01/2019 12:00:00 AM,108,230,217
Central,Charles City County,51036,49,399,448,57,758,815,5228,95132,100360,02/01/2018 12:00:00 AM,107,238,224
Central,Charles City County,51036,49,421,470,56,774,830,10595,135946,146541,07/01/2020 12:00:00 AM,216,323,312
Central,Charles City County,51036,50,375,425,56,707,763,5228,85609,90837,05/01/2019 12:00:00 AM,105,228,214
Central,Charles City County,51036,50,397,447,56,759,815,5123,93703,98826,04/01/2018 12:00:00 AM,102,236,221
Central,Charles City County,51036,50,401,451,56,746,802,5398,90637,96035,12/01/2018 12:00:00 AM,108,226,213
Central,Charles City County,51036,50,403,453,58,775,833,5507,99813,105320,11/01/2017 12:00:00 AM,110,248,232
Central,Charles City County,51036,50,428,478,57,839,896,4925,106248,111173,03/01/2017 12:00:00 AM,99,248,233
Central,Charles City County,51036,50,430,480,62,835,897,5628,106848,112476,11/01/2016 12:00:00 AM,113,248,234
Central,Charles City County,51036,51,372,423,57,727,784,5290,88654,93944,06/01/2019 12:00:00 AM,104,238,222
Central,Charles City County,51036,51,373,424,57,721,778,5229,88307,93536,07/01/2019 12:00:00 AM,103,237,221
Central,Charles City County,51036,51,386,437,62,696,758,13855,148302,162157,01/01/2021 12:00:00 AM,272,384,371
Central,Charles City County,51036,51,397,448,60,784,844,6102,96568,102670,08/01/2018 12:00:00 AM,120,243,229
Central,Charles City County,51036,51,399,450,59,760,819,5507,96693,102200,12/01/2017 12:00:00 AM,108,242,227
Central,Charles City County,51036,51,406,457,59,776,835,5624,100614,106238,01/01/2018 12:00:00 AM,110,248,232
Central,Charles City County,51036,51,409,460,59,796,855,5386,100116,105502,09/01/2017 12:00:00 AM,106,245,229
Central,Charles City County,51036,51,412,463,59,790,849,5435,101133,106568,08/01/2017 12:00:00 AM,107,245,230
Central,Charles City County,51036,51,413,464,56,786,842,5147,100431,105578,07/01/2017 12:00:00 AM,101,243,228
Central,Charles City County,51036,51,420,471,60,767,827,11103,134952,146055,08/01/2020 12:00:00 AM,218,321,310
Central,Charles City County,51036,51,426,477,58,836,894,4839,105876,110715,12/01/2016 12:00:00 AM,95,249,232
Central,Charles City County,51036,51,430,481,58,835,893,5364,105326,110690,04/01/2017 12:00:00 AM,105,245,230
Central,Charles City County,51036,51,436,487,63,855,918,5644,108110,113754,10/01/2016 12:00:00 AM,111,248,234
Central,Charles City County,51036,51,439,490,61,865,926,5124,109374,114498,09/01/2016 12:00:00 AM,100,249,234
Central,Charles City County,51036,52,391,443,60,763,823,5590,92929,98519,09/01/2018 12:00:00 AM,108,238,222
Central,Charles City County,51036,52,395,447,61,715,776,12875,133627,146502,11/01/2020 12:00:00 AM,248,338,328
Central,Charles City County,51036,52,398,450,61,717,778,11700,133633,145333,12/01/2020 12:00:00 AM,225,336,323
Central,Charles City County,51036,52,401,453,60,766,826,5818,93397,99215,11/01/2018 12:00:00 AM,112,233,219
Central,Charles City County,51036,52,408,460,60,796,856,5583,100922,106505,05/01/2018 12:00:00 AM,107,247,232
Central,Charles City County,51036,52,409,461,60,792,852,5737,100283,106020,10/01/2017 12:00:00 AM,110,245,230
Central,Charles City County,51036,52,411,463,61,760,821,11149,137746,148895,09/01/2020 12:00:00 AM,214,335,322
Central,Charles City County,51036,52,415,467,59,802,861,5078,103045,108123,02/01/2017 12:00:00 AM,98,248,232
Central,Charles City County,51036,52,426,478,59,834,893,4863,106487,111350,01/01/2017 12:00:00 AM,94,250,233
Central,Charles City County,51036,53,393,446,62,765,827,5892,97281,103173,07/01/2018 12:00:00 AM,111,248,231
Central,Charles City County,51036,53,395,448,62,761,823,6838,101375,108213,10/01/2018 12:00:00 AM,129,257,242
Central,Charles City County,51036,53,433,486,70,847,917,6659,107407,114066,08/01/2016 12:00:00 AM,126,248,235
Central,Charles City County,51036,54,399,453,63,725,788,12406,133589,145995,10/01/2020 12:00:00 AM,230,335,322
Central,Charles City County,51036,54,405,459,63,792,855,5936,99256,105192,06/01/2018 12:00:00 AM,110,245,229
Central,Charles City County,51036,54,434,488,64,861,925,5690,106749,112439,07/01/2016 12:00:00 AM,105,246,230
Central,Charles City County,51036,55,424,479,66,863,929,5848,101962,107810,01/01/2016 12:00:00 AM,106,240,225
Central,Charles City County,51036,56,439,495,68,863,931,6056,104156,110212,06/01/2016 12:00:00 AM,108,237,223
Central,Charles City County,51036,57,427,484,69,875,944,6097,101652,107749,03/01/2016 12:00:00 AM,107,238,223
Central,Charles City County,51036,57,428,485,69,868,937,6003,102304,108307,02/01/2016 12:00:00 AM,105,239,223
Central,Charles City County,51036,57,438,495,70,879,949,6461,101519,107980,05/01/2016 12:00:00 AM,113,232,218
Central,Charles City County,51036,58,416,474,71,849,920,6419,98824,105243,04/01/2016 12:00:00 AM,111,238,222
Central,Charles City County,51036,58,428,486,73,863,936,7268,101630,108898,12/01/2015 12:00:00 AM,125,237,224
Central,Charles City County,51036,59,518,577,68,1005,1073,5456,125805,131261,12/01/2013 12:00:00 AM,92,243,227
Central,Charles City County,51036,59,528,587,70,990,1060,5061,123216,128277,03/01/2014 12:00:00 AM,86,233,219
Central,Charles City County,51036,60,509,569,73,944,1017,5421,118115,123536,04/01/2014 12:00:00 AM,90,232,217
Central,Charles City County,51036,60,520,580,70,998,1068,5289,122326,127615,01/01/2014 12:00:00 AM,88,235,220
Central,Charles City County,51036,60,524,584,76,1014,1090,6597,136051,142648,10/01/2013 12:00:00 AM,110,260,244
Central,Charles City County,51036,60,543,603,78,1021,1099,7615,139815,147430,05/01/2013 12:00:00 AM,127,257,244
Central,Charles City County,51036,61,521,582,75,1004,1079,6055,126113,132168,11/01/2013 12:00:00 AM,99,242,227
Central,Charles City County,51036,61,525,586,71,1000,1071,5313,121558,126871,02/01/2014 12:00:00 AM,87,232,217
Central,Charles City County,51036,61,539,600,83,1033,1116,8528,139439,147967,06/01/2013 12:00:00 AM,140,259,247
Central,Charles City County,51036,62,504,566,76,949,1025,5748,116576,122324,05/01/2014 12:00:00 AM,93,231,216
Central,Charles City County,51036,62,533,595,81,1036,1117,7552,139296,146848,08/01/2013 12:00:00 AM,122,261,247
Central,Charles City County,51036,62,546,608,84,1029,1113,8111,139952,148063,04/01/2013 12:00:00 AM,131,256,244
Central,Charles City County,51036,63,505,568,80,938,1018,6189,115462,121651,06/01/2014 12:00:00 AM,98,229,214
Central,Charles City County,51036,63,521,584,85,1003,1088,8061,136985,145046,09/01/2013 12:00:00 AM,128,263,248
Central,Charles City County,51036,63,540,603,93,1014,1107,9712,139039,148751,03/01/2013 12:00:00 AM,154,257,247
Central,Charles City County,51036,64,433,497,80,879,959,7627,105549,113176,11/01/2015 12:00:00 AM,119,244,228
Central,Charles City County,51036,64,483,547,83,912,995,7428,109636,117064,08/01/2014 12:00:00 AM,116,227,214
Central,Charles City County,51036,64,490,554,81,925,1006,6806,112241,119047,07/01/2014 12:00:00 AM,106,229,215
Central,Charles City County,51036,65,442,507,83,871,954,7711,107720,115431,10/01/2014 12:00:00 AM,119,244,228
Central,Charles City County,51036,65,513,578,89,979,1068,8820,135636,144456,09/01/2012 12:00:00 AM,136,264,250
Central,Charles City County,51036,65,529,594,92,1016,1108,9177,139998,149175,08/01/2012 12:00:00 AM,141,265,251
Central,Charles City County,51036,65,538,603,90,1026,1116,9202,141878,151080,02/01/2013 12:00:00 AM,142,264,251
Central,Charles City County,51036,65,539,604,90,1039,1129,9648,139186,148834,07/01/2013 12:00:00 AM,148,258,246
Central,Charles City County,51036,66,427,493,81,864,945,7570,103002,110572,01/01/2015 12:00:00 AM,115,241,224
Central,Charles City County,51036,66,511,577,94,960,1054,10020,133002,143022,10/01/2012 12:00:00 AM,152,260,248
Central,Charles City County,51036,66,532,598,95,1019,1114,9753,138909,148662,01/01/2013 12:00:00 AM,148,261,249
Central,Charles City County,51036,67,423,490,90,863,953,8944,105432,114376,04/01/2015 12:00:00 AM,133,249,233
Central,Charles City County,51036,67,479,546,88,921,1009,8390,110745,119135,09/01/2014 12:00:00 AM,125,231,218
Central,Charles City County,51036,67,510,577,98,971,1069,10403,134907,145310,11/01/2012 12:00:00 AM,155,265,252
Central,Charles City County,51036,67,521,588,96,996,1092,10208,138649,148857,07/01/2012 12:00:00 AM,152,266,253
Central,Charles City County,51036,68,423,491,91,859,950,9030,101819,110849,03/01/2015 12:00:00 AM,133,241,226
Central,Charles City County,51036,68,432,500,90,858,948,8323,102913,111236,12/01/2014 12:00:00 AM,122,238,222
Central,Charles City County,51036,68,433,501,88,873,961,8478,106232,114710,02/01/2015 12:00:00 AM,125,245,229
Central,Charles City County,51036,69,410,479,94,857,951,8910,102249,111159,06/01/2015 12:00:00 AM,129,249,232
Central,Charles City County,51036,69,414,483,96,852,948,9515,102728,112243,07/01/2015 12:00:00 AM,138,248,232
Central,Charles City County,51036,69,431,500,92,838,930,8540,103720,112260,11/01/2014 12:00:00 AM,124,241,225
Central,Charles City County,51036,69,514,583,102,983,1085,10581,135222,145803,12/01/2012 12:00:00 AM,153,263,250
Central,Charles City County,51036,70,411,481,96,844,940,9680,103216,112896,05/01/2015 12:00:00 AM,138,251,235
Central,Charles City County,51036,70,420,490,94,851,945,8995,103744,112739,09/01/2015 12:00:00 AM,129,247,230
Central,Charles City County,51036,71,412,483,100,849,949,9995,103082,113077,08/01/2015 12:00:00 AM,141,250,234
Central,Charles City County,51036,71,426,497,96,862,958,9042,104696,113738,10/01/2015 12:00:00 AM,127,246,229
Central,Charles City County,51036,71,515,586,109,966,1075,11642,133898,145540,01/01/2012 12:00:00 AM,164,260,248
Central,Charles City County,51036,72,516,588,110,967,1077,12162,133591,145753,04/01/2012 12:00:00 AM,169,259,248
Central,Charles City County,51036,73,524,597,111,983,1094,12005,135489,147494,05/01/2012 12:00:00 AM,164,259,247
Central,Charles City County,51036,74,528,602,112,994,1106,12632,138162,150794,06/01/2012 12:00:00 AM,171,262,250
Central,Charles City County,51036,75,519,594,120,968,1088,13478,134650,148128,02/01/2012 12:00:00 AM,180,259,249
Central,Charles City County,51036,76,520,596,120,974,1094,13153,134601,147754,03/01/2012 12:00:00 AM,173,259,248
Central,Chesterfield County,51041,1379,8990,10369,2015,22192,24207,243164,2960950.1,3204114.1,05/01/2017 12:00:00 AM,176,329,309
Central,Chesterfield County,51041,1404,8951,10355,2039,22110,24149,241839,2905818,3147657,04/01/2017 12:00:00 AM,172,325,304
Central,Chesterfield County,51041,1407,9220,10627,2023,22772,24795,244243,3009300,3253543,03/01/2017 12:00:00 AM,174,326,306
Central,Chesterfield County,51041,1411,8905,10316,2121,22016,24137,260581,2974364.28,3234945.28,07/01/2017 12:00:00 AM,185,334,314
Central,Chesterfield County,51041,1411,8934,10345,2104,22016,24120,256363,2938881,3195244,06/01/2017 12:00:00 AM,182,329,309
Central,Chesterfield County,51041,1435,9109,10544,2131,22471,24602,254362,2965048,3219410,05/01/2018 12:00:00 AM,177,326,305
Central,Chesterfield County,51041,1436,8947,10383,2159,22096,24255,265140,2980251,3245391,08/01/2017 12:00:00 AM,185,333,313
Central,Chesterfield County,51041,1436,9094,10530,2172,22360,24532,264731,2967297.67,3232028.67,03/01/2018 12:00:00 AM,184,326,307
Central,Chesterfield County,51041,1437,9137,10574,2173,22628,24801,274728,3010470.75,3285198.75,10/01/2017 12:00:00 AM,191,329,311
Central,Chesterfield County,51041,1440,9043,10483,2181,22413,24594,275759,3009534.01,3285293.01,09/01/2017 12:00:00 AM,191,333,313
Central,Chesterfield County,51041,1440,9072,10512,2153,22362,24515,264288,2970837,3235125,06/01/2018 12:00:00 AM,184,327,308
Central,Chesterfield County,51041,1447,10113,11560,2165,25241,27406,255200,3192070,3447270,09/01/2015 12:00:00 AM,176,316,298
Central,Chesterfield County,51041,1449,9164,10613,2199,22709,24908,276199,3002635,3278834,12/01/2017 12:00:00 AM,191,328,309
Central,Chesterfield County,51041,1451,9035,10486,2206,22253,24459,271855.41,2948218,3220073.41,02/01/2018 12:00:00 AM,187,326,307
Central,Chesterfield County,51041,1452,10186,11638,2145,25364,27509,254887,3215873,3470760,08/01/2015 12:00:00 AM,176,316,298
Central,Chesterfield County,51041,1452,9064,10516,2200,22321,24521,274713,2948400,3223113,01/01/2018 12:00:00 AM,189,325,306
Central,Chesterfield County,51041,1452,9179,10631,2215,22733,24948,277950,3007761.39,3285711.39,11/01/2017 12:00:00 AM,191,328,309
Central,Chesterfield County,51041,1452,9349,10801,2108,23256,25364,249293,2991963,3241256,02/01/2017 12:00:00 AM,172,320,300
Central,Chesterfield County,51041,1453,9058,10511,2188,22271,24459,270814,2932317,3203131,04/01/2018 12:00:00 AM,186,324,305
Central,Chesterfield County,51041,1455,10212,11667,2137,25431,27568,252826,3226181,3479007,07/01/2015 12:00:00 AM,174,316,298
Central,Chesterfield County,51041,1461,9442,10903,2164,23390,25554,252964,2979884,3232848,08/01/2016 12:00:00 AM,173,316,297
Central,Chesterfield County,51041,1464,10210,11674,2203,25406,27609,261974,3220209,3482183,06/01/2015 12:00:00 AM,179,315,298
Central,Chesterfield County,51041,1467,10049,11516,2181,25048,27229,260118,3167489,3427607,11/01/2015 12:00:00 AM,177,315,298
Central,Chesterfield County,51041,1467,8951,10418,2173,22060,24233,266470,2913164,3179634,07/01/2018 12:00:00 AM,182,325,305
Central,Chesterfield County,51041,1467,9425,10892,2170,23375,25545,254134,2971606,3225740,07/01/2016 12:00:00 AM,173,315,296
Central,Chesterfield County,51041,1469,10081,11550,2192,25119,27311,262723,3181298,3444021,10/01/2015 12:00:00 AM,179,316,298
Central,Chesterfield County,51041,1469,9487,10956,2167,23562,25729,253200,2999543,3252743,06/01/2016 12:00:00 AM,172,316,297
Central,Chesterfield County,51041,1474,8268,9742,2152,20077,22229,259908,2640978,2900886,02/01/2019 12:00:00 AM,176,319,298
Central,Chesterfield County,51041,1474,9954,11428,2225,24797,27022,266025,3133603,3399628,12/01/2015 12:00:00 AM,180,315,297
Central,Chesterfield County,51041,1476,9482,10958,2194,23603,25797,257634,3015685,3273319,09/01/2016 12:00:00 AM,175,318,299
Central,Chesterfield County,51041,1477,9386,10863,2197,23446,25643,258432,3014497,3272929,01/01/2017 12:00:00 AM,175,321,301
Central,Chesterfield County,51041,1479,9486,10965,2204,23583,25787,254648,2997071,3251719,05/01/2016 12:00:00 AM,172,316,297
Central,Chesterfield County,51041,1480,9596,11076,2186,23885,26071,257026,3076933,3333959,10/01/2016 12:00:00 AM,174,321,301
Central,Chesterfield County,51041,1480,9766,11246,2227,24368,26595,264173,3079549,3343722,01/01/2016 12:00:00 AM,178,315,297
Central,Chesterfield County,51041,1485,10226,11711,2292,25435,27727,272654,3233034,3505688,05/01/2015 12:00:00 AM,184,316,299
Central,Chesterfield County,51041,1487,9429,10916,2224,23624,25848,262940,3039130,3302070,12/01/2016 12:00:00 AM,177,322,302
Central,Chesterfield County,51041,1489,9061,10550,2208,22224,24432,265721,2923577,3189298,08/01/2018 12:00:00 AM,178,323,302
Central,Chesterfield County,51041,1490,9706,11196,2186,24065,26251,259722,3057790,3317512,03/01/2016 12:00:00 AM,174,315,296
Central,Chesterfield County,51041,1490,9751,11241,2229,24224,26453,265529,3079327,3344856,02/01/2016 12:00:00 AM,178,316,298
Central,Chesterfield County,51041,1493,9507,11000,2254,23729,25983,265050,3072425,3337475,11/01/2016 12:00:00 AM,178,323,303
Central,Chesterfield County,51041,1494,8965,10459,2199,21953,24152,271072,2896441.56,3167513.56,09/01/2018 12:00:00 AM,181,323,303
Central,Chesterfield County,51041,1495,9583,11078,2213,23778,25991,257035,3015577,3272612,04/01/2016 12:00:00 AM,172,315,295
Central,Chesterfield County,51041,1503,10344,11847,2334,25682,28016,277696,3260319,3538015,04/01/2015 12:00:00 AM,185,315,299
Central,Chesterfield County,51041,1504,9123,10627,2212,21890,24102,268213,2870218,3138431,10/01/2019 12:00:00 AM,178,315,295
Central,Chesterfield County,51041,1505,8974,10479,2204,22002,24206,280271,2934949,3215220,10/01/2018 12:00:00 AM,186,327,307
Central,Chesterfield County,51041,1509,9101,10610,2247,21910,24157,271994,2844994,3116988,07/01/2019 12:00:00 AM,180,313,294
Central,Chesterfield County,51041,1510,8988,10498,2238,21702,23940,268789,2825192,3093981,01/01/2020 12:00:00 AM,178,314,295
Central,Chesterfield County,51041,1513,9029,10542,2231,21742,23973,267753,2840231.5,3107984.5,05/01/2019 12:00:00 AM,177,315,295
Central,Chesterfield County,51041,1517,9099,10616,2246,21979,24225,270962,2863719,3134681,06/01/2019 12:00:00 AM,179,315,295
Central,Chesterfield County,51041,1517,9185,10702,2255,22145,24400,275686,2907152,3182838,09/01/2019 12:00:00 AM,182,317,297
Central,Chesterfield County,51041,1517,9212,10729,2240,22129,24369,272529,2867040,3139569,08/01/2019 12:00:00 AM,180,311,293
Central,Chesterfield County,51041,1521,9147,10668,2274,22034,24308,277049,2881310,3158359,11/01/2019 12:00:00 AM,182,315,296
Central,Chesterfield County,51041,1523,8951,10474,2238,21849,24087,283877,3074005,3357882,01/01/2019 12:00:00 AM,186,343,321
Central,Chesterfield County,51041,1523,8992,10515,2224,21960,24184,281921,2901718,3183639,12/01/2018 12:00:00 AM,185,323,303
Central,Chesterfield County,51041,1524,9024,10548,2238,22135,24373,279281,2921709,3200990,11/01/2018 12:00:00 AM,183,324,303
Central,Chesterfield County,51041,1527,8985,10512,2269,21732,24001,267271,2847676,3114947,02/01/2020 12:00:00 AM,175,317,296
Central,Chesterfield County,51041,1533,10386,11919,2402,25718,28120,290238,3269211,3559449,03/01/2015 12:00:00 AM,189,315,299
Central,Chesterfield County,51041,1534,9140,10674,2304,22112,24416,285066,2923482,3208548,12/01/2019 12:00:00 AM,186,320,301
Central,Chesterfield County,51041,1539,9093,10632,2302,21862,24164,414341,3728569,4142910,03/01/2020 12:00:00 AM,269,410,390
Central,Chesterfield County,51041,1544,8825,10369,2288,21304,23592,275114,2808459.67,3083573.67,04/01/2019 12:00:00 AM,178,318,297
Central,Chesterfield County,51041,1547,8866,10413,2281,21520,23801,274904.8,2849661,3124565.8,03/01/2019 12:00:00 AM,178,321,300
Central,Chesterfield County,51041,1558,10544,12102,2169,24343,26512,483154,5190952,5674106,02/01/2021 12:00:00 AM,310,492,469
Central,Chesterfield County,51041,1574,10458,12032,2501,25916,28417,302872,3306592,3609464,02/01/2015 12:00:00 AM,192,316,300
Central,Chesterfield County,51041,1591,10419,12010,2395,24604,26999,438872,4306998,4745870,04/01/2020 12:00:00 AM,276,413,395
Central,Chesterfield County,51041,1599,10532,12131,2258,24267,26525,501604,5133762,5635366,03/01/2021 12:00:00 AM,314,487,465
Central,Chesterfield County,51041,1606,11042,12648,2615,27003,29618,323063,3470976,3794039,12/01/2014 12:00:00 AM,201,314,300
Central,Chesterfield County,51041,1607,10417,12024,2285,23969,26254,549749,5519204,6068953,04/01/2021 12:00:00 AM,342,530,505
Central,Chesterfield County,51041,1610,10356,11966,2313,23772,26085,557156,5505848,6063004,05/01/2021 12:00:00 AM,346,532,507
Central,Chesterfield County,51041,1613,10717,12330,2575,26458,29033,308958,3350462,3659420,01/01/2015 12:00:00 AM,192,313,297
Central,Chesterfield County,51041,1615,10881,12496,2424,25484,27908,438828,4400967,4839795,05/01/2020 12:00:00 AM,272,404,387
Central,Chesterfield County,51041,1616,11403,13019,2648,27296,29944,306732,3420431,3727163,08/01/2014 12:00:00 AM,190,300,286
Central,Chesterfield County,51041,1617,10623,12240,2370,24794,27164,459154,4590355,5049509,11/01/2020 12:00:00 AM,284,432,413
Central,Chesterfield County,51041,1620,10296,11916,2349,23697,26046,562364,5413614,5975978,06/01/2021 12:00:00 AM,347,526,502
Central,Chesterfield County,51041,1620,10395,12015,2367,24035,26402,521653,5022150,5543803,01/01/2021 12:00:00 AM,322,483,461
Central,Chesterfield County,51041,1620,10783,12403,2392,25097,27489,459710,4612663,5072373,10/01/2020 12:00:00 AM,284,428,409
Central,Chesterfield County,51041,1621,11134,12755,2636,27103,29739,323925,3508333,3832258,11/01/2014 12:00:00 AM,200,315,300
Central,Chesterfield County,51041,1622,11204,12826,2664,27110,29774,326347,3504707,3831054,10/01/2014 12:00:00 AM,201,313,299
Central,Chesterfield County,51041,1624,11218,12842,2663,27053,29716,307089,3383574,3690663,09/01/2014 12:00:00 AM,189,302,287
Central,Chesterfield County,51041,1624,11545,13169,2652,27401,30053,307508,3438675,3746183,07/01/2014 12:00:00 AM,189,298,284
Central,Chesterfield County,51041,1627,11051,12678,2449,25810,28259,442607,4441980,4884587,06/01/2020 12:00:00 AM,272,402,385
Central,Chesterfield County,51041,1639,11703,13342,2689,27419,30108,310344,3462795,3773139,05/01/2014 12:00:00 AM,189,296,283
Central,Chesterfield County,51041,1640,11824,13464,2719,27603,30322,311468,3495249,3806717,04/01/2014 12:00:00 AM,190,296,283
Central,Chesterfield County,51041,1645,10631,12276,2402,24764,27166,463364,4528182,4991546,12/01/2020 12:00:00 AM,282,426,407
Central,Chesterfield County,51041,1649,11006,12655,2457,25689,28146,445177,4419166,4864343,09/01/2020 12:00:00 AM,270,402,384
Central,Chesterfield County,51041,1656,11227,12883,2495,26248,28743,452166,4520872,4973038,07/01/2020 12:00:00 AM,273,403,386
Central,Chesterfield County,51041,1661,11158,12819,2498,25999,28497,451606,4446842,4898448,08/01/2020 12:00:00 AM,272,399,382
Central,Chesterfield County,51041,1663,11630,13293,2741,27444,30185,318436,3475431,3793867,06/01/2014 12:00:00 AM,191,299,285
Central,Chesterfield County,51041,1676,11849,13525,2779,27570,30349,320722,3477792,3798514,03/01/2014 12:00:00 AM,191,294,281
Central,Chesterfield County,51041,1692,11241,12933,3023,26431,29454,381929,3534699,3916628,01/01/2012 12:00:00 AM,226,314,303
Central,Chesterfield County,51041,1701,11978,13679,2870,27818,30688,330477,3486317,3816794,01/01/2014 12:00:00 AM,194,291,279
Central,Chesterfield County,51041,1702,11912,13614,2876,27790,30666,330988,3523323,3854311,02/01/2014 12:00:00 AM,194,296,283
Central,Chesterfield County,51041,1713,11233,12946,3062,26410,29472,393457,3570916,3964373,02/01/2012 12:00:00 AM,230,318,306
Central,Chesterfield County,51041,1719,12111,13830,2899,28078,30977,341827,3563793,3905620,12/01/2013 12:00:00 AM,199,294,282
Central,Chesterfield County,51041,1722,12256,13978,2915,28380,31295,340753,3631802,3972555,11/01/2013 12:00:00 AM,198,296,284
Central,Chesterfield County,51041,1734,11263,12997,3098,26427,29525,397667,3563722,3961389,03/01/2012 12:00:00 AM,229,316,305
Central,Chesterfield County,51041,1740,12348,14088,2934,28512,31446,373756,3912048,4285804,08/01/2013 12:00:00 AM,215,317,304
Central,Chesterfield County,51041,1748,11423,13171,3101,26660,29761,395336,3613485,4008821,06/01/2012 12:00:00 AM,226,316,304
Central,Chesterfield County,51041,1749,12331,14080,2930,28499,31429,373600,3899061,4272661,09/01/2013 12:00:00 AM,214,316,303
Central,Chesterfield County,51041,1750,11458,13208,3110,26760,29870,398004,3625261,4023265,07/01/2012 12:00:00 AM,227,316,305
Central,Chesterfield County,51041,1753,12327,14080,2947,28420,31367,371759,3906569,4278328,10/01/2013 12:00:00 AM,212,317,304
Central,Chesterfield County,51041,1756,11194,12950,3144,26268,29412,405814,3557805,3963619,04/01/2012 12:00:00 AM,231,318,306
Central,Chesterfield County,51041,1772,12077,13849,3114,28026,31140,403071,3815980,4219051,03/01/2013 12:00:00 AM,227,316,305
Central,Chesterfield County,51041,1774,11276,13050,3159,26437,29596,406468,3574308,3980776,05/01/2012 12:00:00 AM,229,317,305
Central,Chesterfield County,51041,1778,11622,13400,3174,27000,30174,401878,3679131,4081009,08/01/2012 12:00:00 AM,226,317,305
Central,Chesterfield County,51041,1778,12123,13901,3110,28044,31154,402222,3814470,4216692,04/01/2013 12:00:00 AM,226,315,303
Central,Chesterfield County,51041,1782,11666,13448,3143,27188,30331,401247,3705861,4107108,09/01/2012 12:00:00 AM,225,318,305
Central,Chesterfield County,51041,1782,12183,13965,3106,28173,31279,399021,3841841,4240862,05/01/2013 12:00:00 AM,224,315,304
Central,Chesterfield County,51041,1783,12271,14054,3074,28350,31424,392078,3881405,4273483,07/01/2013 12:00:00 AM,220,316,304
Central,Chesterfield County,51041,1790,11974,13764,3122,27880,31002,402476,3765454,4167930,01/01/2013 12:00:00 AM,225,314,303
Central,Chesterfield County,51041,1792,11870,13662,3123,27687,30810,405630,3783067,4188697,11/01/2012 12:00:00 AM,226,319,307
Central,Chesterfield County,51041,1795,11837,13632,3131,27567,30698,408739,3774355,4183094,10/01/2012 12:00:00 AM,228,319,307
Central,Chesterfield County,51041,1800,12265,14065,3129,28329,31458,405020,3883338,4288358,06/01/2013 12:00:00 AM,225,317,305
Central,Chesterfield County,51041,1802,11923,13725,3151,27743,30894,412388,3787383,4199771,12/01/2012 12:00:00 AM,229,318,306
Central,Chesterfield County,51041,1802,12079,13881,3137,28079,31216,405509,3822030,4227539,02/01/2013 12:00:00 AM,225,316,305
Central,Colonial Heights City,51570,128,834,962,181,2059,2240,20122,257616,277738,10/01/2016 12:00:00 AM,157,309,289
Central,Colonial Heights City,51570,131,814,945,207,2004,2211,24619,246553,271172,07/01/2016 12:00:00 AM,188,303,287
Central,Colonial Heights City,51570,133,828,961,187,2038,2225,22040,259245,281285,11/01/2016 12:00:00 AM,166,313,293
Central,Colonial Heights City,51570,134,828,962,189,2025,2214,22833,253455,276288,12/01/2016 12:00:00 AM,170,306,287
Central,Colonial Heights City,51570,135,804,939,212,1970,2182,24615,243364,267979,06/01/2016 12:00:00 AM,182,303,285
Central,Colonial Heights City,51570,135,807,942,199,2000,2199,22707,250491,273198,09/01/2016 12:00:00 AM,168,310,290
Central,Colonial Heights City,51570,135,815,950,209,2010,2219,24398,249744,274142,08/01/2016 12:00:00 AM,181,306,289
Central,Colonial Heights City,51570,137,839,976,215,2064,2279,27373,262938,290311,04/01/2018 12:00:00 AM,200,313,297
Central,Colonial Heights City,51570,137,853,990,216,2089,2305,27346,266634.19,293980.19,05/01/2018 12:00:00 AM,200,313,297
Central,Colonial Heights City,51570,138,827,965,214,2013,2227,25720,252526,278246,05/01/2016 12:00:00 AM,186,305,288
Central,Colonial Heights City,51570,138,842,980,211,2039,2250,26815,262027,288842,07/01/2018 12:00:00 AM,194,311,295
Central,Colonial Heights City,51570,138,843,981,198,2043,2241,24956,256508,281464,01/01/2017 12:00:00 AM,181,304,287
Central,Colonial Heights City,51570,140,842,982,205,2061,2266,24331,264617,288948,06/01/2015 12:00:00 AM,174,314,294
Central,Colonial Heights City,51570,140,844,984,228,2043,2271,27821,264687,292508,02/01/2015 12:00:00 AM,199,314,297
Central,Colonial Heights City,51570,140,848,988,235,2034,2269,29494,262216,291710,01/01/2015 12:00:00 AM,211,309,295
Central,Colonial Heights City,51570,141,830,971,214,2035,2249,25665,256732,282397,02/01/2016 12:00:00 AM,182,309,291
Central,Colonial Heights City,51570,141,840,981,210,2031,2241,26059,256563,282622,03/01/2016 12:00:00 AM,185,305,288
Central,Colonial Heights City,51570,142,813,955,216,1982,2198,26168,256583,282751,05/01/2015 12:00:00 AM,184,316,296
Central,Colonial Heights City,51570,142,825,967,223,1993,2216,27714,251422,279136,04/01/2016 12:00:00 AM,195,305,289
Central,Colonial Heights City,51570,142,849,991,223,2092,2315,28807,274128,302935,03/01/2018 12:00:00 AM,203,323,306
Central,Colonial Heights City,51570,142,857,999,235,2059,2294,29957,266997,296954,12/01/2014 12:00:00 AM,211,312,297
Central,Colonial Heights City,51570,143,790,933,206,1868,2074,25714,243304,269018,02/01/2019 12:00:00 AM,180,308,288
Central,Colonial Heights City,51570,143,811,954,223,1953,2176,27623,251716,279339,09/01/2018 12:00:00 AM,193,310,293
Central,Colonial Heights City,51570,143,831,974,208,1974,2182,26869,266074,292943,01/01/2019 12:00:00 AM,188,320,301
Central,Colonial Heights City,51570,143,851,994,233,2060,2293,29731,265331.8,295062.8,06/01/2018 12:00:00 AM,208,312,297
Central,Colonial Heights City,51570,144,823,967,210,2014,2224,25473,251123,276596,02/01/2017 12:00:00 AM,177,305,286
Central,Colonial Heights City,51570,144,838,982,227,2016,2243,27795,258299,286094,04/01/2015 12:00:00 AM,193,308,291
Central,Colonial Heights City,51570,144,848,992,226,2062,2288,27833,266775,294608,03/01/2015 12:00:00 AM,193,315,297
Central,Colonial Heights City,51570,144,863,1007,240,2053,2293,29571,266296,295867,10/01/2014 12:00:00 AM,205,309,294
Central,Colonial Heights City,51570,144,884,1028,209,2077,2286,25408,267951,293359,07/01/2019 12:00:00 AM,176,303,285
Central,Colonial Heights City,51570,144,888,1032,237,2089,2326,27198,261914,289112,08/01/2014 12:00:00 AM,189,295,280
Central,Colonial Heights City,51570,144,916,1060,237,2153,2390,27018,271559,298577,07/01/2014 12:00:00 AM,188,296,282
Central,Colonial Heights City,51570,145,807,952,224,1976,2200,26408,249576,275984,09/01/2015 12:00:00 AM,182,309,290
Central,Colonial Heights City,51570,145,811,956,223,2016,2239,26936,255353,282289,11/01/2015 12:00:00 AM,186,315,295
Central,Colonial Heights City,51570,145,812,957,225,2020,2245,27458,254052,281510,01/01/2016 12:00:00 AM,189,313,294
Central,Colonial Heights City,51570,145,829,974,224,2025,2249,28413,262295,290708,11/01/2018 12:00:00 AM,196,316,298
Central,Colonial Heights City,51570,145,860,1005,211,2043,2254,26221,267176,293397,05/01/2019 12:00:00 AM,181,311,292
Central,Colonial Heights City,51570,145,875,1020,241,2057,2298,28678,254915,283593,09/01/2014 12:00:00 AM,198,291,278
Central,Colonial Heights City,51570,145,879,1024,216,2067,2283,25871,274699,300570,11/01/2019 12:00:00 AM,178,313,294
Central,Colonial Heights City,51570,146,819,965,217,1988,2205,27336,260496,287832,12/01/2018 12:00:00 AM,187,318,298
Central,Colonial Heights City,51570,146,826,972,223,1997,2220,28324,261550,289874,10/01/2018 12:00:00 AM,194,317,298
Central,Colonial Heights City,51570,146,834,980,229,2024,2253,28857,266182,295039,08/01/2018 12:00:00 AM,198,319,301
Central,Colonial Heights City,51570,147,806,953,229,1976,2205,28073,249071,277144,10/01/2015 12:00:00 AM,191,309,291
Central,Colonial Heights City,51570,147,819,966,231,2037,2268,29430,270105,299535,02/01/2018 12:00:00 AM,200,330,310
Central,Colonial Heights City,51570,147,830,977,230,2069,2299,26886,272722,299608,01/01/2018 12:00:00 AM,183,329,307
Central,Colonial Heights City,51570,147,848,995,222,2102,2324,27312,263944,291256,12/01/2015 12:00:00 AM,186,311,293
Central,Colonial Heights City,51570,147,863,1010,222,2013,2235,26117,264434,290551,01/01/2020 12:00:00 AM,178,306,288
Central,Colonial Heights City,51570,147,876,1023,223,2041,2264,26458,266699,293157,02/01/2020 12:00:00 AM,180,304,287
Central,Colonial Heights City,51570,148,822,970,226,1993,2219,26767,251999,278766,07/01/2015 12:00:00 AM,181,307,287
Central,Colonial Heights City,51570,148,872,1020,222,2052,2274,26915,275423,302338,12/01/2019 12:00:00 AM,182,316,296
Central,Colonial Heights City,51570,148,943,1091,229,2164,2393,26751,273082,299833,05/01/2014 12:00:00 AM,181,290,275
Central,Colonial Heights City,51570,149,840,989,227,2094,2321,29586,279725,309311,10/01/2017 12:00:00 AM,199,333,313
Central,Colonial Heights City,51570,149,849,998,214,2013,2227,26838,256723,283561,04/01/2019 12:00:00 AM,180,302,284
Central,Colonial Heights City,51570,149,869,1018,249,2078,2327,31157,269934,301091,11/01/2014 12:00:00 AM,209,311,296
Central,Colonial Heights City,51570,149,935,1084,234,2186,2420,27107,296551,323658,04/01/2013 12:00:00 AM,182,317,299
Central,Colonial Heights City,51570,149,938,1087,233,2148,2381,27001,269134,296135,04/01/2014 12:00:00 AM,181,287,272
Central,Colonial Heights City,51570,150,803,953,236,1952,2188,27670,246296,273966,08/01/2015 12:00:00 AM,184,307,287
Central,Colonial Heights City,51570,150,830,980,228,2041,2269,30416,272139,302555,06/01/2017 12:00:00 AM,203,328,309
Central,Colonial Heights City,51570,150,840,990,221,1996,2217,28070,258896,286966,03/01/2019 12:00:00 AM,187,308,290
Central,Colonial Heights City,51570,150,854,1004,235,2134,2369,29103,283222,312325,12/01/2017 12:00:00 AM,194,332,311
Central,Colonial Heights City,51570,150,877,1027,215,2069,2284,26947,265725,292672,08/01/2019 12:00:00 AM,180,303,285
Central,Colonial Heights City,51570,150,925,1075,238,2166,2404,27521,276196,303717,06/01/2014 12:00:00 AM,183,299,283
Central,Colonial Heights City,51570,151,825,976,221,2032,2253,29209,269083,298292,05/01/2017 12:00:00 AM,193,326,306
Central,Colonial Heights City,51570,151,861,1012,240,2159,2399,30546,288640,319186,11/01/2017 12:00:00 AM,202,335,315
Central,Colonial Heights City,51570,151,878,1029,217,2058,2275,26253,269743,295996,10/01/2019 12:00:00 AM,174,307,288
Central,Colonial Heights City,51570,151,928,1079,232,2158,2390,26878,269529,296407,02/01/2014 12:00:00 AM,178,290,275
Central,Colonial Heights City,51570,151,932,1083,227,2166,2393,26606,268198,294804,03/01/2014 12:00:00 AM,176,288,272
Central,Colonial Heights City,51570,151,981,1132,225,2256,2481,40524,398553,439077,04/01/2020 12:00:00 AM,268,406,388
Central,Colonial Heights City,51570,152,839,991,238,2056,2294,31039,281374.2,312413.2,07/01/2017 12:00:00 AM,204,335,315
Central,Colonial Heights City,51570,152,867,1019,224,2045,2269,27435,263560,290995,06/01/2019 12:00:00 AM,180,304,286
Central,Colonial Heights City,51570,152,875,1027,228,2032,2260,41182,348697,389879,03/01/2020 12:00:00 AM,271,399,380
Central,Colonial Heights City,51570,153,803,956,221,1993,2214,28144,263248,291392,04/01/2017 12:00:00 AM,184,328,305
Central,Colonial Heights City,51570,153,867,1020,219,2033,2252,25868,264949,290817,09/01/2019 12:00:00 AM,169,306,285
Central,Colonial Heights City,51570,154,837,991,215,2083,2298,28125,270411,298536,03/01/2017 12:00:00 AM,183,323,301
Central,Colonial Heights City,51570,154,853,1007,265,1911,2176,32715,254737,287452,05/01/2012 12:00:00 AM,212,299,285
Central,Colonial Heights City,51570,155,1027,1182,231,2327,2558,41514,402641,444155,05/01/2020 12:00:00 AM,268,392,376
Central,Colonial Heights City,51570,155,1051,1206,232,2392,2624,42262,412962,455224,06/01/2020 12:00:00 AM,273,393,377
Central,Colonial Heights City,51570,155,826,981,246,2050,2296,32537,279447,311984,08/01/2017 12:00:00 AM,210,338,318
Central,Colonial Heights City,51570,155,947,1102,243,2178,2421,29223,298593,327816,06/01/2013 12:00:00 AM,189,315,297
Central,Colonial Heights City,51570,156,845,1001,248,2094,2342,33345,282268,315613,09/01/2017 12:00:00 AM,214,334,315
Central,Colonial Heights City,51570,156,850,1006,260,1936,2196,31728,259016,290744,06/01/2012 12:00:00 AM,203,305,289
Central,Colonial Heights City,51570,156,896,1052,252,2063,2315,30461,278373,308834,10/01/2012 12:00:00 AM,195,311,294
Central,Colonial Heights City,51570,156,905,1061,245,2081,2326,29431,281133,310564,12/01/2012 12:00:00 AM,189,311,293
Central,Colonial Heights City,51570,156,941,1097,240,2208,2448,28909,297314,326223,07/01/2013 12:00:00 AM,185,316,297
Central,Colonial Heights City,51570,156,942,1098,245,2183,2428,28653,294112,322765,05/01/2013 12:00:00 AM,184,312,294
Central,Colonial Heights City,51570,157,1061,1218,236,2407,2643,42231,417036,459267,08/01/2020 12:00:00 AM,269,393,377
Central,Colonial Heights City,51570,157,1070,1227,232,2456,2688,42397,421584,463981,07/01/2020 12:00:00 AM,270,394,378
Central,Colonial Heights City,51570,157,953,1110,230,2145,2375,50682,461304,511986,02/01/2021 12:00:00 AM,323,484,461
Central,Colonial Heights City,51570,158,846,1004,273,1911,2184,32773,258342,291115,07/01/2012 12:00:00 AM,207,305,290
Central,Colonial Heights City,51570,158,946,1104,238,2116,2354,50881,441619,492500,01/01/2021 12:00:00 AM,322,467,446
Central,Colonial Heights City,51570,158,952,1110,248,2192,2440,27919,298342,326261,03/01/2013 12:00:00 AM,177,313,294
Central,Colonial Heights City,51570,158,956,1114,246,2247,2493,28016,276251,304267,12/01/2013 12:00:00 AM,177,289,273
Central,Colonial Heights City,51570,158,967,1125,257,2251,2508,31424,302734,334158,10/01/2013 12:00:00 AM,199,313,297
Central,Colonial Heights City,51570,159,889,1048,259,2032,2291,31281,275452,306733,11/01/2012 12:00:00 AM,197,310,293
Central,Colonial Heights City,51570,159,908,1067,237,2025,2262,55630,465755,521385,05/01/2021 12:00:00 AM,350,513,489
Central,Colonial Heights City,51570,159,919,1078,246,2132,2378,26646,262289,288935,01/01/2014 12:00:00 AM,168,285,268
Central,Colonial Heights City,51570,159,949,1108,236,2136,2372,51676,453328,505004,03/01/2021 12:00:00 AM,325,478,456
Central,Colonial Heights City,51570,159,952,1111,262,2189,2451,32611,300057,332668,08/01/2013 12:00:00 AM,205,315,299
Central,Colonial Heights City,51570,159,961,1120,243,2219,2462,26991,279134,306125,11/01/2013 12:00:00 AM,170,290,273
Central,Colonial Heights City,51570,159,976,1135,243,2194,2437,46834,409052,455886,11/01/2020 12:00:00 AM,295,419,402
Central,Colonial Heights City,51570,160,836,996,289,1903,2192,35635,250177,285812,01/01/2012 12:00:00 AM,223,299,287
Central,Colonial Heights City,51570,160,872,1032,273,1966,2239,32780,264569,297349,08/01/2012 12:00:00 AM,205,303,288
Central,Colonial Heights City,51570,160,964,1124,245,2164,2409,46325,392817,439142,12/01/2020 12:00:00 AM,290,407,391
Central,Colonial Heights City,51570,162,852,1014,292,1926,2218,36404,255272,291676,02/01/2012 12:00:00 AM,225,300,288
Central,Colonial Heights City,51570,162,951,1113,265,2204,2469,32389,297596,329985,09/01/2013 12:00:00 AM,200,313,296
Central,Colonial Heights City,51570,163,1023,1186,246,2338,2584,44962,399436,444398,09/01/2020 12:00:00 AM,276,390,375
Central,Colonial Heights City,51570,163,904,1067,270,2066,2336,30708,278072,308780,01/01/2013 12:00:00 AM,188,308,289
Central,Colonial Heights City,51570,163,913,1076,272,2101,2373,30551,283034,313585,02/01/2013 12:00:00 AM,187,310,291
Central,Colonial Heights City,51570,164,1013,1177,249,2297,2546,46098,421573,467671,10/01/2020 12:00:00 AM,281,416,397
Central,Colonial Heights City,51570,164,850,1014,293,1889,2182,36492,252341,288833,04/01/2012 12:00:00 AM,223,297,285
Central,Colonial Heights City,51570,164,856,1020,299,1918,2217,37036,256064,293100,03/01/2012 12:00:00 AM,226,299,287
Central,Colonial Heights City,51570,164,880,1044,274,2005,2279,33319,271435,304754,09/01/2012 12:00:00 AM,203,308,292
Central,Colonial Heights City,51570,164,920,1084,245,2054,2299,57495,479440,536935,04/01/2021 12:00:00 AM,351,521,495
Central,Colonial Heights City,51570,166,924,1090,251,2073,2324,59223,477850,537073,06/01/2021 12:00:00 AM,357,517,493
Central,Cumberland County,51049,144,756,900,197,1642,1839,46507,375243,421750,04/01/2021 12:00:00 AM,323,496,469
Central,Cumberland County,51049,145,765,910,194,1673,1867,42601,351541,394142,03/01/2021 12:00:00 AM,294,460,433
Central,Cumberland County,51049,146,742,888,194,1638,1832,45255,361507.58,406762.58,02/01/2021 12:00:00 AM,310,487,458
Central,Cumberland County,51049,147,749,896,206,1626,1832,48946,368272,417218,05/01/2021 12:00:00 AM,333,492,466
Central,Cumberland County,51049,149,761,910,211,1610,1821,49305,372198,421503,06/01/2021 12:00:00 AM,331,489,463
Central,Cumberland County,51049,151,643,794,213,1403,1616,22705,170321,193026,02/01/2019 12:00:00 AM,150,265,243
Central,Cumberland County,51049,151,689,840,213,1522,1735,19693,187648,207341,02/01/2020 12:00:00 AM,130,272,247
Central,Cumberland County,51049,153,681,834,225,1478,1703,26200,191740,217940,01/01/2019 12:00:00 AM,171,282,261
Central,Cumberland County,51049,153,693,846,219,1519,1738,21632,190790,212422,11/01/2019 12:00:00 AM,141,275,251
Central,Cumberland County,51049,153,698,851,220,1541,1761,20682,189366,210048,01/01/2020 12:00:00 AM,135,271,247
Central,Cumberland County,51049,154,698,852,221,1549,1770,21707,195698,217405,12/01/2019 12:00:00 AM,141,280,255
Central,Cumberland County,51049,154,728,882,224,1587,1811,48922,329025,377947,01/01/2021 12:00:00 AM,318,452,429
Central,Cumberland County,51049,154,745,899,216,1635,1851,42082,297869,339951,10/01/2020 12:00:00 AM,273,400,378
Central,Cumberland County,51049,155,677,832,223,1489,1712,23776,183470,207246,12/01/2018 12:00:00 AM,153,271,249
Central,Cumberland County,51049,155,704,859,218,1548,1766,39497,265043,304540,03/01/2020 12:00:00 AM,255,376,355
Central,Cumberland County,51049,155,744,899,215,1643,1858,41360,295627,336987,12/01/2020 12:00:00 AM,267,397,375
Central,Cumberland County,51049,155,754,909,222,1667,1889,40393,281021,321414,08/01/2020 12:00:00 AM,261,373,354
Central,Cumberland County,51049,155,755,910,223,1656,1879,40668,287615,328283,04/01/2020 12:00:00 AM,262,381,361
Central,Cumberland County,51049,156,686,842,229,1498,1727,21970,183827,205797,04/01/2019 12:00:00 AM,141,268,244
Central,Cumberland County,51049,156,689,845,226,1523,1749,22860,188835,211695,09/01/2019 12:00:00 AM,147,274,251
Central,Cumberland County,51049,156,690,846,227,1501,1728,23304,184589,207893,03/01/2019 12:00:00 AM,149,268,246
Central,Cumberland County,51049,156,738,894,218,1640,1858,42145,299788,341933,11/01/2020 12:00:00 AM,270,406,382
Central,Cumberland County,51049,156,745,901,222,1643,1865,40051,282669,322720,09/01/2020 12:00:00 AM,257,379,358
Central,Cumberland County,51049,156,758,914,227,1665,1892,40799,286962,327761,05/01/2020 12:00:00 AM,262,379,359
Central,Cumberland County,51049,158,682,840,225,1495,1720,20866,180772,201638,05/01/2019 12:00:00 AM,132,265,240
Central,Cumberland County,51049,158,692,850,228,1544,1772,23544,194934,218478,10/01/2019 12:00:00 AM,149,282,257
Central,Cumberland County,51049,159,684,843,225,1503,1728,23351,185051,208402,11/01/2018 12:00:00 AM,147,271,247
Central,Cumberland County,51049,159,755,914,226,1644,1870,40570,283028,323598,06/01/2020 12:00:00 AM,255,375,354
Central,Cumberland County,51049,160,676,836,230,1485,1715,23064,182956,206020,06/01/2019 12:00:00 AM,144,271,246
Central,Cumberland County,51049,160,691,851,233,1518,1751,23190,189039,212229,08/01/2019 12:00:00 AM,145,274,249
Central,Cumberland County,51049,161,754,915,228,1659,1887,42018,286570,328588,07/01/2020 12:00:00 AM,261,380,359
Central,Cumberland County,51049,162,678,840,228,1506,1734,25812,204227,230039,10/01/2018 12:00:00 AM,159,301,274
Central,Cumberland County,51049,163,689,852,236,1519,1755,23330,184568,207898,07/01/2019 12:00:00 AM,143,268,244
Central,Cumberland County,51049,165,666,831,233,1492,1725,23372,181731,205103,08/01/2018 12:00:00 AM,142,273,247
Central,Cumberland County,51049,167,671,838,232,1504,1736,23437,183901,207338,09/01/2018 12:00:00 AM,140,274,247
Central,Cumberland County,51049,168,655,823,237,1492,1729,24244,180272,204516,07/01/2018 12:00:00 AM,144,275,249
Central,Cumberland County,51049,170,656,826,237,1455,1692,24386,173073,197459,04/01/2018 12:00:00 AM,143,264,239
Central,Cumberland County,51049,170,659,829,236,1501,1737,23541,180320,203861,05/01/2018 12:00:00 AM,138,274,246
Central,Cumberland County,51049,170,666,836,237,1502,1739,23773,180631,204404,06/01/2018 12:00:00 AM,140,271,245
Central,Cumberland County,51049,171,663,834,230,1489,1719,21828,178596,200424,03/01/2018 12:00:00 AM,128,269,240
Central,Cumberland County,51049,171,666,837,230,1488,1718,22799,180302,203101,11/01/2017 12:00:00 AM,133,271,243
Central,Cumberland County,51049,171,673,844,212,1548,1760,21400,186154,207554,03/01/2017 12:00:00 AM,125,277,246
Central,Cumberland County,51049,171,674,845,217,1559,1776,21384,192108,213492,05/01/2017 12:00:00 AM,125,285,253
Central,Cumberland County,51049,172,661,833,220,1526,1746,21712,184107,205819,04/01/2017 12:00:00 AM,126,279,247
Central,Cumberland County,51049,172,898,1070,258,2040,2298,25075,236501,261576,02/01/2014 12:00:00 AM,146,263,244
Central,Cumberland County,51049,173,663,836,237,1483,1720,23907,178752,202659,12/01/2017 12:00:00 AM,138,270,242
Central,Cumberland County,51049,173,667,840,223,1530,1753,21197,188870,210067,07/01/2017 12:00:00 AM,123,283,250
Central,Cumberland County,51049,173,671,844,222,1540,1762,20793,193400,214193,06/01/2017 12:00:00 AM,120,288,254
Central,Cumberland County,51049,173,838,1011,262,1912,2174,25263,222308,247571,06/01/2014 12:00:00 AM,146,265,245
Central,Cumberland County,51049,173,870,1043,259,1979,2238,25826,231894,257720,05/01/2014 12:00:00 AM,149,267,247
Central,Cumberland County,51049,173,891,1064,250,2049,2299,23125,238238,261363,03/01/2014 12:00:00 AM,134,267,246
Central,Cumberland County,51049,174,664,838,224,1488,1712,21877,186454,208331,09/01/2017 12:00:00 AM,126,281,249
Central,Cumberland County,51049,174,675,849,236,1496,1732,22778,178948,201726,01/01/2018 12:00:00 AM,131,265,238
Central,Cumberland County,51049,174,676,850,231,1485,1716,23666,179535,203201,10/01/2017 12:00:00 AM,136,266,239
Central,Cumberland County,51049,174,702,876,229,1689,1918,23989,193426,217415,10/01/2015 12:00:00 AM,138,276,248
Central,Cumberland County,51049,174,890,1064,252,2022,2274,23602,237094,260696,04/01/2014 12:00:00 AM,136,266,245
Central,Cumberland County,51049,174,900,1074,259,2026,2285,25039,236570,261609,12/01/2013 12:00:00 AM,144,263,244
Central,Cumberland County,51049,174,905,1079,255,2058,2313,24278,237421,261699,01/01/2014 12:00:00 AM,140,262,243
Central,Cumberland County,51049,175,659,834,239,1470,1709,23800,175137,198937,02/01/2018 12:00:00 AM,136,266,239
Central,Cumberland County,51049,175,678,853,225,1545,1770,22421,191364,213785,08/01/2017 12:00:00 AM,128,282,251
Central,Cumberland County,51049,175,883,1058,273,2027,2300,29984,250760,280744,08/01/2013 12:00:00 AM,171,284,265
Central,Cumberland County,51049,176,827,1003,266,1891,2157,25025,218512,243537,07/01/2014 12:00:00 AM,142,264,243
Central,Cumberland County,51049,176,884,1060,276,1983,2259,29996,248149,278145,10/01/2013 12:00:00 AM,170,281,262
Central,Cumberland County,51049,177,811,988,266,1873,2139,26126,216741,242867,08/01/2014 12:00:00 AM,148,267,246
Central,Cumberland County,51049,178,698,876,236,1672,1908,23891,192440,216331,11/01/2015 12:00:00 AM,134,276,247
Central,Cumberland County,51049,178,700,878,242,1651,1893,23674,192254,215928,08/01/2015 12:00:00 AM,133,275,246
Central,Cumberland County,51049,178,774,952,275,1805,2080,29379,210611,239990,11/01/2014 12:00:00 AM,165,272,252
Central,Cumberland County,51049,178,803,981,277,1841,2118,27943,211095,239038,09/01/2014 12:00:00 AM,157,263,244
Central,Cumberland County,51049,178,860,1038,280,1982,2262,30051,245991,276042,06/01/2013 12:00:00 AM,169,286,266
Central,Cumberland County,51049,178,882,1060,270,1994,2264,26489,232328,258817,11/01/2013 12:00:00 AM,149,263,244
Central,Cumberland County,51049,179,705,884,237,1674,1911,23790,193530,217320,12/01/2015 12:00:00 AM,133,275,246
Central,Cumberland County,51049,179,885,1064,280,2009,2289,30691,249995,280686,09/01/2013 12:00:00 AM,171,282,264
Central,Cumberland County,51049,180,692,872,238,1657,1895,24316,189154,213470,01/01/2016 12:00:00 AM,135,273,245
Central,Cumberland County,51049,180,702,882,246,1665,1911,24447,193988,218435,07/01/2015 12:00:00 AM,136,276,248
Central,Cumberland County,51049,180,750,930,286,1760,2046,31374,203371,234745,12/01/2014 12:00:00 AM,174,271,252
Central,Cumberland County,51049,181,706,887,252,1682,1934,25485,194063,219548,09/01/2015 12:00:00 AM,141,275,248
Central,Cumberland County,51049,181,786,967,280,1805,2085,30227,213418,243645,10/01/2014 12:00:00 AM,167,272,252
Central,Cumberland County,51049,181,868,1049,290,1990,2280,31559,243644,275203,07/01/2013 12:00:00 AM,174,281,262
Central,Cumberland County,51049,182,668,850,258,1575,1833,26077,181874,207951,05/01/2016 12:00:00 AM,143,272,245
Central,Cumberland County,51049,182,705,887,264,1666,1930,27572,192390,219962,05/01/2015 12:00:00 AM,151,273,248
Central,Cumberland County,51049,182,737,919,283,1718,2001,29480,195029,224509,02/01/2015 12:00:00 AM,162,265,244
Central,Cumberland County,51049,183,701,884,245,1625,1870,23972,189149,213121,02/01/2017 12:00:00 AM,131,270,241
Central,Cumberland County,51049,183,702,885,262,1680,1942,27713,196146,223859,06/01/2015 12:00:00 AM,151,279,253
Central,Cumberland County,51049,183,754,937,286,1767,2053,30011,199941,229952,01/01/2015 12:00:00 AM,164,265,245
Central,Cumberland County,51049,183,835,1018,282,1962,2244,30075,240046,270121,05/01/2012 12:00:00 AM,164,287,265
Central,Cumberland County,51049,184,695,879,247,1657,1904,24811,190961,215772,02/01/2016 12:00:00 AM,135,275,245
Central,Cumberland County,51049,184,819,1003,286,1915,2201,31342,238757,270099,06/01/2012 12:00:00 AM,170,292,269
Central,Cumberland County,51049,184,842,1026,284,1935,2219,29059,232666,261725,02/01/2012 12:00:00 AM,158,276,255
Central,Cumberland County,51049,185,687,872,242,1587,1829,22915,188477,211392,01/01/2017 12:00:00 AM,124,274,242
Central,Cumberland County,51049,185,718,903,278,1690,1968,29785,194052,223837,04/01/2015 12:00:00 AM,161,270,248
Central,Cumberland County,51049,185,859,1044,298,1967,2265,32020,241660,273680,05/01/2013 12:00:00 AM,173,281,262
Central,Cumberland County,51049,185,872,1057,297,2003,2300,32445,251276,283721,04/01/2013 12:00:00 AM,175,288,268
Central,Cumberland County,51049,186,663,849,267,1552,1819,26186,180275,206461,06/01/2016 12:00:00 AM,141,272,243
Central,Cumberland County,51049,186,680,866,259,1599,1858,26450,183363,209813,04/01/2016 12:00:00 AM,142,270,242
Central,Cumberland County,51049,187,685,872,257,1605,1862,26505,185002,211507,03/01/2016 12:00:00 AM,142,270,243
Central,Cumberland County,51049,187,727,914,290,1688,1978,30565,195716,226281,03/01/2015 12:00:00 AM,163,269,248
Central,Cumberland County,51049,187,824,1011,293,1922,2215,32406,238116,270522,07/01/2012 12:00:00 AM,173,289,268
Central,Cumberland County,51049,188,828,1016,296,1937,2233,32354,234221,266575,04/01/2012 12:00:00 AM,172,283,262
Central,Cumberland County,51049,188,842,1030,297,1958,2255,33869,243978,277847,09/01/2012 12:00:00 AM,180,290,270
Central,Cumberland County,51049,188,845,1033,293,1967,2260,32273,246409,278682,08/01/2012 12:00:00 AM,172,292,270
Central,Cumberland County,51049,188,860,1048,308,1979,2287,34800,247702,282502,11/01/2012 12:00:00 AM,185,288,270
Central,Cumberland County,51049,189,658,847,273,1538,1811,27028,176414,203442,07/01/2016 12:00:00 AM,143,268,240
Central,Cumberland County,51049,189,673,862,262,1559,1821,25404,180588,205992,11/01/2016 12:00:00 AM,134,268,239
Central,Cumberland County,51049,189,685,874,257,1589,1846,24861,186254,211115,12/01/2016 12:00:00 AM,132,272,242
Central,Cumberland County,51049,190,852,1042,301,1942,2243,32400,242731,275131,03/01/2013 12:00:00 AM,171,285,264
Central,Cumberland County,51049,191,833,1024,294,1936,2230,30171,232127,262298,01/01/2012 12:00:00 AM,158,279,256
Central,Cumberland County,51049,191,842,1033,300,1953,2253,31685,235679,267364,03/01/2012 12:00:00 AM,166,280,259
Central,Cumberland County,51049,192,849,1041,327,1949,2276,37835,240232,278067,12/01/2012 12:00:00 AM,197,283,267
Central,Cumberland County,51049,193,842,1035,317,1944,2261,36424,241613,278037,10/01/2012 12:00:00 AM,189,287,269
Central,Cumberland County,51049,195,668,863,282,1576,1858,27529,181295,208824,08/01/2016 12:00:00 AM,141,271,242
Central,Cumberland County,51049,195,849,1044,332,1912,2244,38533,236302,274835,02/01/2013 12:00:00 AM,198,278,263
Central,Cumberland County,51049,198,674,872,276,1578,1854,27478,185080,212558,10/01/2016 12:00:00 AM,139,275,244
Central,Cumberland County,51049,198,678,876,284,1585,1869,27866,182249,210115,09/01/2016 12:00:00 AM,141,269,240
Central,Cumberland County,51049,198,845,1043,338,1920,2258,38184,233590,271774,01/01/2013 12:00:00 AM,193,276,261
Central,Essex County,51057,124,679,803,169,1533,1702,16689,177604,194293,06/01/2019 12:00:00 AM,135,262,242
Central,Essex County,51057,128,662,790,175,1490,1665,17898,171098,188996,07/01/2019 12:00:00 AM,140,258,239
Central,Essex County,51057,130,694,824,175,1548,1723,18066,183029,201095,04/01/2019 12:00:00 AM,139,264,244
Central,Essex County,51057,131,682,813,181,1566,1747,18912,179651,198563,08/01/2019 12:00:00 AM,144,263,244
Central,Essex County,51057,132,693,825,171,1584,1755,17147,181730,198877,11/01/2019 12:00:00 AM,130,262,241
Central,Essex County,51057,132,697,829,177,1556,1733,17283,178301,195584,05/01/2019 12:00:00 AM,131,256,236
Central,Essex County,51057,132,702,834,181,1603,1784,17816,187195,205011,12/01/2018 12:00:00 AM,135,267,246
Central,Essex County,51057,133,699,832,182,1579,1761,18213,180878,199091,02/01/2019 12:00:00 AM,137,259,239
Central,Essex County,51057,136,675,811,184,1541,1725,19744,176574,196318,10/01/2019 12:00:00 AM,145,262,242
Central,Essex County,51057,136,681,817,184,1562,1746,19365,179979,199344,09/01/2019 12:00:00 AM,142,264,244
Central,Essex County,51057,136,701,837,190,1575,1765,19983,182939,202922,03/01/2019 12:00:00 AM,147,261,242
Central,Essex County,51057,137,664,801,174,1511,1685,32556,255575,288131,03/01/2020 12:00:00 AM,238,385,360
Central,Essex County,51057,137,696,833,189,1571,1760,19271,181127,200398,01/01/2019 12:00:00 AM,141,260,241
Central,Essex County,51057,139,661,800,180,1481,1661,17975,170063,188038,02/01/2020 12:00:00 AM,129,257,235
Central,Essex County,51057,139,703,842,191,1616,1807,19981,190826,210807,11/01/2018 12:00:00 AM,144,271,250
Central,Essex County,51057,140,693,833,187,1590,1777,19658,182995,202653,12/01/2019 12:00:00 AM,140,264,243
Central,Essex County,51057,141,742,883,181,1650,1831,40548,348583,389131,03/01/2021 12:00:00 AM,288,470,441
Central,Essex County,51057,142,692,834,195,1600,1795,19884,195120,215004,10/01/2018 12:00:00 AM,140,282,258
Central,Essex County,51057,142,722,864,181,1626,1807,33535,281134,314669,04/01/2020 12:00:00 AM,236,389,364
Central,Essex County,51057,142,743,885,180,1652,1832,40390,351139.94,391529.94,02/01/2021 12:00:00 AM,284,473,442
Central,Essex County,51057,143,677,820,187,1533,1720,18498,179240,197738,01/01/2020 12:00:00 AM,129,265,241
Central,Essex County,51057,144,715,859,187,1578,1765,37597,286156,323753,10/01/2020 12:00:00 AM,261,400,377
Central,Essex County,51057,144,741,885,189,1632,1821,44078,367542,411620,04/01/2021 12:00:00 AM,306,496,465
Central,Essex County,51057,145,745,890,191,1642,1833,45219,372555,417774,05/01/2021 12:00:00 AM,312,500,469
Central,Essex County,51057,146,722,868,190,1596,1786,37304,289285,326589,12/01/2020 12:00:00 AM,256,401,376
Central,Essex County,51057,146,724,870,190,1617,1807,35231,275262,310493,08/01/2020 12:00:00 AM,241,380,357
Central,Essex County,51057,147,708,855,213,1643,1856,21818,196491,218309,08/01/2018 12:00:00 AM,148,278,255
Central,Essex County,51057,147,717,864,191,1619,1810,35929,277391,313320,05/01/2020 12:00:00 AM,244,387,363
Central,Essex County,51057,147,726,873,192,1607,1799,35395,277048,312443,09/01/2020 12:00:00 AM,241,382,358
Central,Essex County,51057,147,731,878,193,1596,1789,45682,358289,403971,06/01/2021 12:00:00 AM,311,490,460
Central,Essex County,51057,148,711,859,211,1685,1896,21187,201411,222598,05/01/2018 12:00:00 AM,143,283,259
Central,Essex County,51057,148,718,866,193,1620,1813,36125,278076,314201,06/01/2020 12:00:00 AM,244,387,363
Central,Essex County,51057,148,719,867,202,1578,1780,45052,329082,374134,01/01/2021 12:00:00 AM,304,458,432
Central,Essex County,51057,149,696,845,217,1610,1827,23023,187540,210563,09/01/2018 12:00:00 AM,155,269,249
Central,Essex County,51057,149,716,865,204,1645,1849,19804,193782,213586,04/01/2018 12:00:00 AM,133,271,247
Central,Essex County,51057,150,701,851,217,1651,1868,22180,193359,215539,06/01/2018 12:00:00 AM,148,276,253
Central,Essex County,51057,150,707,857,194,1568,1762,37699,289881,327580,11/01/2020 12:00:00 AM,251,410,382
Central,Essex County,51057,150,730,880,198,1638,1836,37701,282290,319991,07/01/2020 12:00:00 AM,251,387,364
Central,Essex County,51057,151,704,855,220,1649,1869,22002,193036,215038,07/01/2018 12:00:00 AM,146,274,252
Central,Essex County,51057,151,721,872,205,1717,1922,19811,209144,228955,12/01/2017 12:00:00 AM,131,290,263
Central,Essex County,51057,152,696,848,212,1642,1854,21216,189309,210525,01/01/2018 12:00:00 AM,140,272,248
Central,Essex County,51057,154,712,866,214,1677,1891,21119,196235,217354,02/01/2018 12:00:00 AM,137,276,251
Central,Essex County,51057,154,732,886,209,1749,1958,20382,208229,228611,11/01/2017 12:00:00 AM,132,284,258
Central,Essex County,51057,154,734,888,221,1751,1972,21741,214258,235999,04/01/2017 12:00:00 AM,141,292,266
Central,Essex County,51057,154,744,898,219,1783,2002,21842,216550,238392,06/01/2017 12:00:00 AM,142,291,265
Central,Essex County,51057,155,712,867,219,1651,1870,22366,191337,213703,03/01/2018 12:00:00 AM,144,269,246
Central,Essex County,51057,156,731,887,214,1770,1984,20213,214348,234561,10/01/2017 12:00:00 AM,130,293,264
Central,Essex County,51057,157,729,886,220,1742,1962,20856,209810,230666,07/01/2017 12:00:00 AM,133,288,260
Central,Essex County,51057,157,747,904,220,1792,2012,21558,216751,238309,09/01/2017 12:00:00 AM,137,290,264
Central,Essex County,51057,157,749,906,227,1789,2016,23043,221685,244728,03/01/2017 12:00:00 AM,147,296,270
Central,Essex County,51057,157,754,911,220,1794,2014,20602,217698,238300,08/01/2017 12:00:00 AM,131,289,262
Central,Essex County,51057,159,745,904,230,1775,2005,22741,212631,235372,05/01/2017 12:00:00 AM,143,285,260
Central,Essex County,51057,161,757,918,228,1794,2022,21825,221015,242840,02/01/2017 12:00:00 AM,136,292,265
Central,Essex County,51057,163,743,906,231,1800,2031,23358,218485,241843,09/01/2016 12:00:00 AM,143,294,267
Central,Essex County,51057,163,760,923,231,1806,2037,21890,222075,243965,01/01/2017 12:00:00 AM,134,292,264
Central,Essex County,51057,164,755,919,226,1808,2034,20306,214689,234995,04/01/2016 12:00:00 AM,124,284,256
Central,Essex County,51057,166,741,907,236,1778,2014,23706,212827,236533,08/01/2016 12:00:00 AM,143,287,261
Central,Essex County,51057,166,747,913,239,1777,2016,23110,216714,239824,12/01/2016 12:00:00 AM,139,290,263
Central,Essex County,51057,166,763,929,227,1826,2053,21719,219566,241285,03/01/2016 12:00:00 AM,131,288,260
Central,Essex County,51057,167,849,1016,245,1996,2241,23756,238681,262437,04/01/2015 12:00:00 AM,142,281,258
Central,Essex County,51057,168,741,909,241,1760,2001,23508,213718,237226,11/01/2016 12:00:00 AM,140,288,261
Central,Essex County,51057,168,971,1139,259,2314,2573,28256,303732,331988,03/01/2013 12:00:00 AM,168,313,291
Central,Essex County,51057,169,735,904,245,1749,1994,24256,214596,238852,10/01/2016 12:00:00 AM,144,292,264
Central,Essex County,51057,169,743,912,241,1780,2021,24766,209923,234689,07/01/2016 12:00:00 AM,147,283,257
Central,Essex County,51057,170,744,914,235,1791,2026,23248,211699,234947,06/01/2016 12:00:00 AM,137,285,257
Central,Essex County,51057,170,751,921,232,1802,2034,22613,211218,233831,05/01/2016 12:00:00 AM,133,281,254
Central,Essex County,51057,170,811,981,263,1941,2204,26112,229506,255618,07/01/2015 12:00:00 AM,154,283,261
Central,Essex County,51057,170,832,1002,267,1968,2235,26985,231535,258520,06/01/2015 12:00:00 AM,159,278,258
Central,Essex County,51057,172,755,927,239,1775,2014,24084,211772,235856,01/01/2016 12:00:00 AM,140,280,254
Central,Essex County,51057,173,760,933,240,1801,2041,23620,217580,241200,02/01/2016 12:00:00 AM,137,286,259
Central,Essex County,51057,174,768,942,250,1830,2080,25271,215956,241227,12/01/2015 12:00:00 AM,145,281,256
Central,Essex County,51057,174,775,949,259,1845,2104,27041,214281,241322,11/01/2015 12:00:00 AM,155,276,254
Central,Essex County,51057,175,835,1010,275,1974,2249,27718,233682,261400,05/01/2015 12:00:00 AM,158,280,259
Central,Essex County,51057,175,852,1027,269,2007,2276,26174,240096,266270,02/01/2015 12:00:00 AM,150,282,259
Central,Essex County,51057,175,969,1144,264,2301,2565,30126,305633,335759,10/01/2012 12:00:00 AM,172,315,293
Central,Essex County,51057,176,789,965,273,1866,2139,27682,215554,243236,09/01/2015 12:00:00 AM,157,273,252
Central,Essex County,51057,176,964,1140,266,2321,2587,30558,306381,336939,09/01/2012 12:00:00 AM,174,318,296
Central,Essex County,51057,176,971,1147,272,2315,2587,29846,303096,332942,02/01/2013 12:00:00 AM,170,312,290
Central,Essex County,51057,177,802,979,275,1899,2174,27442,225035,252477,08/01/2015 12:00:00 AM,155,281,258
Central,Essex County,51057,177,875,1052,271,2074,2345,27179,244609,271788,09/01/2014 12:00:00 AM,154,280,258
Central,Essex County,51057,177,980,1157,268,2390,2658,29113,316447,345560,08/01/2012 12:00:00 AM,164,323,299
Central,Essex County,51057,178,860,1038,270,2021,2291,26331,240618,266949,03/01/2015 12:00:00 AM,148,280,257
Central,Essex County,51057,178,896,1074,280,2113,2393,27807,248626,276433,08/01/2014 12:00:00 AM,156,277,257
Central,Essex County,51057,178,969,1147,279,2289,2568,31019,303132,334151,04/01/2013 12:00:00 AM,174,313,291
Central,Essex County,51057,178,978,1156,274,2333,2607,30234,305579,335813,01/01/2013 12:00:00 AM,170,312,290
Central,Essex County,51057,179,769,948,272,1819,2091,27860,212436,240296,10/01/2015 12:00:00 AM,156,276,253
Central,Essex County,51057,179,967,1146,271,2305,2576,29411,303623,333034,05/01/2013 12:00:00 AM,164,314,291
Central,Essex County,51057,179,971,1150,276,2320,2596,31732,307209,338941,12/01/2012 12:00:00 AM,177,316,295
Central,Essex County,51057,179,978,1157,309,2326,2635,36288,311645,347933,02/01/2012 12:00:00 AM,203,319,301
Central,Essex County,51057,180,978,1158,277,2362,2639,30601,311630,342231,07/01/2012 12:00:00 AM,170,319,296
Central,Essex County,51057,181,968,1149,281,2295,2576,31013,299857,330870,06/01/2013 12:00:00 AM,171,310,288
Central,Essex County,51057,181,969,1150,277,2309,2586,31726,304638,336364,11/01/2012 12:00:00 AM,175,314,292
Central,Essex County,51057,182,853,1035,285,2010,2295,29363,242216,271579,01/01/2015 12:00:00 AM,161,284,262
Central,Essex County,51057,182,867,1049,284,2043,2327,31128,250514,281642,11/01/2014 12:00:00 AM,171,289,268
Central,Essex County,51057,182,979,1161,312,2335,2647,35874,311543,347417,03/01/2012 12:00:00 AM,197,318,299
Central,Essex County,51057,182,980,1162,323,2334,2657,38355,311139,349494,01/01/2012 12:00:00 AM,211,317,301
Central,Essex County,51057,184,855,1039,293,2018,2311,32422,245594,278016,10/01/2014 12:00:00 AM,176,287,268
Central,Essex County,51057,184,977,1161,300,2342,2642,33639,309891,343530,05/01/2012 12:00:00 AM,183,317,296
Central,Essex County,51057,185,867,1052,288,2035,2323,30842,250575,281417,12/01/2014 12:00:00 AM,167,289,268
Central,Essex County,51057,185,975,1160,297,2342,2639,33593,308572,342165,06/01/2012 12:00:00 AM,182,316,295
Central,Essex County,51057,186,937,1123,300,2184,2484,30455,260457,290912,05/01/2014 12:00:00 AM,164,278,259
Central,Essex County,51057,186,947,1133,307,2218,2525,30780,266573,297353,04/01/2014 12:00:00 AM,165,281,262
Central,Essex County,51057,186,964,1150,306,2329,2635,34622,309000,343622,04/01/2012 12:00:00 AM,186,321,299
Central,Essex County,51057,188,960,1148,302,2280,2582,33367,295884,329251,07/01/2013 12:00:00 AM,177,308,287
Central,Essex County,51057,190,907,1097,322,2129,2451,32277,249866,282143,07/01/2014 12:00:00 AM,170,275,257
Central,Essex County,51057,190,928,1118,312,2144,2456,30761,255136,285897,06/01/2014 12:00:00 AM,162,275,256
Central,Essex County,51057,190,956,1146,325,2213,2538,33794,267350,301144,02/01/2014 12:00:00 AM,178,280,263
Central,Essex County,51057,192,956,1148,308,2227,2535,34892,286831,321723,10/01/2013 12:00:00 AM,182,300,280
Central,Essex County,51057,193,950,1143,332,2196,2528,34385,262461,296846,03/01/2014 12:00:00 AM,178,276,260
Central,Essex County,51057,193,954,1147,314,2201,2515,33097,263129,296226,11/01/2013 12:00:00 AM,171,276,258
Central,Essex County,51057,194,953,1147,321,2237,2558,35664,289500,325164,09/01/2013 12:00:00 AM,184,304,283
Central,Essex County,51057,194,959,1153,310,2280,2590,34233,295165,329398,08/01/2013 12:00:00 AM,176,308,286
Central,Essex County,51057,195,945,1140,332,2187,2519,35390,262858,298248,12/01/2013 12:00:00 AM,181,278,262
Central,Essex County,51057,196,950,1146,331,2198,2529,34737,261464,296201,01/01/2014 12:00:00 AM,177,275,258
Central,Fluvanna County,51065,100,520,620,125,1263,1388,12738,142927,155665,11/01/2018 12:00:00 AM,127,275,251
Central,Fluvanna County,51065,100,529,629,127,1263,1390,12377,139258,151635,10/01/2019 12:00:00 AM,124,263,241
Central,Fluvanna County,51065,100,535,635,127,1250,1377,12757,138530,151287,11/01/2019 12:00:00 AM,128,259,238
Central,Fluvanna County,51065,100,575,675,125,1417,1542,12687,168475,181162,05/01/2017 12:00:00 AM,127,293,268
Central,Fluvanna County,51065,100,581,681,126,1458,1584,12228,170132,182360,02/01/2017 12:00:00 AM,122,293,268
Central,Fluvanna County,51065,100,615,715,134,1385,1519,26281,254690,280971,11/01/2020 12:00:00 AM,263,414,393
Central,Fluvanna County,51065,101,551,652,122,1355,1477,13234,163025,176259,09/01/2017 12:00:00 AM,131,296,270
Central,Fluvanna County,51065,101,558,659,134,1395,1529,13733,165531,179264,11/01/2016 12:00:00 AM,136,297,272
Central,Fluvanna County,51065,101,570,671,127,1387,1514,13812,165189,179001,10/01/2017 12:00:00 AM,137,290,267
Central,Fluvanna County,51065,102,511,613,125,1250,1375,11481,138521,150002,06/01/2019 12:00:00 AM,113,271,245
Central,Fluvanna County,51065,102,521,623,126,1265,1391,13016,137376,150392,05/01/2019 12:00:00 AM,128,264,241
Central,Fluvanna County,51065,102,524,626,129,1268,1397,12737,144573,157310,07/01/2018 12:00:00 AM,125,276,251
Central,Fluvanna County,51065,102,614,716,138,1390,1528,26266,247860,274126,12/01/2020 12:00:00 AM,258,404,383
Central,Fluvanna County,51065,103,502,605,131,1187,1318,13590,129887,143477,02/01/2019 12:00:00 AM,132,259,237
Central,Fluvanna County,51065,103,549,652,131,1305,1436,13519,155689,169208,01/01/2019 12:00:00 AM,131,284,260
Central,Fluvanna County,51065,103,551,654,126,1374,1500,13782,163439,177221,08/01/2017 12:00:00 AM,134,297,271
Central,Fluvanna County,51065,104,524,628,129,1262,1391,13251,145057,158308,08/01/2018 12:00:00 AM,127,277,252
Central,Fluvanna County,51065,104,531,635,129,1281,1410,13207,138933,152140,04/01/2019 12:00:00 AM,127,262,240
Central,Fluvanna County,51065,104,532,636,129,1264,1393,12180,141536,153716,09/01/2019 12:00:00 AM,117,266,242
Central,Fluvanna County,51065,104,538,642,132,1296,1428,13624,147512,161136,06/01/2018 12:00:00 AM,131,274,251
Central,Fluvanna County,51065,104,544,648,140,1361,1501,14562,157054,171616,10/01/2016 12:00:00 AM,140,289,265
Central,Fluvanna County,51065,104,558,662,146,1399,1545,15875,164233,180108,12/01/2015 12:00:00 AM,153,294,272
Central,Fluvanna County,51065,104,569,673,128,1415,1543,13126,169451,182577,06/01/2017 12:00:00 AM,126,298,271
Central,Fluvanna County,51065,104,574,678,132,1429,1561,13684,171674,185358,04/01/2017 12:00:00 AM,132,299,273
Central,Fluvanna County,51065,104,587,691,128,1440,1568,13430,171111,184541,12/01/2017 12:00:00 AM,129,292,267
Central,Fluvanna County,51065,104,620,724,129,1371,1500,29283,285452,314735,02/01/2021 12:00:00 AM,282,460,435
Central,Fluvanna County,51065,105,528,633,132,1276,1408,13686,141713,155399,03/01/2019 12:00:00 AM,130,268,245
Central,Fluvanna County,51065,105,529,634,133,1270,1403,13575,139247,152822,12/01/2018 12:00:00 AM,129,263,241
Central,Fluvanna County,51065,105,567,672,130,1402,1532,13980,167346,181326,11/01/2017 12:00:00 AM,133,295,270
Central,Fluvanna County,51065,105,570,675,128,1402,1530,13102,164627,177729,01/01/2018 12:00:00 AM,125,289,263
Central,Fluvanna County,51065,105,573,678,137,1417,1554,13773,171498,185271,03/01/2017 12:00:00 AM,131,299,273
Central,Fluvanna County,51065,105,602,707,143,1338,1481,31799,281074,312873,01/01/2021 12:00:00 AM,303,467,443
Central,Fluvanna County,51065,105,669,774,147,1585,1732,13593,181253,194846,08/01/2014 12:00:00 AM,129,271,252
Central,Fluvanna County,51065,105,680,785,155,1714,1869,16711,209246,225957,09/01/2013 12:00:00 AM,159,308,288
Central,Fluvanna County,51065,105,683,788,149,1639,1788,14275,186620,200895,05/01/2014 12:00:00 AM,136,273,255
Central,Fluvanna County,51065,106,501,607,132,1222,1354,12298,138169,150467,07/01/2019 12:00:00 AM,116,276,248
Central,Fluvanna County,51065,106,549,655,128,1335,1463,12700,152201,164901,03/01/2018 12:00:00 AM,120,277,252
Central,Fluvanna County,51065,106,667,773,148,1586,1734,13821,181904,195725,06/01/2014 12:00:00 AM,130,273,253
Central,Fluvanna County,51065,107,518,625,133,1245,1378,12692,137624,150316,08/01/2019 12:00:00 AM,119,266,241
Central,Fluvanna County,51065,107,553,660,132,1322,1454,13199,152934,166133,04/01/2018 12:00:00 AM,123,277,252
Central,Fluvanna County,51065,107,670,777,155,1624,1779,14750,185580,200330,02/01/2014 12:00:00 AM,138,277,258
Central,Fluvanna County,51065,107,672,779,154,1620,1774,15306,184441,199747,04/01/2014 12:00:00 AM,143,274,256
Central,Fluvanna County,51065,107,675,782,154,1645,1799,14681,184188,198869,01/01/2014 12:00:00 AM,137,273,254
Central,Fluvanna County,51065,108,540,648,134,1303,1437,13472,151036,164508,05/01/2018 12:00:00 AM,125,280,254
Central,Fluvanna County,51065,108,550,658,133,1374,1507,13675,164708,178383,07/01/2017 12:00:00 AM,127,299,271
Central,Fluvanna County,51065,108,553,661,150,1371,1521,15375,161517,176892,02/01/2016 12:00:00 AM,142,292,268
Central,Fluvanna County,51065,108,563,671,132,1390,1522,13862,161391,175253,02/01/2018 12:00:00 AM,128,287,261
Central,Fluvanna County,51065,108,658,766,155,1567,1722,14879,178589,193468,07/01/2014 12:00:00 AM,138,271,253
Central,Fluvanna County,51065,109,574,683,158,1443,1601,17023,170623,187646,11/01/2015 12:00:00 AM,156,297,275
Central,Fluvanna County,51065,109,677,786,162,1680,1842,15089,187102,202191,11/01/2013 12:00:00 AM,138,276,257
Central,Fluvanna County,51065,110,549,659,153,1368,1521,15976,158375,174351,03/01/2016 12:00:00 AM,145,288,265
Central,Fluvanna County,51065,110,618,728,143,1355,1498,31964,287346,319310,03/01/2021 12:00:00 AM,291,465,439
Central,Fluvanna County,51065,110,661,771,143,1589,1732,12826,182932,195758,09/01/2014 12:00:00 AM,117,277,254
Central,Fluvanna County,51065,110,669,779,160,1618,1778,15028,188719,203747,03/01/2014 12:00:00 AM,137,282,262
Central,Fluvanna County,51065,110,672,782,166,1690,1856,17452,204646,222098,10/01/2013 12:00:00 AM,159,305,284
Central,Fluvanna County,51065,110,676,786,160,1645,1805,15049,184915,199964,12/01/2013 12:00:00 AM,137,274,254
Central,Fluvanna County,51065,111,545,656,150,1371,1521,15509,156801,172310,04/01/2016 12:00:00 AM,140,288,263
Central,Fluvanna County,51065,112,541,653,155,1359,1514,16677,154486,171163,06/01/2016 12:00:00 AM,149,286,262
Central,Fluvanna County,51065,112,552,664,153,1375,1528,16181,158197,174378,09/01/2016 12:00:00 AM,144,287,263
Central,Fluvanna County,51065,112,571,683,163,1437,1600,18213,167582,185795,10/01/2015 12:00:00 AM,163,293,272
Central,Fluvanna County,51065,112,580,692,161,1455,1616,18228,168141,186369,07/01/2015 12:00:00 AM,163,290,269
Central,Fluvanna County,51065,113,549,662,160,1369,1529,17225,159670,176895,01/01/2016 12:00:00 AM,152,291,267
Central,Fluvanna County,51065,113,586,699,161,1477,1638,18170,171804,189974,09/01/2015 12:00:00 AM,161,293,272
Central,Fluvanna County,51065,113,675,788,168,1677,1845,18342,207031,225373,08/01/2013 12:00:00 AM,162,307,286
Central,Fluvanna County,51065,114,531,645,157,1329,1486,16661,153899,170560,07/01/2016 12:00:00 AM,146,290,264
Central,Fluvanna County,51065,114,604,718,151,1332,1483,36078,304477,340555,05/01/2021 12:00:00 AM,316,504,474
Central,Fluvanna County,51065,114,692,806,186,1708,1894,21784,213739,235523,06/01/2012 12:00:00 AM,191,309,292
Central,Fluvanna County,51065,114,708,822,182,1752,1934,22294,219713,242007,05/01/2012 12:00:00 AM,196,310,294
Central,Fluvanna County,51065,115,544,659,162,1361,1523,17042,158040,175082,05/01/2016 12:00:00 AM,148,291,266
Central,Fluvanna County,51065,115,579,694,158,1475,1633,17236,171271,188507,08/01/2015 12:00:00 AM,150,296,272
Central,Fluvanna County,51065,115,608,723,148,1343,1491,34920,297307,332227,04/01/2021 12:00:00 AM,304,489,460
Central,Fluvanna County,51065,115,636,751,156,1567,1723,16132,182871,199003,11/01/2014 12:00:00 AM,140,288,265
Central,Fluvanna County,51065,115,667,782,160,1610,1770,16809,190112,206921,10/01/2014 12:00:00 AM,146,285,265
Central,Fluvanna County,51065,115,699,814,196,1732,1928,23881,216299,240180,02/01/2012 12:00:00 AM,208,309,295
Central,Fluvanna County,51065,116,540,656,161,1342,1503,16757,156308,173065,08/01/2016 12:00:00 AM,144,289,264
Central,Fluvanna County,51065,116,682,798,180,1671,1851,19771,208068,227839,07/01/2013 12:00:00 AM,170,305,286
Central,Fluvanna County,51065,117,591,708,169,1471,1640,18369,168691,187060,06/01/2015 12:00:00 AM,157,285,264
Central,Fluvanna County,51065,117,687,804,203,1682,1885,24536,209095,233631,01/01/2012 12:00:00 AM,210,304,291
Central,Fluvanna County,51065,117,705,822,186,1723,1909,22552,216783,239335,04/01/2012 12:00:00 AM,193,307,291
Central,Fluvanna County,51065,118,610,728,159,1345,1504,36816,304816,341632,06/01/2021 12:00:00 AM,312,500,469
Central,Fluvanna County,51065,118,677,795,184,1675,1859,20954,207965,228919,06/01/2013 12:00:00 AM,178,307,288
Central,Fluvanna County,51065,118,698,816,200,1704,1904,24195,211495,235690,03/01/2012 12:00:00 AM,205,303,289
Central,Fluvanna County,51065,119,637,756,170,1583,1753,17791,184933,202724,12/01/2014 12:00:00 AM,150,290,268
Central,Fluvanna County,51065,119,676,795,190,1651,1841,21728,207100,228828,03/01/2013 12:00:00 AM,183,306,288
Central,Fluvanna County,51065,119,681,800,188,1637,1825,20808,200806,221614,01/01/2013 12:00:00 AM,175,295,277
Central,Fluvanna County,51065,120,610,730,179,1532,1711,19199,173463,192662,01/01/2015 12:00:00 AM,160,284,264
Central,Fluvanna County,51065,120,653,773,184,1576,1760,20256,199280,219536,10/01/2012 12:00:00 AM,169,305,284
Central,Fluvanna County,51065,120,660,780,194,1617,1811,23395,205689,229084,07/01/2012 12:00:00 AM,195,312,294
Central,Fluvanna County,51065,120,662,782,188,1625,1813,21629,203758,225387,08/01/2012 12:00:00 AM,180,308,288
Central,Fluvanna County,51065,120,662,782,192,1615,1807,21784,203277,225061,09/01/2012 12:00:00 AM,182,307,288
Central,Fluvanna County,51065,121,596,717,174,1481,1655,18669,177692,196361,05/01/2015 12:00:00 AM,154,298,274
Central,Fluvanna County,51065,121,680,801,193,1649,1842,22021,205809,227830,02/01/2013 12:00:00 AM,182,303,284
Central,Fluvanna County,51065,121,690,811,197,1687,1884,21876,210651,232527,05/01/2013 12:00:00 AM,181,305,287
Central,Fluvanna County,51065,122,601,723,181,1530,1711,19746,177128,196874,02/01/2015 12:00:00 AM,162,295,272
Central,Fluvanna County,51065,122,603,725,179,1500,1679,18806,180243,199049,04/01/2015 12:00:00 AM,154,299,275
Central,Fluvanna County,51065,122,606,728,176,1515,1691,18769,178792,197561,03/01/2015 12:00:00 AM,154,295,271
Central,Fluvanna County,51065,122,682,804,193,1663,1856,23757,217060,240817,04/01/2013 12:00:00 AM,195,318,300
Central,Fluvanna County,51065,123,666,789,195,1596,1791,22638,197387,220025,12/01/2012 12:00:00 AM,184,296,279
Central,Fluvanna County,51065,126,659,785,198,1584,1782,22225,197143,219368,11/01/2012 12:00:00 AM,176,299,279
Central,Fluvanna County,51065,89,609,698,108,1397,1505,20192,235212,255404,08/01/2020 12:00:00 AM,227,386,366
Central,Fluvanna County,51065,91,529,620,110,1227,1337,9943,132269,142212,01/01/2020 12:00:00 AM,109,250,229
Central,Fluvanna County,51065,91,606,697,116,1390,1506,21487,240475,261962,09/01/2020 12:00:00 AM,236,397,376
Central,Fluvanna County,51065,92,519,611,106,1198,1304,20144,202955,223099,03/01/2020 12:00:00 AM,219,391,365
Central,Fluvanna County,51065,92,522,614,106,1199,1305,9758,130655,140413,02/01/2020 12:00:00 AM,106,250,229
Central,Fluvanna County,51065,94,580,674,110,1339,1449,20693,232838,253531,04/01/2020 12:00:00 AM,220,401,376
Central,Fluvanna County,51065,95,533,628,118,1224,1342,11626,136225,147851,12/01/2019 12:00:00 AM,122,256,235
Central,Fluvanna County,51065,95,590,685,113,1356,1469,21248,232945,254193,06/01/2020 12:00:00 AM,224,395,371
Central,Fluvanna County,51065,95,596,691,113,1370,1483,21022,236084,257106,05/01/2020 12:00:00 AM,221,396,372
Central,Fluvanna County,51065,95,596,691,113,1380,1493,21336,235627,256963,07/01/2020 12:00:00 AM,225,395,372
Central,Fluvanna County,51065,96,521,617,117,1249,1366,12354,141188,153542,10/01/2018 12:00:00 AM,129,271,249
Central,Fluvanna County,51065,96,565,661,124,1398,1522,11898,163523,175421,01/01/2017 12:00:00 AM,124,289,265
Central,Fluvanna County,51065,97,554,651,126,1393,1519,12640,162074,174714,12/01/2016 12:00:00 AM,130,293,268
Central,Fluvanna County,51065,98,600,698,129,1357,1486,24932,245968,270900,10/01/2020 12:00:00 AM,254,410,388
Central,Fluvanna County,51065,99,513,612,122,1227,1349,12554,138249,150803,09/01/2018 12:00:00 AM,127,269,246
Central,Goochland County,51075,100,565,665,152,1197,1349,17378,153061,170439,08/01/2013 12:00:00 AM,174,271,256
Central,Goochland County,51075,101,558,659,157,1176,1333,17550,150102,167652,06/01/2013 12:00:00 AM,174,269,254
Central,Goochland County,51075,101,561,662,152,1178,1330,17021,148088,165109,07/01/2013 12:00:00 AM,169,264,249
Central,Goochland County,51075,105,546,651,171,1139,1310,19638,142878,162516,03/01/2012 12:00:00 AM,187,262,250
Central,Goochland County,51075,105,560,665,157,1179,1336,17088,150285,167373,05/01/2013 12:00:00 AM,163,268,252
Central,Goochland County,51075,107,557,664,172,1173,1345,19460,147674,167134,02/01/2012 12:00:00 AM,182,265,252
Central,Goochland County,51075,108,519,627,172,1061,1233,19001,135266,154267,05/01/2012 12:00:00 AM,176,261,246
Central,Goochland County,51075,108,548,656,172,1169,1341,19342,146183,165525,01/01/2012 12:00:00 AM,179,267,252
Central,Goochland County,51075,110,531,641,181,1091,1272,20989,138726,159715,04/01/2012 12:00:00 AM,191,261,249
Central,Goochland County,51075,112,521,633,180,1066,1246,20298,136447,156745,06/01/2012 12:00:00 AM,181,262,248
Central,Goochland County,51075,112,552,664,177,1154,1331,20325,146281,166606,04/01/2013 12:00:00 AM,181,265,251
Central,Goochland County,51075,113,552,665,178,1150,1328,22548,147660,170208,03/01/2013 12:00:00 AM,200,268,256
Central,Goochland County,51075,114,521,635,174,1082,1256,18665,136570,155235,07/01/2012 12:00:00 AM,164,262,244
Central,Goochland County,51075,114,563,677,175,1154,1329,20015,143490,163505,12/01/2012 12:00:00 AM,176,255,242
Central,Goochland County,51075,116,563,679,181,1165,1346,20550,144573,165123,11/01/2012 12:00:00 AM,177,257,243
Central,Goochland County,51075,118,536,654,182,1097,1279,19636,139991,159627,08/01/2012 12:00:00 AM,166,261,244
Central,Goochland County,51075,118,547,665,185,1117,1302,21395,141082,162477,02/01/2013 12:00:00 AM,181,258,244
Central,Goochland County,51075,118,551,669,181,1135,1316,20391,141541,161932,01/01/2013 12:00:00 AM,173,257,242
Central,Goochland County,51075,119,539,658,179,1114,1293,19582,142942,162524,09/01/2012 12:00:00 AM,165,265,247
Central,Goochland County,51075,124,544,668,191,1128,1319,21812,143022,164834,10/01/2012 12:00:00 AM,176,263,247
Central,Goochland County,51075,72,458,530,82,948,1030,8705,111070,119775,03/01/2018 12:00:00 AM,121,243,226
Central,Goochland County,51075,72,468,540,83,951,1034,8938,112818,121756,02/01/2018 12:00:00 AM,124,241,225
Central,Goochland County,51075,72,489,561,88,975,1063,9208,119748,128956,10/01/2017 12:00:00 AM,128,245,230
Central,Goochland County,51075,74,448,522,85,912,997,8261,107619,115880,04/01/2018 12:00:00 AM,112,240,222
Central,Goochland County,51075,74,481,555,89,952,1041,9130,118446,127576,09/01/2017 12:00:00 AM,123,246,230
Central,Goochland County,51075,74,488,562,90,966,1056,9769,121383,131152,11/01/2017 12:00:00 AM,132,249,233
Central,Goochland County,51075,75,457,532,90,941,1031,9088,117120,126208,07/01/2017 12:00:00 AM,121,256,237
Central,Goochland County,51075,75,459,534,89,921,1010,9501,111467,120968,12/01/2017 12:00:00 AM,127,243,227
Central,Goochland County,51075,76,421,497,89,830,919,8023,96920,104943,02/01/2020 12:00:00 AM,106,230,211
Central,Goochland County,51075,76,480,556,84,971,1055,19302,206017,225319,01/01/2021 12:00:00 AM,254,429,405
Central,Goochland County,51075,77,436,513,90,836,926,8793,96996,105789,07/01/2019 12:00:00 AM,114,222,206
Central,Goochland County,51075,77,439,516,86,853,939,8488,100513,109001,05/01/2019 12:00:00 AM,110,229,211
Central,Goochland County,51075,77,449,526,90,923,1013,9169,110323,119492,05/01/2018 12:00:00 AM,119,246,227
Central,Goochland County,51075,77,451,528,93,919,1012,10587,110236,120823,01/01/2018 12:00:00 AM,137,244,229
Central,Goochland County,51075,77,471,548,96,954,1050,10572,116829,127401,08/01/2017 12:00:00 AM,137,248,232
Central,Goochland County,51075,77,476,553,84,963,1047,19418,208084,227502,03/01/2021 12:00:00 AM,252,437,411
Central,Goochland County,51075,77,487,564,89,957,1046,18097,176636,194733,10/01/2020 12:00:00 AM,235,363,345
Central,Goochland County,51075,78,425,503,87,831,918,8233,97628,105861,02/01/2019 12:00:00 AM,106,230,210
Central,Goochland County,51075,78,427,505,92,807,899,9160,96414,105574,10/01/2019 12:00:00 AM,117,226,209
Central,Goochland County,51075,78,472,550,87,948,1035,19911,204218,224129,02/01/2021 12:00:00 AM,255,433,408
Central,Goochland County,51075,78,474,552,85,944,1029,20713,214169,234882,04/01/2021 12:00:00 AM,266,452,426
Central,Goochland County,51075,78,482,560,89,959,1048,17434,177978,195412,11/01/2020 12:00:00 AM,224,369,349
Central,Goochland County,51075,78,483,561,89,966,1055,17826,181568,199394,12/01/2020 12:00:00 AM,229,376,355
Central,Goochland County,51075,79,428,507,91,812,903,9016,93353,102369,11/01/2019 12:00:00 AM,114,218,202
Central,Goochland County,51075,79,442,521,91,849,940,9150,101948,111098,06/01/2019 12:00:00 AM,116,231,213
Central,Goochland County,51075,79,443,522,88,843,931,8324,100542,108866,04/01/2019 12:00:00 AM,105,227,209
Central,Goochland County,51075,79,443,522,88,870,958,8940,102535,111475,03/01/2019 12:00:00 AM,113,231,214
Central,Goochland County,51075,79,477,556,87,945,1032,21238,217049,238287,05/01/2021 12:00:00 AM,269,455,429
Central,Goochland County,51075,80,423,503,95,817,912,8738,92385,101123,01/01/2020 12:00:00 AM,109,218,201
Central,Goochland County,51075,80,437,517,90,858,948,8950,105259,114209,12/01/2018 12:00:00 AM,112,241,221
Central,Goochland County,51075,80,440,520,92,863,955,9258,109278,118536,01/01/2019 12:00:00 AM,116,248,228
Central,Goochland County,51075,80,444,524,95,856,951,8664,98283,106947,08/01/2019 12:00:00 AM,108,221,204
Central,Goochland County,51075,80,489,569,89,969,1058,21549,221870,243419,06/01/2021 12:00:00 AM,269,454,428
Central,Goochland County,51075,81,425,506,97,836,933,18384,150067,168451,03/01/2020 12:00:00 AM,227,353,333
Central,Goochland County,51075,81,433,514,99,835,934,9086,98632,107718,09/01/2019 12:00:00 AM,112,228,210
Central,Goochland County,51075,81,436,517,94,887,981,9382,107023,116405,06/01/2018 12:00:00 AM,116,245,225
Central,Goochland County,51075,82,429,511,98,805,903,9830,92750,102580,12/01/2019 12:00:00 AM,120,216,201
Central,Goochland County,51075,82,460,542,102,914,1016,18603,157538,176141,04/01/2020 12:00:00 AM,227,342,325
Central,Goochland County,51075,82,478,560,102,945,1047,19425,167654,187079,05/01/2020 12:00:00 AM,237,351,334
Central,Goochland County,51075,82,495,577,101,991,1092,18853,177064,195917,08/01/2020 12:00:00 AM,230,358,340
Central,Goochland County,51075,82,498,580,98,977,1075,18394,175130,193524,09/01/2020 12:00:00 AM,224,352,334
Central,Goochland County,51075,83,438,521,98,876,974,10680,103588,114268,11/01/2018 12:00:00 AM,129,237,219
Central,Goochland County,51075,83,455,538,102,941,1043,10889,116566,127455,06/01/2017 12:00:00 AM,131,256,237
Central,Goochland County,51075,84,429,513,100,872,972,10359,102859,113218,08/01/2018 12:00:00 AM,123,240,221
Central,Goochland County,51075,84,433,517,97,879,976,9892,106684,116576,10/01/2018 12:00:00 AM,118,246,225
Central,Goochland County,51075,84,448,532,105,943,1048,11349,114094,125443,04/01/2017 12:00:00 AM,135,255,236
Central,Goochland County,51075,84,479,563,104,955,1059,19268,166602,185870,06/01/2020 12:00:00 AM,229,348,330
Central,Goochland County,51075,85,437,522,102,878,980,10360,103935,114295,07/01/2018 12:00:00 AM,122,238,219
Central,Goochland County,51075,85,452,537,104,946,1050,11028,116880,127908,05/01/2017 12:00:00 AM,130,259,238
Central,Goochland County,51075,85,491,576,105,978,1083,20118,172013,192131,07/01/2020 12:00:00 AM,237,350,334
Central,Goochland County,51075,86,428,514,102,866,968,10280,102259,112539,09/01/2018 12:00:00 AM,120,239,219
Central,Goochland County,51075,89,462,551,105,969,1074,10335,113476,123811,12/01/2016 12:00:00 AM,116,246,225
Central,Goochland County,51075,89,465,554,106,976,1082,10631,114955,125586,01/01/2017 12:00:00 AM,119,247,227
Central,Goochland County,51075,89,472,561,114,1017,1131,11598,119270,130868,03/01/2016 12:00:00 AM,130,253,233
Central,Goochland County,51075,90,444,534,109,950,1059,10935,110057,120992,07/01/2016 12:00:00 AM,122,248,227
Central,Goochland County,51075,90,446,536,117,946,1063,13124,111952,125076,06/01/2016 12:00:00 AM,146,251,233
Central,Goochland County,51075,90,452,542,109,958,1067,11005,111016,122021,08/01/2016 12:00:00 AM,122,246,225
Central,Goochland County,51075,90,472,562,114,1033,1147,11522,119416,130938,02/01/2016 12:00:00 AM,128,253,233
Central,Goochland County,51075,91,463,554,107,994,1101,10962,116308,127270,11/01/2016 12:00:00 AM,120,251,230
Central,Goochland County,51075,91,468,559,109,988,1097,11080,116499,127579,02/01/2017 12:00:00 AM,122,249,228
Central,Goochland County,51075,91,476,567,120,1045,1165,12115,123851,135966,10/01/2015 12:00:00 AM,133,260,240
Central,Goochland County,51075,92,454,546,119,970,1089,12303,113072,125375,04/01/2016 12:00:00 AM,134,249,230
Central,Goochland County,51075,92,456,548,113,958,1071,12435,118605,131040,03/01/2017 12:00:00 AM,135,260,239
Central,Goochland County,51075,92,470,562,123,1041,1164,12513,119055,131568,01/01/2016 12:00:00 AM,136,253,234
Central,Goochland County,51075,92,470,562,124,1027,1151,13219,118210,131429,12/01/2015 12:00:00 AM,144,252,234
Central,Goochland County,51075,92,472,564,123,1035,1158,12236,121221,133457,11/01/2015 12:00:00 AM,133,257,237
Central,Goochland County,51075,93,446,539,123,947,1070,12890,109712,122602,05/01/2016 12:00:00 AM,139,246,227
Central,Goochland County,51075,93,460,553,116,1000,1116,12378,116536,128914,09/01/2016 12:00:00 AM,133,253,233
Central,Goochland County,51075,93,463,556,114,997,1111,11871,115007,126878,10/01/2016 12:00:00 AM,128,248,228
Central,Goochland County,51075,93,560,653,130,1177,1307,13423,131397,144820,06/01/2014 12:00:00 AM,144,235,222
Central,Goochland County,51075,93,593,686,118,1238,1356,11831,143255,155086,03/01/2014 12:00:00 AM,127,242,226
Central,Goochland County,51075,94,482,576,128,1057,1185,13656,124225,137881,09/01/2015 12:00:00 AM,145,258,239
Central,Goochland County,51075,94,506,600,120,1106,1226,12242,127127,139369,01/01/2015 12:00:00 AM,130,251,232
Central,Goochland County,51075,94,581,675,121,1214,1335,12067,138268,150335,04/01/2014 12:00:00 AM,128,238,223
Central,Goochland County,51075,94,592,686,123,1226,1349,13083,140309,153392,02/01/2014 12:00:00 AM,139,237,224
Central,Goochland County,51075,94,598,692,132,1254,1386,12914,144980,157894,11/01/2013 12:00:00 AM,137,242,228
Central,Goochland County,51075,95,486,581,124,1084,1208,14057,124939,138996,07/01/2015 12:00:00 AM,148,257,239
Central,Goochland County,51075,95,498,593,124,1093,1217,13331,129533,142864,02/01/2015 12:00:00 AM,140,260,241
Central,Goochland County,51075,95,520,615,124,1133,1257,12944,132974,145918,12/01/2014 12:00:00 AM,136,256,237
Central,Goochland County,51075,95,578,673,137,1212,1349,14625,155008,169633,09/01/2013 12:00:00 AM,154,268,252
Central,Goochland County,51075,96,493,589,130,1096,1226,14229,128643,142872,06/01/2015 12:00:00 AM,148,261,243
Central,Goochland County,51075,96,497,593,129,1116,1245,13843,127356,141199,05/01/2015 12:00:00 AM,144,256,238
Central,Goochland County,51075,96,533,629,122,1140,1262,11910,132242,144152,10/01/2014 12:00:00 AM,124,248,229
Central,Goochland County,51075,96,534,630,125,1146,1271,12654,135028,147682,11/01/2014 12:00:00 AM,132,253,234
Central,Goochland County,51075,96,567,663,129,1195,1324,13100,133796,146896,05/01/2014 12:00:00 AM,136,236,222
Central,Goochland County,51075,96,592,688,134,1244,1378,13539,141382,154921,12/01/2013 12:00:00 AM,141,239,225
Central,Goochland County,51075,96,593,689,128,1241,1369,13081,141528,154609,01/01/2014 12:00:00 AM,136,239,224
Central,Goochland County,51075,96,596,692,140,1248,1388,15353,158314,173667,10/01/2013 12:00:00 AM,160,266,251
Central,Goochland County,51075,97,478,575,131,1055,1186,14360,124106,138466,08/01/2015 12:00:00 AM,148,260,241
Central,Goochland County,51075,97,499,596,128,1117,1245,13401,129648,143049,04/01/2015 12:00:00 AM,138,260,240
Central,Goochland County,51075,97,549,646,131,1163,1294,13469,131359,144828,07/01/2014 12:00:00 AM,139,239,224
Central,Goochland County,51075,98,489,587,130,1097,1227,13575,128901,142476,03/01/2015 12:00:00 AM,139,264,243
Central,Goochland County,51075,98,553,651,128,1186,1314,12349,133212,145561,08/01/2014 12:00:00 AM,126,241,224
Central,Goochland County,51075,99,538,637,130,1157,1287,11650,127137,138787,09/01/2014 12:00:00 AM,118,236,218
Central,Hanover County,51085,306,2084,2390,457,4835,5292,47862,589434,637296,06/01/2015 12:00:00 AM,156,283,267
Central,Hanover County,51085,309,2062,2371,446,4804,5250,46740,578349,625089,08/01/2015 12:00:00 AM,151,280,264
Central,Hanover County,51085,312,2080,2392,475,4832,5307,50640,593862,644502,05/01/2015 12:00:00 AM,162,286,269
Central,Hanover County,51085,313,1717,2030,437,3689,4126,46275,440656,486931,04/01/2019 12:00:00 AM,148,257,240
Central,Hanover County,51085,313,1723,2036,439,3710,4149,46808,441405,488213,05/01/2019 12:00:00 AM,150,256,240
Central,Hanover County,51085,313,2056,2369,455,4803,5258,48712,580218,628930,07/01/2015 12:00:00 AM,156,282,265
Central,Hanover County,51085,316,1710,2026,444,3658,4102,48162,434528,482690,06/01/2019 12:00:00 AM,152,254,238
Central,Hanover County,51085,316,1719,2035,434,3710,4144,45445,442738,488183,07/01/2019 12:00:00 AM,144,258,240
Central,Hanover County,51085,316,2041,2357,470,4721,5191,50158,569185,619343,09/01/2015 12:00:00 AM,159,279,263
Central,Hanover County,51085,317,1723,2040,443,3708,4151,47925,438540,486465,03/01/2019 12:00:00 AM,151,255,238
Central,Hanover County,51085,317,2003,2320,474,4570,5044,53378,546453,599831,02/01/2016 12:00:00 AM,168,273,259
Central,Hanover County,51085,319,1716,2035,437,3736,4173,45511,448127,493638,08/01/2019 12:00:00 AM,143,261,243
Central,Hanover County,51085,320,2014,2334,413,4241,4654,92868,887270,980138,03/01/2021 12:00:00 AM,290,441,420
Central,Hanover County,51085,320,2085,2405,490,4795,5285,52275,590744,643019,04/01/2015 12:00:00 AM,163,283,267
Central,Hanover County,51085,321,1660,1981,450,3599,4049,47622,431055,478677,02/01/2019 12:00:00 AM,148,260,242
Central,Hanover County,51085,322,1721,2043,441,3700,4141,46982,450961,497943,10/01/2019 12:00:00 AM,146,262,244
Central,Hanover County,51085,322,2011,2333,415,4247,4662,91618,891498,983116,02/01/2021 12:00:00 AM,285,443,421
Central,Hanover County,51085,323,2034,2357,491,4693,5184,52666,560065,612731,10/01/2015 12:00:00 AM,163,275,260
Central,Hanover County,51085,325,2091,2416,505,4804,5309,53306,581988,635294,03/01/2015 12:00:00 AM,164,278,263
Central,Hanover County,51085,326,1740,2066,450,3801,4251,46446,457929,504375,09/01/2019 12:00:00 AM,142,263,244
Central,Hanover County,51085,326,2013,2339,491,4602,5093,53921,550493,604414,11/01/2015 12:00:00 AM,165,273,258
Central,Hanover County,51085,328,1987,2315,482,4522,5004,55200,534098,589298,03/01/2016 12:00:00 AM,168,269,255
Central,Hanover County,51085,329,1684,2013,450,3594,4044,44222,433383,477605,02/01/2020 12:00:00 AM,134,257,237
Central,Hanover County,51085,329,1722,2051,461,3825,4286,50781,464714,515495,12/01/2018 12:00:00 AM,154,270,251
Central,Hanover County,51085,329,1999,2328,500,4572,5072,55559,541427,596986,01/01/2016 12:00:00 AM,169,271,256
Central,Hanover County,51085,330,1725,2055,465,3862,4327,50273,464291,514564,11/01/2018 12:00:00 AM,152,269,250
Central,Hanover County,51085,330,1741,2071,456,3814,4270,50368,470755,521123,01/01/2019 12:00:00 AM,153,270,252
Central,Hanover County,51085,331,1694,2025,458,3574,4032,47777,425359,473136,01/01/2020 12:00:00 AM,144,251,234
Central,Hanover County,51085,331,1781,2112,465,3946,4411,50392,480606,530998,06/01/2018 12:00:00 AM,152,270,251
Central,Hanover County,51085,331,1828,2159,458,4041,4499,49934,488204,538138,04/01/2018 12:00:00 AM,151,267,249
Central,Hanover County,51085,331,2099,2430,509,4837,5346,54721,583914,638635,02/01/2015 12:00:00 AM,165,278,263
Central,Hanover County,51085,332,1715,2047,477,3798,4275,50758,463539,514297,10/01/2018 12:00:00 AM,153,270,251
Central,Hanover County,51085,332,1971,2303,436,4159,4595,100839,945886,1046725,04/01/2021 12:00:00 AM,304,480,455
Central,Hanover County,51085,332,2026,2358,502,4633,5135,56120,553617,609737,12/01/2015 12:00:00 AM,169,273,259
Central,Hanover County,51085,333,1749,2082,443,3691,4134,81285,635632,716917,03/01/2020 12:00:00 AM,244,363,344
Central,Hanover County,51085,333,1966,2299,486,4497,4983,55064,533851,588915,04/01/2016 12:00:00 AM,165,272,256
Central,Hanover County,51085,333,2034,2367,453,4296,4749,86677,791537,878214,12/01/2020 12:00:00 AM,260,389,371
Central,Hanover County,51085,334,1709,2043,464,3675,4139,49026,441248,490274,11/01/2019 12:00:00 AM,147,258,240
Central,Hanover County,51085,334,1871,2205,477,4215,4692,51692,509702,561394,02/01/2018 12:00:00 AM,155,272,255
Central,Hanover County,51085,334,1931,2265,460,4399,4859,48892,543809,592701,03/01/2017 12:00:00 AM,146,282,262
Central,Hanover County,51085,334,1965,2299,437,4139,4576,105751,950796,1056547,05/01/2021 12:00:00 AM,317,484,460
Central,Hanover County,51085,335,1978,2313,486,4460,4946,53559,527961,581520,05/01/2016 12:00:00 AM,160,267,251
Central,Hanover County,51085,336,1882,2218,484,4243,4727,50734,511342,562076,01/01/2018 12:00:00 AM,151,272,253
Central,Hanover County,51085,336,1903,2239,479,4346,4825,51149,530798,581947,12/01/2016 12:00:00 AM,152,279,260
Central,Hanover County,51085,336,2005,2341,452,4218,4670,100678,883696,984374,01/01/2021 12:00:00 AM,300,441,420
Central,Hanover County,51085,337,1716,2053,470,3674,4144,49606,449064,498670,12/01/2019 12:00:00 AM,147,262,243
Central,Hanover County,51085,337,1862,2199,474,4152,4626,50993,498666,549659,03/01/2018 12:00:00 AM,151,268,250
Central,Hanover County,51085,337,1984,2321,443,4137,4580,104273,949369,1053642,06/01/2021 12:00:00 AM,309,479,454
Central,Hanover County,51085,338,1750,2088,499,3864,4363,53473,469278,522751,08/01/2018 12:00:00 AM,158,268,250
Central,Hanover County,51085,338,1892,2230,489,4290,4779,53928,520588,574516,11/01/2016 12:00:00 AM,160,275,258
Central,Hanover County,51085,338,2017,2355,464,4246,4710,89854,779619,869473,11/01/2020 12:00:00 AM,266,387,369
Central,Hanover County,51085,339,1822,2161,480,4014,4494,54248,491818,546066,05/01/2018 12:00:00 AM,160,270,253
Central,Hanover County,51085,339,1911,2250,466,4364,4830,49506,529916,579422,04/01/2017 12:00:00 AM,146,277,258
Central,Hanover County,51085,340,1723,2063,502,3824,4326,56328,462987,519315,09/01/2018 12:00:00 AM,166,269,252
Central,Hanover County,51085,340,1736,2076,492,3835,4327,52462,463393,515855,07/01/2018 12:00:00 AM,154,267,248
Central,Hanover County,51085,340,1839,2179,491,4185,4676,55371,510591,565962,11/01/2017 12:00:00 AM,163,278,260
Central,Hanover County,51085,340,1846,2186,501,4150,4651,55186,503051,558237,12/01/2017 12:00:00 AM,162,273,255
Central,Hanover County,51085,340,1976,2316,456,4161,4617,83382,725199,808581,05/01/2020 12:00:00 AM,245,367,349
Central,Hanover County,51085,340,2056,2396,466,4338,4804,90211,800556,890767,10/01/2020 12:00:00 AM,265,389,372
Central,Hanover County,51085,341,1926,2267,460,4077,4537,85187,715285,800472,04/01/2020 12:00:00 AM,250,371,353
Central,Hanover County,51085,343,1917,2260,511,4337,4848,56499,523519,580018,08/01/2016 12:00:00 AM,165,273,257
Central,Hanover County,51085,343,1929,2272,502,4372,4874,55655,529499,585154,09/01/2016 12:00:00 AM,162,274,258
Central,Hanover County,51085,343,2210,2553,549,4959,5508,59400,608360,667760,12/01/2014 12:00:00 AM,173,275,262
Central,Hanover County,51085,344,1930,2274,501,4390,4891,55285,538805,594090,10/01/2016 12:00:00 AM,161,279,261
Central,Hanover County,51085,344,1995,2339,462,4192,4654,84664,726464,811128,06/01/2020 12:00:00 AM,246,364,347
Central,Hanover County,51085,344,2028,2372,460,4256,4716,85852,741723,827575,07/01/2020 12:00:00 AM,250,366,349
Central,Hanover County,51085,344,2051,2395,460,4293,4753,85453,752320,837773,09/01/2020 12:00:00 AM,248,367,350
Central,Hanover County,51085,344,2174,2518,538,4927,5465,56928,591083,648011,01/01/2015 12:00:00 AM,165,272,257
Central,Hanover County,51085,345,1906,2251,484,4369,4853,53533,537092,590625,06/01/2017 12:00:00 AM,155,282,262
Central,Hanover County,51085,345,1952,2297,503,4438,4941,56099,535488,591587,06/01/2016 12:00:00 AM,163,274,258
Central,Hanover County,51085,346,1904,2250,491,4368,4859,52765,535855,588620,05/01/2017 12:00:00 AM,153,281,262
Central,Hanover County,51085,346,1919,2265,504,4352,4856,57180,526834,584014,07/01/2016 12:00:00 AM,165,275,258
Central,Hanover County,51085,347,1821,2168,502,4159,4661,57219,506702,563921,10/01/2017 12:00:00 AM,165,278,260
Central,Hanover County,51085,347,1857,2204,483,4250,4733,53249,521486,574735,07/01/2017 12:00:00 AM,153,281,261
Central,Hanover County,51085,347,2348,2695,572,5039,5611,61145,598702,659847,06/01/2014 12:00:00 AM,176,255,245
Central,Hanover County,51085,348,1934,2282,479,4420,4899,50715,537328,588043,01/01/2017 12:00:00 AM,146,278,258
Central,Hanover County,51085,348,2350,2698,577,5303,5880,71087,696797,767884,05/01/2012 12:00:00 AM,204,297,285
Central,Hanover County,51085,349,1867,2216,499,4289,4788,57897,526057,583954,08/01/2017 12:00:00 AM,166,282,264
Central,Hanover County,51085,349,2033,2382,477,4267,4744,86381,738857,825238,08/01/2020 12:00:00 AM,248,363,346
Central,Hanover County,51085,350,1979,2329,481,4519,5000,51518,548755,600273,02/01/2017 12:00:00 AM,147,277,258
Central,Hanover County,51085,350,2278,2628,567,5037,5604,60431,598756,659187,08/01/2014 12:00:00 AM,173,263,251
Central,Hanover County,51085,351,1851,2202,506,4255,4761,58769,522133,580902,09/01/2017 12:00:00 AM,167,282,264
Central,Hanover County,51085,351,2236,2587,565,4974,5539,62776,605470,668246,10/01/2014 12:00:00 AM,179,271,258
Central,Hanover County,51085,351,2360,2711,579,5328,5907,70807,699037,769844,06/01/2012 12:00:00 AM,202,296,284
Central,Hanover County,51085,352,2212,2564,571,4956,5527,62482,604953,667435,11/01/2014 12:00:00 AM,178,273,260
Central,Hanover County,51085,352,2380,2732,576,5146,5722,61512,609889,671401,05/01/2014 12:00:00 AM,175,256,246
Central,Hanover County,51085,353,2367,2720,570,5135,5705,61472,610933,672405,04/01/2014 12:00:00 AM,174,258,247
Central,Hanover County,51085,353,2396,2749,566,5219,5785,61748,620772,682520,03/01/2014 12:00:00 AM,175,259,248
Central,Hanover County,51085,354,2448,2802,567,5381,5948,61710,643289,704999,11/01/2013 12:00:00 AM,174,263,252
Central,Hanover County,51085,355,2400,2755,569,5270,5839,60575,631790,692365,12/01/2013 12:00:00 AM,171,263,251
Central,Hanover County,51085,356,2256,2612,578,5000,5578,60733,597809,658542,09/01/2014 12:00:00 AM,171,265,252
Central,Hanover County,51085,356,2296,2652,580,5018,5598,60483,594604,655087,07/01/2014 12:00:00 AM,170,259,247
Central,Hanover County,51085,356,2354,2710,576,5291,5867,70740,699125,769865,07/01/2012 12:00:00 AM,199,297,284
Central,Hanover County,51085,357,2428,2785,584,5290,5874,60793,624065,684858,01/01/2014 12:00:00 AM,170,257,246
Central,Hanover County,51085,358,2392,2750,585,5210,5795,60271,620307,680578,02/01/2014 12:00:00 AM,168,259,247
Central,Hanover County,51085,358,2394,2752,608,5385,5993,76186,710786,786972,03/01/2012 12:00:00 AM,213,297,286
Central,Hanover County,51085,359,2414,2773,582,5427,6009,70066,716205,786271,08/01/2012 12:00:00 AM,195,297,284
Central,Hanover County,51085,359,2449,2808,582,5409,5991,67486,703522,771008,01/01/2013 12:00:00 AM,188,287,275
Central,Hanover County,51085,360,2345,2705,614,5296,5910,76435,698199,774634,04/01/2012 12:00:00 AM,212,298,286
Central,Hanover County,51085,360,2419,2779,623,5385,6008,78223,704537,782760,01/01/2012 12:00:00 AM,217,291,282
Central,Hanover County,51085,360,2439,2799,606,5432,6038,76165,716933,793098,02/01/2012 12:00:00 AM,212,294,283
Central,Hanover County,51085,363,2457,2820,587,5371,5958,67609,704444,772053,03/01/2013 12:00:00 AM,186,287,274
Central,Hanover County,51085,364,2482,2846,585,5460,6045,66820,717813,784633,02/01/2013 12:00:00 AM,184,289,276
Central,Hanover County,51085,366,2439,2805,586,5341,5927,68876,697864,766740,04/01/2013 12:00:00 AM,188,286,273
Central,Hanover County,51085,366,2446,2812,612,5438,6050,70957,711497,782454,12/01/2012 12:00:00 AM,194,291,278
Central,Hanover County,51085,367,2463,2830,589,5389,5978,69855,693087,762942,10/01/2013 12:00:00 AM,190,281,270
Central,Hanover County,51085,368,2451,2819,576,5345,5921,67665,687183,754848,09/01/2013 12:00:00 AM,184,280,268
Central,Hanover County,51085,370,2451,2821,588,5362,5950,68760,694087,762847,08/01/2013 12:00:00 AM,186,283,270
Central,Hanover County,51085,372,2451,2823,630,5477,6107,76454,721857,798311,11/01/2012 12:00:00 AM,206,295,283
Central,Hanover County,51085,373,2412,2785,621,5432,6053,77066,720153,797219,09/01/2012 12:00:00 AM,207,299,286
Central,Hanover County,51085,374,2422,2796,602,5317,5919,70837,685640,756477,07/01/2013 12:00:00 AM,189,283,271
Central,Hanover County,51085,374,2432,2806,607,5370,5977,71417,697834,769251,06/01/2013 12:00:00 AM,191,287,274
Central,Hanover County,51085,374,2457,2831,616,5521,6137,74677,735323,810000,10/01/2012 12:00:00 AM,200,299,286
Central,Hanover County,51085,382,2448,2830,627,5355,5982,74972,695911,770883,05/01/2013 12:00:00 AM,196,284,272
Central,Henrico County,51087,2175,10308,12483,3450,23700,27150,364877,2971727,3336604,02/01/2020 12:00:00 AM,168,288,267
Central,Henrico County,51087,2189,11704,13893,3445,27813,31258,369952,3469194,3839146,01/01/2017 12:00:00 AM,169,296,276
Central,Henrico County,51087,2190,10475,12665,3433,24048,27481,613166,4123881,4737047,03/01/2020 12:00:00 AM,280,394,374
Central,Henrico County,51087,2194,10408,12602,3473,23887,27360,362182,2984466,3346648,01/01/2020 12:00:00 AM,165,287,266
Central,Henrico County,51087,2196,10330,12526,3494,23904,27398,375414,2980375,3355789,02/01/2019 12:00:00 AM,171,289,268
Central,Henrico County,51087,2203,12739,14942,3238,27904,31142,723969,5966698,6690667,02/01/2021 12:00:00 AM,329,468,448
Central,Henrico County,51087,2205,10713,12918,3460,24627,28087,371747,3073986,3445733,11/01/2019 12:00:00 AM,169,287,267
Central,Henrico County,51087,2215,11793,14008,3517,28034,31551,377223,3513006,3890229,12/01/2016 12:00:00 AM,170,298,278
Central,Henrico County,51087,2216,10584,12800,3512,24320,27832,373860,3051592,3425452,12/01/2019 12:00:00 AM,169,288,268
Central,Henrico County,51087,2218,11989,14207,3587,28489,32076,390793,3567805,3958598,10/01/2016 12:00:00 AM,176,298,279
Central,Henrico County,51087,2221,11115,13336,3476,26365,29841,387039,3377201,3764240,05/01/2017 12:00:00 AM,174,304,282
Central,Henrico County,51087,2225,11069,13294,3514,26418,29932,390815,3368506,3759321,07/01/2017 12:00:00 AM,176,304,283
Central,Henrico County,51087,2225,11780,14005,3476,27793,31269,371262,3483212.87,3854474.87,02/01/2017 12:00:00 AM,167,296,275
Central,Henrico County,51087,2226,11055,13281,3569,26322,29891,396281,3336187,3732468,10/01/2017 12:00:00 AM,178,302,281
Central,Henrico County,51087,2228,11125,13353,3516,26421,29937,388786,3400360,3789146,08/01/2017 12:00:00 AM,175,306,284
Central,Henrico County,51087,2229,10905,13134,3510,25183,28693,377635,3149491,3527126,07/01/2019 12:00:00 AM,169,289,269
Central,Henrico County,51087,2235,11514,13749,3472,27243,30715,375197,3468704,3843901,03/01/2017 12:00:00 AM,168,301,280
Central,Henrico County,51087,2237,10824,13061,3518,24932,28450,378760,3157821,3536581,10/01/2019 12:00:00 AM,169,292,271
Central,Henrico County,51087,2238,10973,13211,3538,25287,28825,378047,3158550,3536597,08/01/2019 12:00:00 AM,169,288,268
Central,Henrico County,51087,2241,10960,13201,3640,25974,29614,390083,3244815,3634898,01/01/2018 12:00:00 AM,174,296,275
Central,Henrico County,51087,2241,11051,13292,3543,26407,29950,395580,3371331,3766911,09/01/2017 12:00:00 AM,177,305,283
Central,Henrico County,51087,2241,11167,13408,3573,26482,30055,401155,3396863.53,3798018.53,06/01/2017 12:00:00 AM,179,304,283
Central,Henrico County,51087,2244,10804,13048,3581,24956,28537,379066,3097267,3476333,05/01/2019 12:00:00 AM,169,287,266
Central,Henrico County,51087,2244,11721,13965,3677,27959,31636,400441,3477092,3877533,04/01/2016 12:00:00 AM,178,297,278
Central,Henrico County,51087,2244,11773,14017,3688,28149,31837,399943,3504060,3904003,05/01/2016 12:00:00 AM,178,298,279
Central,Henrico County,51087,2245,11261,13506,3496,26528,30024,381679,3384634,3766313,04/01/2017 12:00:00 AM,170,301,279
Central,Henrico County,51087,2245,12453,14698,3378,27053,30431,786396,6239251,7025647,04/01/2021 12:00:00 AM,350,501,478
Central,Henrico County,51087,2245,12568,14813,3357,27461,30818,732766,5782442,6515208,03/01/2021 12:00:00 AM,326,460,440
Central,Henrico County,51087,2246,12296,14542,3421,26717,30138,798266,6178537,6976803,05/01/2021 12:00:00 AM,355,502,480
Central,Henrico County,51087,2247,11850,14097,3705,28220,31925,428692,3701175,4129867,06/01/2016 12:00:00 AM,191,312,293
Central,Henrico County,51087,2248,11900,14148,3748,28335,32083,414718,3574142,3988860,07/01/2016 12:00:00 AM,184,300,282
Central,Henrico County,51087,2248,11925,14173,3717,28445,32162,403570,3548463,3952033,08/01/2016 12:00:00 AM,180,298,279
Central,Henrico County,51087,2251,10846,13097,3588,25047,28635,386635,3121396,3508031,06/01/2019 12:00:00 AM,172,288,268
Central,Henrico County,51087,2251,11975,14226,3713,28532,32245,405704,3549406,3955110,09/01/2016 12:00:00 AM,180,296,278
Central,Henrico County,51087,2255,11811,14066,3596,28137,31733,392316,3526555,3918871,11/01/2016 12:00:00 AM,174,299,279
Central,Henrico County,51087,2257,11098,13355,3646,26378,30024,406300,3330498,3736798,11/01/2017 12:00:00 AM,180,300,280
Central,Henrico County,51087,2258,11788,14046,3717,28018,31735,407731,3486007,3893738,03/01/2016 12:00:00 AM,181,296,277
Central,Henrico County,51087,2259,10906,13165,3566,25124,28690,386024,3164227,3550251,09/01/2019 12:00:00 AM,171,290,270
Central,Henrico County,51087,2261,10839,13100,3606,25148,28754,387917,3115707,3503624,03/01/2019 12:00:00 AM,172,287,267
Central,Henrico County,51087,2261,12339,14600,3478,26779,30257,815653,6205437,7021090,06/01/2021 12:00:00 AM,361,503,481
Central,Henrico County,51087,2266,10885,13151,3615,25129,28744,388238,3110237,3498475,04/01/2019 12:00:00 AM,171,286,266
Central,Henrico County,51087,2266,10981,13247,3667,26095,29762,406566,3285772,3692338,12/01/2017 12:00:00 AM,179,299,279
Central,Henrico County,51087,2278,11815,14093,3797,28143,31940,419479,3497452,3916931,01/01/2016 12:00:00 AM,184,296,278
Central,Henrico County,51087,2278,11821,14099,3790,28103,31893,416336,3510967,3927303,02/01/2016 12:00:00 AM,183,297,279
Central,Henrico County,51087,2279,12107,14386,3816,28456,32272,438387,3591421,4029808,05/01/2015 12:00:00 AM,192,297,280
Central,Henrico County,51087,2282,10897,13179,3713,25714,29427,404771,3221473,3626244,02/01/2018 12:00:00 AM,177,296,275
Central,Henrico County,51087,2284,10946,13230,3690,25700,29390,396555,3216771,3613326,04/01/2018 12:00:00 AM,174,294,273
Central,Henrico County,51087,2288,12101,14389,3812,28387,32199,436587,3580138,4016725,04/01/2015 12:00:00 AM,191,296,279
Central,Henrico County,51087,2288,12545,14833,3512,27460,30972,762430,5776930,6539360,01/01/2021 12:00:00 AM,333,460,441
Central,Henrico County,51087,2292,11021,13313,3735,25825,29560,408675,3242531.44,3651206.44,03/01/2018 12:00:00 AM,178,294,274
Central,Henrico County,51087,2295,12150,14445,3860,28647,32507,447582,3616259,4063841,06/01/2015 12:00:00 AM,195,298,281
Central,Henrico County,51087,2297,12227,14524,3603,27319,30922,650036,4783632.3,5433668.3,04/01/2020 12:00:00 AM,283,391,374
Central,Henrico County,51087,2298,10914,13212,3715,25566,29281,397798,3199415,3597213,05/01/2018 12:00:00 AM,173,293,272
Central,Henrico County,51087,2301,12176,14477,3846,28908,32754,434668,3629095,4063763,11/01/2015 12:00:00 AM,189,298,281
Central,Henrico County,51087,2301,12212,14513,3854,28865,32719,435406,3635243,4070649,09/01/2015 12:00:00 AM,189,298,280
Central,Henrico County,51087,2301,12595,14896,3544,27520,31064,674665,5066798,5741463,12/01/2020 12:00:00 AM,293,402,385
Central,Henrico County,51087,2302,12230,14532,3865,28968,32833,444232,3642761,4086993,08/01/2015 12:00:00 AM,193,298,281
Central,Henrico County,51087,2303,10964,13267,3719,25728,29447,401066,3224556.46,3625622.46,06/01/2018 12:00:00 AM,174,294,273
Central,Henrico County,51087,2304,12045,14349,3854,28603,32457,434796,3574314,4009110,12/01/2015 12:00:00 AM,189,297,279
Central,Henrico County,51087,2304,12741,15045,3581,27988,31569,683492,5148019,5831511,10/01/2020 12:00:00 AM,297,404,388
Central,Henrico County,51087,2306,10900,13206,3707,25351,29058,417486,3305470,3722956,01/01/2019 12:00:00 AM,181,303,282
Central,Henrico County,51087,2308,12115,14423,3890,28346,32236,444597,3560792,4005389,03/01/2015 12:00:00 AM,193,294,278
Central,Henrico County,51087,2309,12181,14490,3886,28785,32671,439093,3631954,4071047,10/01/2015 12:00:00 AM,190,298,281
Central,Henrico County,51087,2310,12233,14543,3892,28603,32495,442841,3608228,4051069,02/01/2015 12:00:00 AM,192,295,279
Central,Henrico County,51087,2313,12567,14880,3582,27552,31134,681342,5110419,5791761,11/01/2020 12:00:00 AM,295,407,389
Central,Henrico County,51087,2314,12129,14443,3874,28701,32575,446456,3607608,4054064,07/01/2015 12:00:00 AM,193,297,281
Central,Henrico County,51087,2323,10808,13131,3761,25248,29009,427423,3161406,3588829,12/01/2018 12:00:00 AM,184,293,273
Central,Henrico County,51087,2326,13104,15430,3589,28706,32295,648818,4982467,5631285,09/01/2020 12:00:00 AM,279,380,365
Central,Henrico County,51087,2328,12823,15151,3667,28443,32110,661021,4942674,5603695,05/01/2020 12:00:00 AM,284,385,370
Central,Henrico County,51087,2330,13277,15607,3615,29115,32730,646841,4999207,5646048,08/01/2020 12:00:00 AM,278,377,362
Central,Henrico County,51087,2332,10950,13282,3796,25644,29440,412437,3228789.2,3641226.2,07/01/2018 12:00:00 AM,177,295,274
Central,Henrico County,51087,2335,10959,13294,3790,25575,29365,425140,3228964,3654104,11/01/2018 12:00:00 AM,182,295,275
Central,Henrico County,51087,2336,10926,13262,3767,25651,29418,412995,3214066,3627061,09/01/2018 12:00:00 AM,177,294,273
Central,Henrico County,51087,2350,10990,13340,3792,25720,29512,413344,3230195,3643539,08/01/2018 12:00:00 AM,176,294,273
Central,Henrico County,51087,2351,13045,15396,3683,28771,32454,660565,4996075,5656640,06/01/2020 12:00:00 AM,281,383,367
Central,Henrico County,51087,2357,10850,13207,3816,25368,29184,427105,3220344.13,3647449.13,10/01/2018 12:00:00 AM,181,297,276
Central,Henrico County,51087,2357,12508,14865,3961,29071,33032,451912,3644389,4096301,01/01/2015 12:00:00 AM,192,291,276
Central,Henrico County,51087,2357,13242,15599,3676,29137,32813,661543,5026978,5688521,07/01/2020 12:00:00 AM,281,380,365
Central,Henrico County,51087,2363,12841,15204,4049,29552,33601,472887,3776909,4249796,11/01/2014 12:00:00 AM,200,294,280
Central,Henrico County,51087,2364,12978,15342,4035,29432,33467,449413,3653427,4102840,08/01/2014 12:00:00 AM,190,282,267
Central,Henrico County,51087,2378,12745,15123,4083,29359,33442,478132,3734591,4212723,12/01/2014 12:00:00 AM,201,293,279
Central,Henrico County,51087,2394,13056,15450,4116,29449,33565,458043,3652725,4110768,07/01/2014 12:00:00 AM,191,280,266
Central,Henrico County,51087,2399,12891,15290,4118,29523,33641,485911,3792556,4278467,10/01/2014 12:00:00 AM,203,294,280
Central,Henrico County,51087,2405,12835,15240,4166,29225,33391,465142,3611180,4076322,09/01/2014 12:00:00 AM,193,281,267
Central,Henrico County,51087,2416,13316,15732,4157,29730,33887,462677,3701008,4163685,06/01/2014 12:00:00 AM,192,278,265
Central,Henrico County,51087,2448,13542,15990,4287,29769,34056,476887,3732135,4209022,04/01/2014 12:00:00 AM,195,276,263
Central,Henrico County,51087,2459,13433,15892,4281,29809,34090,479169,3711581,4190750,05/01/2014 12:00:00 AM,195,276,264
Central,Henrico County,51087,2468,13660,16128,4346,29861,34207,483410,3719057,4202467,03/01/2014 12:00:00 AM,196,272,261
Central,Henrico County,51087,2478,14088,16566,4325,30659,34984,479190,3822202,4301392,11/01/2013 12:00:00 AM,193,271,260
Central,Henrico County,51087,2479,13838,16317,4319,30201,34520,468196,3738019,4206215,01/01/2014 12:00:00 AM,189,270,258
Central,Henrico County,51087,2498,14029,16527,4351,30626,34977,478719,3807335,4286054,12/01/2013 12:00:00 AM,192,271,259
Central,Henrico County,51087,2501,13733,16234,4382,29979,34361,480205,3728429,4208634,02/01/2014 12:00:00 AM,192,271,259
Central,Henrico County,51087,2507,14170,16677,4442,30669,35111,534253,4131265,4665518,09/01/2013 12:00:00 AM,213,292,280
Central,Henrico County,51087,2511,14156,16667,4424,30753,35177,531354,4134361,4665715,10/01/2013 12:00:00 AM,212,292,280
Central,Henrico County,51087,2520,14237,16757,4504,30766,35270,546173,4147239,4693412,08/01/2013 12:00:00 AM,217,291,280
Central,Henrico County,51087,2543,14157,16700,4581,30602,35183,561303,4119085,4680388,07/01/2013 12:00:00 AM,221,291,280
Central,Henrico County,51087,2573,14168,16741,4622,30652,35274,566071,4122697,4688768,06/01/2013 12:00:00 AM,220,291,280
Central,Henrico County,51087,2609,14135,16744,4757,30597,35354,586437,4114708,4701145,05/01/2013 12:00:00 AM,225,291,281
Central,Henrico County,51087,2620,14001,16621,4767,30389,35156,591021,4084909,4675930,03/01/2013 12:00:00 AM,226,292,281
Central,Henrico County,51087,2622,14014,16636,4803,30295,35098,594293,4081254,4675547,04/01/2013 12:00:00 AM,227,291,281
Central,Henrico County,51087,2639,14018,16657,4822,30508,35330,606025,4119567,4725592,12/01/2012 12:00:00 AM,230,294,284
Central,Henrico County,51087,2648,14021,16669,4840,30432,35272,602402,4065307,4667709,01/01/2013 12:00:00 AM,227,290,280
Central,Henrico County,51087,2650,14053,16703,4825,30477,35302,598601,4102287,4700888,02/01/2013 12:00:00 AM,226,292,281
Central,Henrico County,51087,2652,13403,16055,5069,29597,34666,652346,3947612,4599958,01/01/2012 12:00:00 AM,246,295,287
Central,Henrico County,51087,2654,14042,16696,4838,30524,35362,611365,4125796,4737161,11/01/2012 12:00:00 AM,230,294,284
Central,Henrico County,51087,2661,13488,16149,5020,29700,34720,638144,3991195,4629339,05/01/2012 12:00:00 AM,240,296,287
Central,Henrico County,51087,2666,13451,16117,5067,29668,34735,647977,3971148,4619125,04/01/2012 12:00:00 AM,243,295,287
Central,Henrico County,51087,2671,13764,16435,4942,30145,35087,623788,4069764,4693552,09/01/2012 12:00:00 AM,234,296,286
Central,Henrico County,51087,2672,13510,16182,5040,29712,34752,639215,3988397,4627612,06/01/2012 12:00:00 AM,239,295,286
Central,Henrico County,51087,2674,13434,16108,5109,29592,34701,659982,3962521,4622503,03/01/2012 12:00:00 AM,247,295,287
Central,Henrico County,51087,2674,13446,16120,5080,29646,34726,653705,3979156,4632861,02/01/2012 12:00:00 AM,244,296,287
Central,Henrico County,51087,2674,13883,16557,4921,30196,35117,625130,4084605,4709735,10/01/2012 12:00:00 AM,234,294,284
Central,Henrico County,51087,2675,13710,16385,4998,30002,35000,634028,4043120,4677148,08/01/2012 12:00:00 AM,237,295,285
Central,Henrico County,51087,2690,13588,16278,5090,29813,34903,642848,4003191,4646039,07/01/2012 12:00:00 AM,239,295,285
Central,Hopewell City,51670,543,2438,2981,820,5571,6391,91120,736514,827634,04/01/2017 12:00:00 AM,168,302,278
Central,Hopewell City,51670,545,2466,3011,782,5495,6277,172921,1171587,1344508,02/01/2021 12:00:00 AM,317,475,447
Central,Hopewell City,51670,549,2449,2998,832,5650,6482,95190,738085,833275,03/01/2017 12:00:00 AM,173,301,278
Central,Hopewell City,51670,551,2382,2933,842,5317,6159,88681,695926,784607,01/01/2020 12:00:00 AM,161,292,268
Central,Hopewell City,51670,552,2374,2926,840,5287,6127,91483,692792,784275,02/01/2020 12:00:00 AM,166,292,268
Central,Hopewell City,51670,555,2385,2940,838,5326,6164,150186,911970,1062156,03/01/2020 12:00:00 AM,271,382,361
Central,Hopewell City,51670,557,2482,3039,850,5721,6571,94363,761964,856327,06/01/2017 12:00:00 AM,169,307,282
Central,Hopewell City,51670,558,2433,2991,859,5567,6426,96313,731988,828301,05/01/2017 12:00:00 AM,173,301,277
Central,Hopewell City,51670,560,2440,3000,843,5539,6382,93369,719969,813338,08/01/2019 12:00:00 AM,167,295,271
Central,Hopewell City,51670,561,2422,2983,848,5451,6299,92660,718188,810848,12/01/2019 12:00:00 AM,165,297,272
Central,Hopewell City,51670,561,2515,3076,872,5772,6644,94011,746946,840957,02/01/2017 12:00:00 AM,168,297,273
Central,Hopewell City,51670,563,2444,3007,853,5467,6320,93924,719042,812966,11/01/2019 12:00:00 AM,167,294,270
Central,Hopewell City,51670,564,2477,3041,885,5710,6595,98063,734653,832716,01/01/2017 12:00:00 AM,174,297,274
Central,Hopewell City,51670,564,2497,3061,828,5523,6351,180728,1151483,1332211,03/01/2021 12:00:00 AM,320,461,435
Central,Hopewell City,51670,567,2574,3141,857,5708,6565,154820,988905,1143725,04/01/2020 12:00:00 AM,273,384,364
Central,Hopewell City,51670,568,2468,3036,859,5436,6295,201474,1252473,1453947,04/01/2021 12:00:00 AM,355,507,479
Central,Hopewell City,51670,569,2623,3192,865,5768,6633,154375,992020,1146395,09/01/2020 12:00:00 AM,271,378,359
Central,Hopewell City,51670,570,2433,3003,868,5531,6399,96801,703602,800403,06/01/2019 12:00:00 AM,170,289,267
Central,Hopewell City,51670,570,2436,3006,873,5616,6489,103822,742758,846580,07/01/2017 12:00:00 AM,182,305,282
Central,Hopewell City,51670,570,2483,3053,850,5588,6438,92120,732904,825024,09/01/2019 12:00:00 AM,162,295,270
Central,Hopewell City,51670,570,2668,3238,854,5864,6718,154178,1000351,1154529,08/01/2020 12:00:00 AM,270,375,357
Central,Hopewell City,51670,571,2445,3016,867,5483,6350,96719,726435,823154,10/01/2019 12:00:00 AM,169,297,273
Central,Hopewell City,51670,572,2280,2852,847,5136,5983,93666,659279,752945,02/01/2019 12:00:00 AM,164,289,264
Central,Hopewell City,51670,573,2452,3025,861,5555,6416,97635,708367,806002,07/01/2019 12:00:00 AM,170,289,266
Central,Hopewell City,51670,574,2495,3069,913,5752,6665,100428,739201,839629,12/01/2016 12:00:00 AM,175,296,274
Central,Hopewell City,51670,575,2422,2997,880,5321,6201,204577,1217397,1421974,05/01/2021 12:00:00 AM,356,503,474
Central,Hopewell City,51670,575,2567,3142,881,5640,6521,168123,1036784,1204907,10/01/2020 12:00:00 AM,292,404,383
Central,Hopewell City,51670,576,2425,3001,872,5561,6433,100889,731328,832217,09/01/2017 12:00:00 AM,175,302,277
Central,Hopewell City,51670,577,2434,3011,873,5609,6482,102954,734861,837815,08/01/2017 12:00:00 AM,178,302,278
Central,Hopewell City,51670,577,2649,3226,877,5849,6726,158112,1013761,1171873,05/01/2020 12:00:00 AM,274,383,363
Central,Hopewell City,51670,577,2678,3255,873,5871,6744,157568,1009721,1167289,06/01/2020 12:00:00 AM,273,377,359
Central,Hopewell City,51670,579,2420,2999,993,5713,6706,109981,709515,819496,04/01/2015 12:00:00 AM,190,293,273
Central,Hopewell City,51670,579,2484,3063,887,5488,6375,168905,1002979,1171884,11/01/2020 12:00:00 AM,292,404,383
Central,Hopewell City,51670,579,2504,3083,922,5822,6744,104993,742411,847404,11/01/2016 12:00:00 AM,181,296,275
Central,Hopewell City,51670,580,2367,2947,873,5378,6251,97133,683100,780233,04/01/2019 12:00:00 AM,167,289,265
Central,Hopewell City,51670,580,2409,2989,990,5675,6665,109915,708017,817932,05/01/2015 12:00:00 AM,190,294,274
Central,Hopewell City,51670,580,2717,3297,869,5963,6832,159380,1027691,1187071,07/01/2020 12:00:00 AM,275,378,360
Central,Hopewell City,51670,582,2533,3115,939,5856,6795,107975,747446,855421,10/01/2016 12:00:00 AM,186,295,275
Central,Hopewell City,51670,582,2537,3119,958,5794,6752,106271,738058,844329,02/01/2016 12:00:00 AM,183,291,271
Central,Hopewell City,51670,585,2556,3141,932,5916,6848,106043,749966,856009,08/01/2016 12:00:00 AM,181,293,273
Central,Hopewell City,51670,585,2573,3158,935,5965,6900,105270,757199,862469,09/01/2016 12:00:00 AM,180,294,273
Central,Hopewell City,51670,586,2743,3329,1053,6073,7126,113670,746621,860291,06/01/2014 12:00:00 AM,194,272,258
Central,Hopewell City,51670,587,2427,3014,898,5449,6347,99720,697834,797554,05/01/2019 12:00:00 AM,170,288,265
Central,Hopewell City,51670,587,2460,3047,895,5428,6323,172482,985259,1157741,12/01/2020 12:00:00 AM,294,401,380
Central,Hopewell City,51670,587,2548,3135,944,5864,6808,104674,747302,851976,06/01/2016 12:00:00 AM,178,293,272
Central,Hopewell City,51670,588,2523,3111,993,5850,6843,109591,736802,846393,12/01/2015 12:00:00 AM,186,292,272
Central,Hopewell City,51670,588,2535,3123,998,5879,6877,113090,738040,851130,10/01/2015 12:00:00 AM,192,291,273
Central,Hopewell City,51670,589,2426,3015,906,5321,6227,211458,1229220,1440678,06/01/2021 12:00:00 AM,359,507,478
Central,Hopewell City,51670,589,2475,3064,1002,5821,6823,112929,731241,844170,08/01/2015 12:00:00 AM,192,295,276
Central,Hopewell City,51670,589,2493,3082,978,5757,6735,109610,724886,834496,01/01/2016 12:00:00 AM,186,291,271
Central,Hopewell City,51670,589,2524,3113,969,5774,6743,107490,734197,841687,03/01/2016 12:00:00 AM,182,291,270
Central,Hopewell City,51670,590,2393,2983,890,5410,6300,102013,725193,827206,01/01/2019 12:00:00 AM,173,303,277
Central,Hopewell City,51670,590,2410,3000,1009,5724,6733,112036,707023,819059,03/01/2015 12:00:00 AM,190,293,273
Central,Hopewell City,51670,590,2432,3022,985,5725,6710,108260,713763,822023,06/01/2015 12:00:00 AM,183,293,272
Central,Hopewell City,51670,590,2605,3195,1046,5965,7011,119687,761894,881581,10/01/2014 12:00:00 AM,203,292,276
Central,Hopewell City,51670,590,2760,3350,1045,6126,7171,112373,760233,872606,11/01/2013 12:00:00 AM,190,275,260
Central,Hopewell City,51670,591,2452,3043,875,5583,6458,100223,715093,815316,06/01/2018 12:00:00 AM,170,292,268
Central,Hopewell City,51670,592,2383,2975,1009,5648,6657,113439,700292,813731,02/01/2015 12:00:00 AM,192,294,274
Central,Hopewell City,51670,592,2523,3115,965,5771,6736,104582,732672,837254,04/01/2016 12:00:00 AM,177,290,269
Central,Hopewell City,51670,592,2548,3140,1008,5924,6932,114647,746137,860784,11/01/2015 12:00:00 AM,194,293,274
Central,Hopewell City,51670,592,2549,3141,1059,5850,6909,121689,746392,868081,11/01/2014 12:00:00 AM,206,293,276
Central,Hopewell City,51670,592,2641,3233,1068,5846,6914,124054,787828,911882,04/01/2012 12:00:00 AM,210,298,282
Central,Hopewell City,51670,593,2393,2986,892,5470,6362,99351,699450,798801,03/01/2019 12:00:00 AM,168,292,268
Central,Hopewell City,51670,593,2414,3007,932,5348,6280,202785,1122124,1324909,01/01/2021 12:00:00 AM,342,465,441
Central,Hopewell City,51670,593,2535,3128,971,5820,6791,107205,741834,849039,05/01/2016 12:00:00 AM,181,293,271
Central,Hopewell City,51670,594,2435,3029,893,5573,6466,102510,721918,824428,10/01/2017 12:00:00 AM,173,296,272
Central,Hopewell City,51670,594,2470,3064,893,5613,6506,102791,715726,818517,05/01/2018 12:00:00 AM,173,290,267
Central,Hopewell City,51670,595,2388,2983,882,5407,6289,100778,696807,797585,12/01/2018 12:00:00 AM,169,292,267
Central,Hopewell City,51670,595,2534,3129,968,5846,6814,109407,739382,848789,07/01/2016 12:00:00 AM,184,292,271
Central,Hopewell City,51670,595,2651,3246,1085,5873,6958,125431,797409,922840,05/01/2012 12:00:00 AM,211,301,284
Central,Hopewell City,51670,596,2511,3107,996,5862,6858,114378,735809,850187,09/01/2015 12:00:00 AM,192,293,274
Central,Hopewell City,51670,596,2741,3337,1073,6053,7126,116884,745044,861928,12/01/2013 12:00:00 AM,196,272,258
Central,Hopewell City,51670,597,2679,3276,1086,5938,7024,127990,803190,931180,06/01/2012 12:00:00 AM,214,300,284
Central,Hopewell City,51670,598,2441,3039,898,5595,6493,103361,721788,825149,12/01/2017 12:00:00 AM,173,296,272
Central,Hopewell City,51670,598,2644,3242,1104,5827,6931,129287,787847,917134,03/01/2012 12:00:00 AM,216,298,283
Central,Hopewell City,51670,599,2465,3064,874,5622,6496,97897,723359,821256,02/01/2018 12:00:00 AM,163,293,268
Central,Hopewell City,51670,599,2741,3340,1096,6077,7173,117848,751079,868927,05/01/2014 12:00:00 AM,197,274,260
Central,Hopewell City,51670,599,2765,3364,1083,6089,7172,115907,752874,868781,04/01/2014 12:00:00 AM,194,272,258
Central,Hopewell City,51670,600,2432,3032,1020,5746,6766,115488,720701,836189,07/01/2015 12:00:00 AM,192,296,276
Central,Hopewell City,51670,600,2494,3094,1061,5760,6821,122161,731670,853831,12/01/2014 12:00:00 AM,204,293,276
Central,Hopewell City,51670,601,2466,3067,905,5593,6498,104258.5,721411,825669.5,08/01/2018 12:00:00 AM,173,293,269
Central,Hopewell City,51670,602,2610,3212,1093,5922,7015,120313,730150,850463,09/01/2014 12:00:00 AM,200,280,265
Central,Hopewell City,51670,602,2715,3317,1094,6009,7103,128317,813101,941418,09/01/2012 12:00:00 AM,213,299,284
Central,Hopewell City,51670,603,2697,3300,1095,6042,7137,120839,746548,867387,07/01/2014 12:00:00 AM,200,277,263
Central,Hopewell City,51670,604,2423,3027,909,5515,6424,104666,710097.29,814763.29,07/01/2018 12:00:00 AM,173,293,269
Central,Hopewell City,51670,604,2445,3049,898,5545,6443,101720,716863,818583,11/01/2018 12:00:00 AM,168,293,268
Central,Hopewell City,51670,604,2465,3069,890,5601,6491,100108,717722,817830,01/01/2018 12:00:00 AM,166,291,266
Central,Hopewell City,51670,605,2475,3080,907,5609,6516,106760,737533,844293,10/01/2018 12:00:00 AM,176,298,274
Central,Hopewell City,51670,605,2671,3276,1095,6010,7105,121022,740064,861086,08/01/2014 12:00:00 AM,200,277,263
Central,Hopewell City,51670,606,2432,3038,915,5558,6473,103823,724058,827881,11/01/2017 12:00:00 AM,171,298,273
Central,Hopewell City,51670,606,2758,3364,1064,6113,7177,123942,816379,940321,09/01/2013 12:00:00 AM,205,296,280
Central,Hopewell City,51670,607,2429,3036,1049,5685,6734,116020,707459,823479,01/01/2015 12:00:00 AM,191,291,271
Central,Hopewell City,51670,607,2452,3059,906,5586,6492,103200,715815,819015,09/01/2018 12:00:00 AM,170,292,268
Central,Hopewell City,51670,607,2457,3064,904,5595,6499,102692,713509,816201,04/01/2018 12:00:00 AM,169,290,266
Central,Hopewell City,51670,607,2469,3076,897,5635,6532,100659,717891,818550,03/01/2018 12:00:00 AM,166,291,266
Central,Hopewell City,51670,609,2617,3226,1141,5775,6916,136112,773813,909925,01/01/2012 12:00:00 AM,224,296,282
Central,Hopewell City,51670,609,2642,3251,1144,5806,6950,136956,783837,920793,02/01/2012 12:00:00 AM,225,297,283
Central,Hopewell City,51670,610,2674,3284,1118,5928,7046,131155,804241,935396,07/01/2012 12:00:00 AM,215,301,285
Central,Hopewell City,51670,611,2686,3297,1104,5937,7041,129540,806107,935647,08/01/2012 12:00:00 AM,212,300,284
Central,Hopewell City,51670,612,2732,3344,1098,6013,7111,119648,739676,859324,02/01/2014 12:00:00 AM,196,271,257
Central,Hopewell City,51670,614,2737,3351,1102,6030,7132,118554,738611,857165,03/01/2014 12:00:00 AM,193,270,256
Central,Hopewell City,51670,614,2754,3368,1103,6046,7149,131250,810126,941376,10/01/2013 12:00:00 AM,214,294,280
Central,Hopewell City,51670,616,2733,3349,1122,5990,7112,120544,725840,846384,01/01/2014 12:00:00 AM,196,266,253
Central,Hopewell City,51670,622,2657,3279,1136,5822,6958,133536,786436,919972,02/01/2013 12:00:00 AM,215,296,281
Central,Hopewell City,51670,627,2707,3334,1138,5972,7110,134027,804055,938082,08/01/2013 12:00:00 AM,214,297,281
Central,Hopewell City,51670,628,2655,3283,1156,5817,6973,135424,776157,911581,01/01/2013 12:00:00 AM,216,292,278
Central,Hopewell City,51670,629,2655,3284,1152,5841,6993,136441,789046,925487,12/01/2012 12:00:00 AM,217,297,282
Central,Hopewell City,51670,629,2683,3312,1136,5902,7038,135791,792965,928756,05/01/2013 12:00:00 AM,216,296,280
Central,Hopewell City,51670,629,2692,3321,1155,5935,7090,138223,804447,942670,10/01/2012 12:00:00 AM,220,299,284
Central,Hopewell City,51670,632,2676,3308,1148,5894,7042,137781,797758,935539,06/01/2013 12:00:00 AM,218,298,283
Central,Hopewell City,51670,634,2658,3292,1154,5842,6996,138574,787540,926114,04/01/2013 12:00:00 AM,219,296,281
Central,Hopewell City,51670,634,2706,3340,1146,5972,7118,137279,802743,940022,07/01/2013 12:00:00 AM,217,297,281
Central,Hopewell City,51670,636,2664,3300,1182,5849,7031,140810,792403,933213,11/01/2012 12:00:00 AM,221,297,283
Central,Hopewell City,51670,637,2645,3282,1169,5812,6981,136377,780149,916526,03/01/2013 12:00:00 AM,214,295,279
Central,King William County,51101,100,773,873,173,1803,1976,21242,231108,252350,05/01/2013 12:00:00 AM,212,299,289
Central,King William County,51101,101,759,860,172,1781,1953,21273,230140,251413,09/01/2012 12:00:00 AM,211,303,292
Central,King William County,51101,102,762,864,175,1766,1941,21929,231616,253545,08/01/2012 12:00:00 AM,215,304,293
Central,King William County,51101,102,770,872,177,1811,1988,21801,235335,257136,10/01/2012 12:00:00 AM,214,306,295
Central,King William County,51101,102,781,883,175,1847,2022,21784,239192,260976,11/01/2012 12:00:00 AM,214,306,296
Central,King William County,51101,102,789,891,174,1871,2045,20902,241974,262876,12/01/2012 12:00:00 AM,205,307,295
Central,King William County,51101,103,773,876,182,1803,1985,22517,230708,253225,04/01/2013 12:00:00 AM,219,298,289
Central,King William County,51101,103,791,894,175,1855,2030,20827,237033,257860,02/01/2013 12:00:00 AM,202,300,288
Central,King William County,51101,105,790,895,178,1871,2049,21638,235866,257504,01/01/2013 12:00:00 AM,206,299,288
Central,King William County,51101,65,594,659,80,1391,1471,8082,165839,173921,08/01/2016 12:00:00 AM,124,279,264
Central,King William County,51101,66,583,649,95,1359,1454,10016,163387,173403,01/01/2017 12:00:00 AM,152,280,267
Central,King William County,51101,68,552,620,94,1261,1355,10499,149072,159571,01/01/2018 12:00:00 AM,154,270,257
Central,King William County,51101,68,568,636,95,1297,1392,11072,158370,169442,10/01/2017 12:00:00 AM,163,279,266
Central,King William County,51101,68,585,653,91,1366,1457,9890,164236,174126,09/01/2016 12:00:00 AM,145,281,267
Central,King William County,51101,70,593,663,91,1383,1474,9645,163638,173283,07/01/2016 12:00:00 AM,138,276,261
Central,King William County,51101,71,572,643,100,1313,1413,11284,156642,167926,04/01/2017 12:00:00 AM,159,274,261
Central,King William County,51101,71,575,646,104,1319,1423,12428,156851,169279,11/01/2017 12:00:00 AM,175,273,262
Central,King William County,51101,71,576,647,102,1317,1419,11903,157130,169033,12/01/2017 12:00:00 AM,168,273,261
Central,King William County,51101,71,582,653,98,1375,1473,10825,163800,174625,10/01/2016 12:00:00 AM,152,281,267
Central,Lancaster County,51103,124,538,662,172,1172,1344,14009,132730,146739,02/01/2019 12:00:00 AM,113,247,222
Central,King William County,51101,71,585,656,101,1351,1452,11059,161192,172251,03/01/2017 12:00:00 AM,156,276,263
Central,King William County,51101,71,585,656,101,1376,1477,10697,166676,177373,12/01/2016 12:00:00 AM,151,285,270
Central,King William County,51101,71,587,658,97,1377,1474,11011,165865,176876,11/01/2016 12:00:00 AM,155,283,269
Central,King William County,51101,72,557,629,105,1271,1376,12269,149196,161465,02/01/2018 12:00:00 AM,170,268,257
Central,King William County,51101,72,559,631,98,1201,1299,10725,138516,149241,02/01/2020 12:00:00 AM,149,248,237
Central,King William County,51101,72,574,646,96,1236,1332,17432,215087,232519,03/01/2020 12:00:00 AM,242,375,360
Central,King William County,51101,73,520,593,93,1118,1211,9723,127067,136790,09/01/2019 12:00:00 AM,133,244,231
Central,King William County,51101,73,553,626,100,1283,1383,10721,155768,166489,07/01/2017 12:00:00 AM,147,282,266
Central,King William County,51101,73,561,634,103,1287,1390,11651,154933,166584,06/01/2017 12:00:00 AM,160,276,263
Central,King William County,51101,73,562,635,97,1280,1377,10034,154868,164902,09/01/2017 12:00:00 AM,137,276,260
Central,King William County,51101,73,650,723,97,1404,1501,17873,239539,257412,08/01/2020 12:00:00 AM,245,369,356
Central,King William County,51101,74,516,590,102,1160,1262,11217,135217,146434,11/01/2018 12:00:00 AM,152,262,248
Central,King William County,51101,74,519,593,98,1110,1208,9699,128503,138202,05/01/2019 12:00:00 AM,131,248,233
Central,King William County,51101,74,548,622,114,1236,1350,12753,144325,157078,03/01/2018 12:00:00 AM,172,263,253
Central,King William County,51101,74,553,627,99,1191,1290,10315,136297,146612,12/01/2019 12:00:00 AM,139,246,234
Central,King William County,51101,74,554,628,101,1203,1304,10326,137407,147733,01/01/2020 12:00:00 AM,140,248,235
Central,King William County,51101,74,575,649,111,1335,1446,11839,158328,170167,02/01/2017 12:00:00 AM,160,275,262
Central,King William County,51101,74,610,684,101,1321,1422,18661,227162,245823,04/01/2020 12:00:00 AM,252,372,359
Central,King William County,51101,74,636,710,102,1369,1471,18905,233978,252883,05/01/2020 12:00:00 AM,255,368,356
Central,King William County,51101,74,642,716,98,1372,1470,18087,237159,255246,09/01/2020 12:00:00 AM,244,369,356
Central,King William County,51101,74,651,725,102,1410,1512,18641,242090,260731,07/01/2020 12:00:00 AM,252,372,360
Central,King William County,51101,75,509,584,102,1092,1194,11391,121319,132710,08/01/2019 12:00:00 AM,152,238,227
Central,King William County,51101,75,558,633,109,1288,1397,12306,154399,166705,05/01/2017 12:00:00 AM,164,277,263
Central,King William County,51101,75,606,681,100,1317,1417,19029,240871,259900,12/01/2020 12:00:00 AM,254,397,382
Central,King William County,51101,76,489,565,110,1076,1186,12643,122038,134681,02/01/2019 12:00:00 AM,166,250,238
Central,King William County,51101,76,506,582,105,1125,1230,11215,132294,143509,12/01/2018 12:00:00 AM,148,261,247
Central,King William County,51101,76,512,588,104,1094,1198,11122,127506,138628,04/01/2019 12:00:00 AM,146,249,236
Central,King William County,51101,76,547,623,113,1241,1354,12868,145065,157933,04/01/2018 12:00:00 AM,169,265,254
Central,King William County,51101,76,556,632,107,1268,1375,12172,154435,166607,08/01/2017 12:00:00 AM,160,278,264
Central,King William County,51101,76,595,671,108,1379,1487,12419,165865,178284,05/01/2016 12:00:00 AM,163,279,266
Central,King William County,51101,76,635,711,101,1377,1478,19358,247818,267176,10/01/2020 12:00:00 AM,255,390,376
Central,King William County,51101,76,644,720,104,1384,1488,19197,239528,258725,06/01/2020 12:00:00 AM,253,372,359
Central,King William County,51101,77,500,577,108,1084,1192,11568,125471,137039,03/01/2019 12:00:00 AM,150,251,238
Central,King William County,51101,77,511,588,102,1099,1201,10302,124753,135055,06/01/2019 12:00:00 AM,134,244,230
Central,King William County,51101,77,516,593,111,1182,1293,13469,141491,154960,10/01/2018 12:00:00 AM,175,274,261
Central,King William County,51101,77,519,596,112,1161,1273,11932,133746,145678,09/01/2018 12:00:00 AM,155,258,244
Central,King William County,51101,77,528,605,113,1193,1306,12652,140176,152828,08/01/2018 12:00:00 AM,164,265,253
Central,King William County,51101,77,593,670,108,1389,1497,12389,165921,178310,06/01/2016 12:00:00 AM,161,280,266
Central,King William County,51101,77,602,679,106,1291,1397,23674,265326,289000,01/01/2021 12:00:00 AM,307,441,426
Central,King William County,51101,77,618,695,101,1338,1439,23568,279312,302880,02/01/2021 12:00:00 AM,306,452,436
Central,King William County,51101,77,623,700,99,1355,1454,19310,248052,267362,11/01/2020 12:00:00 AM,251,398,382
Central,King William County,51101,77,675,752,107,1589,1696,12409,187082,199491,03/01/2015 12:00:00 AM,161,277,265
Central,King William County,51101,78,499,577,112,1097,1209,12463,130820,143283,01/01/2019 12:00:00 AM,160,262,248
Central,King William County,51101,78,537,615,114,1205,1319,12841,140282,153123,07/01/2018 12:00:00 AM,165,261,249
Central,King William County,51101,78,601,679,103,1297,1400,22994,269681,292675,03/01/2021 12:00:00 AM,295,449,431
Central,King William County,51101,78,664,742,106,1546,1652,11550,182367,193917,04/01/2015 12:00:00 AM,148,275,261
Central,King William County,51101,79,547,626,117,1241,1358,13062,146726,159788,05/01/2018 12:00:00 AM,165,268,255
Central,King William County,51101,79,591,670,105,1269,1374,24634,289294,313928,04/01/2021 12:00:00 AM,312,489,469
Central,King William County,51101,79,593,672,118,1379,1497,14157,163525,177682,04/01/2016 12:00:00 AM,179,276,264
Central,King William County,51101,79,675,754,105,1545,1650,11456,183949,195405,07/01/2015 12:00:00 AM,145,273,259
Central,King William County,51101,79,675,754,110,1550,1660,12118,183982,196100,06/01/2015 12:00:00 AM,153,273,260
Central,King William County,51101,80,504,584,106,1093,1199,11123,122057,133180,07/01/2019 12:00:00 AM,139,242,228
Central,King William County,51101,80,533,613,108,1148,1256,11275,131730,143005,11/01/2019 12:00:00 AM,141,247,233
Central,King William County,51101,80,535,615,117,1208,1325,13417,143317,156734,06/01/2018 12:00:00 AM,168,268,255
Central,King William County,51101,80,539,619,104,1164,1268,10790,136119,146909,10/01/2019 12:00:00 AM,135,253,237
Central,King William County,51101,80,587,667,110,1250,1360,25660,284617,310277,05/01/2021 12:00:00 AM,321,485,465
Central,King William County,51101,80,672,752,119,1535,1654,13401,181138,194539,10/01/2015 12:00:00 AM,168,270,259
Central,King William County,51101,80,675,755,118,1553,1671,12954,181103,194057,05/01/2015 12:00:00 AM,162,268,257
Central,King William County,51101,80,677,757,115,1537,1652,12584,181234,193818,09/01/2015 12:00:00 AM,157,268,256
Central,King William County,51101,81,630,711,120,1463,1583,14408,174311,188719,02/01/2016 12:00:00 AM,178,277,265
Central,King William County,51101,81,665,746,111,1509,1620,12296,178788,191084,08/01/2015 12:00:00 AM,152,269,256
Central,King William County,51101,81,665,746,122,1520,1642,14336,182047,196383,11/01/2015 12:00:00 AM,177,274,263
Central,King William County,51101,82,608,690,125,1402,1527,15019,164598,179617,03/01/2016 12:00:00 AM,183,271,260
Central,King William County,51101,82,656,738,117,1547,1664,13609,185148,198757,01/01/2015 12:00:00 AM,166,282,269
Central,King William County,51101,82,657,739,127,1497,1624,15504,177570,193074,12/01/2015 12:00:00 AM,189,270,261
Central,King William County,51101,82,711,793,125,1656,1781,13931,196544,210475,07/01/2014 12:00:00 AM,170,276,265
Central,King William County,51101,82,766,848,127,1770,1897,12388,211662,224050,02/01/2014 12:00:00 AM,151,276,264
Central,King William County,51101,83,589,672,116,1278,1394,26917,289172,316089,06/01/2021 12:00:00 AM,324,491,470
Central,King William County,51101,83,668,751,123,1564,1687,13474,187138,200612,02/01/2015 12:00:00 AM,162,280,267
Central,King William County,51101,83,764,847,131,1754,1885,13182,207204,220386,01/01/2014 12:00:00 AM,159,271,260
Central,King William County,51101,84,641,725,133,1466,1599,16393,172723,189116,01/01/2016 12:00:00 AM,195,269,261
Central,King William County,51101,84,766,850,131,1760,1891,13151,208290,221441,03/01/2014 12:00:00 AM,157,272,261
Central,King William County,51101,85,659,744,125,1535,1660,14808,183040,197848,12/01/2014 12:00:00 AM,174,278,266
Central,King William County,51101,85,672,757,125,1561,1686,14620,191080,205700,11/01/2014 12:00:00 AM,172,284,272
Central,King William County,51101,86,696,782,133,1623,1756,15115,191168,206283,08/01/2014 12:00:00 AM,176,275,264
Central,King William County,51101,86,731,817,129,1700,1829,14445,201975,216420,06/01/2014 12:00:00 AM,168,276,265
Central,King William County,51101,86,760,846,136,1754,1890,13729,210805,224534,12/01/2013 12:00:00 AM,160,277,265
Central,King William County,51101,87,694,781,130,1613,1743,14483,189103,203586,09/01/2014 12:00:00 AM,166,272,261
Central,King William County,51101,88,747,835,137,1722,1859,15618,202621,218239,05/01/2014 12:00:00 AM,177,271,261
Central,King William County,51101,89,755,844,143,1748,1891,14505,209660,224165,11/01/2013 12:00:00 AM,163,278,266
Central,King William County,51101,89,759,848,146,1751,1897,15891,205247,221138,04/01/2014 12:00:00 AM,179,270,261
Central,King William County,51101,89,759,848,148,1770,1918,17713,226497,244210,09/01/2013 12:00:00 AM,199,298,288
Central,King William County,51101,92,756,848,160,1770,1930,20112,226960,247072,07/01/2013 12:00:00 AM,219,300,291
Central,King William County,51101,93,750,843,161,1750,1911,20252,225392,245644,08/01/2013 12:00:00 AM,218,301,291
Central,King William County,51101,93,759,852,160,1773,1933,19454,228732,248186,10/01/2013 12:00:00 AM,209,301,291
Central,King William County,51101,94,668,762,148,1548,1696,18107,189517,207624,10/01/2014 12:00:00 AM,193,284,272
Central,King William County,51101,96,761,857,156,1749,1905,18882,227365,246247,05/01/2012 12:00:00 AM,197,299,287
Central,King William County,51101,96,775,871,169,1812,1981,20800,231673,252473,06/01/2013 12:00:00 AM,217,299,290
Central,King William County,51101,96,778,874,162,1788,1950,19872,229907,249779,04/01/2012 12:00:00 AM,207,296,286
Central,King William County,51101,96,785,881,162,1841,2003,19782,237675,257457,03/01/2012 12:00:00 AM,206,303,292
Central,King William County,51101,96,788,884,159,1872,2031,19647,240351,259998,02/01/2012 12:00:00 AM,205,305,294
Central,King William County,51101,97,777,874,166,1850,2016,20511,236573,257084,01/01/2012 12:00:00 AM,211,304,294
Central,King William County,51101,98,755,853,169,1731,1900,21201,225944,247145,07/01/2012 12:00:00 AM,216,299,290
Central,King William County,51101,98,763,861,161,1751,1912,19696,227912,247608,06/01/2012 12:00:00 AM,201,299,288
Central,King William County,51101,98,782,880,167,1839,2006,20041,238909,258950,03/01/2013 12:00:00 AM,205,306,294
Central,King and Queen County,51097,64,518,582,77,1161,1238,7661,142766,150427,08/01/2013 12:00:00 AM,120,276,258
Central,King and Queen County,51097,66,509,575,90,1150,1240,8996,142378,151374,06/01/2012 12:00:00 AM,136,280,263
Central,King and Queen County,51097,66,515,581,88,1136,1224,9039,139867,148906,07/01/2013 12:00:00 AM,137,272,256
Central,King and Queen County,51097,67,503,570,95,1150,1245,9656,143629,153285,07/01/2012 12:00:00 AM,144,286,269
Central,King and Queen County,51097,67,514,581,99,1146,1245,10963,141257,152220,04/01/2012 12:00:00 AM,164,275,262
Central,King and Queen County,51097,67,522,589,89,1146,1235,9105,143321,152426,06/01/2013 12:00:00 AM,136,275,259
Central,King and Queen County,51097,68,493,561,98,1120,1218,10601,138932,149533,01/01/2013 12:00:00 AM,156,282,267
Central,King and Queen County,51097,69,372,441,92,877,969,10288,113789,124077,08/01/2017 12:00:00 AM,149,306,281
Central,King and Queen County,51097,69,382,451,84,827,911,10468,112690,123158,01/01/2019 12:00:00 AM,152,295,273
Central,King and Queen County,51097,69,382,451,86,831,917,10719,106740,117459,12/01/2018 12:00:00 AM,155,279,260
Central,King and Queen County,51097,69,422,491,88,852,940,16370,147993,164363,06/01/2020 12:00:00 AM,237,351,335
Central,King and Queen County,51097,69,507,576,95,1127,1222,9777,139707,149484,05/01/2013 12:00:00 AM,142,276,260
Central,King and Queen County,51097,69,507,576,99,1132,1231,11077,140074,151151,04/01/2013 12:00:00 AM,161,276,262
Central,King and Queen County,51097,69,511,580,98,1141,1239,9694,139996,149690,05/01/2012 12:00:00 AM,140,274,258
Central,King and Queen County,51097,69,519,588,84,1173,1257,8613,147164,155777,09/01/2013 12:00:00 AM,125,284,265
Central,King and Queen County,51097,70,374,444,91,802,893,11080,103473,114553,11/01/2018 12:00:00 AM,158,277,258
Central,King and Queen County,51097,70,382,452,89,820,909,10073,106584,116657,06/01/2018 12:00:00 AM,144,279,258
Central,King and Queen County,51097,70,427,497,95,865,960,17421,151709,169130,07/01/2020 12:00:00 AM,249,355,340
Central,King and Queen County,51097,70,433,503,93,881,974,17008,152720,169728,08/01/2020 12:00:00 AM,243,353,337
Central,King and Queen County,51097,70,509,579,99,1161,1260,9895,142968,152863,08/01/2012 12:00:00 AM,141,281,264
Central,King and Queen County,51097,70,515,585,87,1163,1250,7548,136094,143642,11/01/2013 12:00:00 AM,108,264,246
Central,King and Queen County,51097,71,360,431,87,797,884,10702,102070,112772,09/01/2018 12:00:00 AM,151,284,262
Central,King and Queen County,51097,71,362,433,89,765,854,9999,97659,107658,02/01/2019 12:00:00 AM,141,270,249
Central,King and Queen County,51097,71,365,436,90,762,852,8589,92995,101584,02/01/2020 12:00:00 AM,121,255,233
Central,King and Queen County,51097,71,367,438,89,760,849,8599,93066,101665,01/01/2020 12:00:00 AM,121,254,232
Central,King and Queen County,51097,71,369,440,89,804,893,10875,104145,115020,08/01/2018 12:00:00 AM,153,282,261
Central,King and Queen County,51097,71,373,444,87,809,896,11371,114494.81,125865.81,10/01/2018 12:00:00 AM,160,307,283
Central,King and Queen County,51097,71,375,446,90,780,870,16636,134918,151554,03/01/2020 12:00:00 AM,234,360,340
Central,King and Queen County,51097,71,378,449,90,892,982,9245,107413,116658,03/01/2017 12:00:00 AM,130,284,260
Central,King and Queen County,51097,71,384,455,94,823,917,11081,108514,119595,05/01/2018 12:00:00 AM,156,283,263
Central,King and Queen County,51097,71,400,471,92,819,911,16490,142400,158890,04/01/2020 12:00:00 AM,232,356,337
Central,King and Queen County,51097,71,420,491,92,849,941,17412,148371,165783,05/01/2020 12:00:00 AM,245,353,338
Central,King and Queen County,51097,71,420,491,93,857,950,21543,197294,218837,04/01/2021 12:00:00 AM,303,470,446
Central,King and Queen County,51097,71,424,495,96,870,966,17522,153421,170943,09/01/2020 12:00:00 AM,247,362,345
Central,King and Queen County,51097,71,429,500,91,883,974,19840,183294,203134,03/01/2021 12:00:00 AM,279,427,406
Central,King and Queen County,51097,71,494,565,105,1128,1233,12286,140265,152551,11/01/2012 12:00:00 AM,173,284,270
Central,King and Queen County,51097,71,494,565,110,1147,1257,13059,141469,154528,12/01/2012 12:00:00 AM,184,286,274
Central,King and Queen County,51097,71,507,578,110,1139,1249,13165,141975,155140,02/01/2013 12:00:00 AM,185,280,268
Central,King and Queen County,51097,71,515,586,88,1166,1254,8834,146263,155097,10/01/2013 12:00:00 AM,124,284,265
Central,King and Queen County,51097,72,371,443,91,877,968,9550,109132,118682,04/01/2017 12:00:00 AM,133,294,268
Central,King and Queen County,51097,72,374,446,90,804,894,10763,102414,113177,07/01/2018 12:00:00 AM,149,274,254
Central,King and Queen County,51097,72,391,463,95,889,984,10049,114266,124315,11/01/2017 12:00:00 AM,140,292,268
Central,King and Queen County,51097,72,393,465,97,849,946,10567,107450,118017,03/01/2018 12:00:00 AM,147,273,254
Central,King and Queen County,51097,72,394,466,96,856,952,10012,108693,118705,02/01/2018 12:00:00 AM,139,276,255
Central,King and Queen County,51097,72,428,500,97,878,975,18259,156994,175253,10/01/2020 12:00:00 AM,254,367,351
Central,King and Queen County,51097,72,431,503,93,878,971,21181,189454,210635,02/01/2021 12:00:00 AM,294,440,419
Central,King and Queen County,51097,72,502,574,109,1122,1231,12777,138963,151740,03/01/2013 12:00:00 AM,177,277,264
Central,King and Queen County,51097,73,363,436,87,768,855,9061,94861,103922,10/01/2019 12:00:00 AM,124,261,238
Central,King and Queen County,51097,73,368,441,94,876,970,10768,108153,118921,05/01/2017 12:00:00 AM,148,294,270
Central,King and Queen County,51097,73,376,449,102,880,982,11507,111041,122548,09/01/2017 12:00:00 AM,158,295,273
Central,King and Queen County,51097,73,388,461,96,906,1002,10275,114590,124865,10/01/2017 12:00:00 AM,141,295,271
Central,King and Queen County,51097,73,421,494,92,863,955,21526,198906,220432,06/01/2021 12:00:00 AM,295,472,446
Central,King and Queen County,51097,73,426,499,93,866,959,21925,199488,221413,05/01/2021 12:00:00 AM,300,468,444
Central,King and Queen County,51097,73,494,567,102,1112,1214,10966,137354,148320,02/01/2012 12:00:00 AM,150,278,262
Central,King and Queen County,51097,73,500,573,107,1138,1245,10873,131412,142285,03/01/2014 12:00:00 AM,149,263,248
Central,King and Queen County,51097,73,509,582,108,1140,1248,12047,139227,151274,03/01/2012 12:00:00 AM,165,274,260
Central,King and Queen County,51097,74,364,438,93,760,853,9763,94440,104203,12/01/2019 12:00:00 AM,132,259,238
Central,King and Queen County,51097,74,370,444,88,788,876,9179,97064,106243,11/01/2019 12:00:00 AM,124,262,239
Central,King and Queen County,51097,74,372,446,96,874,970,12113,112156,124269,06/01/2017 12:00:00 AM,164,301,279
Central,King and Queen County,51097,74,378,452,93,810,903,9961,99861,109822,04/01/2019 12:00:00 AM,135,264,243
Central,King and Queen County,51097,74,383,457,100,831,931,11222,105720,116942,04/01/2018 12:00:00 AM,152,276,256
Central,King and Queen County,51097,74,394,468,98,886,984,10490,115524,126014,12/01/2017 12:00:00 AM,142,293,269
Central,King and Queen County,51097,74,424,498,100,873,973,19567,163007,182574,11/01/2020 12:00:00 AM,264,384,367
Central,King and Queen County,51097,74,429,503,99,882,981,21793,181034,202827,01/01/2021 12:00:00 AM,295,422,403
Central,King and Queen County,51097,74,489,563,108,1118,1226,10782,139602,150384,09/01/2012 12:00:00 AM,146,285,267
Central,King and Queen County,51097,74,507,581,108,1149,1257,10681,132851,143532,02/01/2014 12:00:00 AM,144,262,247
Central,King and Queen County,51097,74,509,583,110,1157,1267,11089,131585,142674,04/01/2014 12:00:00 AM,150,259,245
Central,King and Queen County,51097,75,365,440,100,868,968,11362,110790,122152,07/01/2017 12:00:00 AM,151,304,278
Central,King and Queen County,51097,75,389,464,96,928,1024,9445,113598,123043,02/01/2017 12:00:00 AM,126,292,265
Central,King and Queen County,51097,75,394,469,102,874,976,10814,109583,120397,01/01/2018 12:00:00 AM,144,278,257
Central,King and Queen County,51097,75,431,506,101,885,986,19235,161225,180460,12/01/2020 12:00:00 AM,256,374,357
Central,King and Queen County,51097,75,494,569,117,1130,1247,13175,142273,155448,10/01/2012 12:00:00 AM,176,288,273
Central,King and Queen County,51097,76,365,441,93,779,872,9491,94163,103654,09/01/2019 12:00:00 AM,125,258,235
Central,King and Queen County,51097,76,379,455,97,818,915,10932,101245,112177,03/01/2019 12:00:00 AM,144,267,247
Central,King and Queen County,51097,76,393,469,98,937,1035,9722,112038,121760,01/01/2017 12:00:00 AM,128,285,260
Central,King and Queen County,51097,77,485,562,106,1099,1205,11635,133427,145062,01/01/2012 12:00:00 AM,151,275,258
Central,King and Queen County,51097,77,505,582,103,1143,1246,9853,132643,142496,01/01/2014 12:00:00 AM,128,263,245
Central,King and Queen County,51097,77,508,585,117,1149,1266,12296,132153,144449,05/01/2014 12:00:00 AM,160,260,247
Central,King and Queen County,51097,78,376,454,97,803,900,10615,101754,112369,05/01/2019 12:00:00 AM,136,271,248
Central,King and Queen County,51097,78,378,456,102,803,905,10866,100983,111849,06/01/2019 12:00:00 AM,139,267,245
Central,King and Queen County,51097,78,387,465,104,911,1015,10842,110458,121300,12/01/2016 12:00:00 AM,139,285,261
Central,King and Queen County,51097,79,497,576,117,1131,1248,12463,127552,140015,06/01/2014 12:00:00 AM,158,257,243
Central,King and Queen County,51097,80,375,455,104,806,910,10851,102399,113250,07/01/2019 12:00:00 AM,136,273,249
Central,King and Queen County,51097,80,391,471,106,909,1015,11727,109540,121267,09/01/2016 12:00:00 AM,147,280,257
Central,King and Queen County,51097,80,409,489,108,927,1035,11111,111030,122141,06/01/2016 12:00:00 AM,139,271,250
Central,King and Queen County,51097,80,507,587,120,1143,1263,12528,133456,145984,12/01/2013 12:00:00 AM,157,263,249
Central,King and Queen County,51097,81,366,447,103,799,902,10340,100444,110784,08/01/2019 12:00:00 AM,128,274,248
Central,King and Queen County,51097,82,390,472,109,907,1016,11506,111508,123014,10/01/2016 12:00:00 AM,140,286,261
Central,King and Queen County,51097,82,494,576,118,1126,1244,12706,125920,138626,07/01/2014 12:00:00 AM,155,255,241
Central,King and Queen County,51097,83,376,459,110,889,999,11606,109536,121142,11/01/2016 12:00:00 AM,140,291,264
Central,King and Queen County,51097,83,411,494,108,939,1047,11324,109263,120587,05/01/2016 12:00:00 AM,136,266,244
Central,King and Queen County,51097,83,427,510,110,975,1085,11511,113552,125063,03/01/2016 12:00:00 AM,139,266,245
Central,King and Queen County,51097,83,479,562,114,1104,1218,12262,123190,135452,08/01/2014 12:00:00 AM,148,257,241
Central,King and Queen County,51097,84,388,472,110,896,1006,11482,106778,118260,08/01/2016 12:00:00 AM,137,275,251
Central,King and Queen County,51097,84,415,499,111,949,1060,11623,109607,121230,04/01/2016 12:00:00 AM,138,264,243
Central,King and Queen County,51097,84,436,520,112,998,1110,11782,112378,124160,01/01/2016 12:00:00 AM,140,258,239
Central,King and Queen County,51097,84,447,531,111,1009,1120,11811,115317,127128,02/01/2016 12:00:00 AM,141,258,239
Central,King and Queen County,51097,85,436,521,121,1019,1140,13671,120047,133718,02/01/2015 12:00:00 AM,161,275,257
Central,King and Queen County,51097,85,437,522,108,1012,1120,11420,117338,128758,05/01/2015 12:00:00 AM,134,269,247
Central,King and Queen County,51097,85,448,533,107,1037,1144,9934,122570,132504,09/01/2015 12:00:00 AM,117,274,249
Central,King and Queen County,51097,86,436,522,113,1009,1122,12343,116993,129336,04/01/2015 12:00:00 AM,144,268,248
Central,King and Queen County,51097,86,462,548,129,1066,1195,15056,127403,142459,10/01/2014 12:00:00 AM,175,276,260
Central,King and Queen County,51097,87,438,525,113,1009,1122,11987,116881,128868,12/01/2015 12:00:00 AM,138,267,245
Central,King and Queen County,51097,87,440,527,118,1030,1148,12834,117926,130760,03/01/2015 12:00:00 AM,148,268,248
Central,King and Queen County,51097,87,441,528,114,1015,1129,12547,121546,134093,07/01/2015 12:00:00 AM,144,276,254
Central,King and Queen County,51097,87,443,530,114,1023,1137,11721,121213,132934,08/01/2015 12:00:00 AM,135,274,251
Central,King and Queen County,51097,87,453,540,124,1048,1172,13357,122579,135936,01/01/2015 12:00:00 AM,154,271,252
Central,King and Queen County,51097,87,474,561,126,1092,1218,13620,122907,136527,09/01/2014 12:00:00 AM,157,259,243
Central,King and Queen County,51097,88,438,526,113,1010,1123,12376,119886,132262,06/01/2015 12:00:00 AM,141,274,251
Central,King and Queen County,51097,88,451,539,139,1030,1169,15482,123423,138905,12/01/2014 12:00:00 AM,176,274,258
Central,King and Queen County,51097,89,453,542,142,1036,1178,16039,123423,139462,11/01/2014 12:00:00 AM,180,272,257
Central,King and Queen County,51097,90,387,477,131,868,999,14169,102572,116741,07/01/2016 12:00:00 AM,157,265,245
Central,King and Queen County,51097,90,432,522,119,988,1107,12510,117173,129683,11/01/2015 12:00:00 AM,139,271,248
Central,King and Queen County,51097,90,441,531,118,1011,1129,12389,119208,131597,10/01/2015 12:00:00 AM,138,270,248
Central,Lancaster County,51103,100,576,676,138,1182,1320,30893,246391,277284,03/01/2021 12:00:00 AM,309,428,410
Central,Lancaster County,51103,100,577,677,133,1176,1309,31996,267296,299292,05/01/2021 12:00:00 AM,320,463,442
Central,Lancaster County,51103,101,569,670,140,1177,1317,31667,247037,278704,02/01/2021 12:00:00 AM,314,434,416
Central,Lancaster County,51103,103,575,678,145,1195,1340,31184,250282,281466,01/01/2021 12:00:00 AM,303,435,415
Central,Lancaster County,51103,103,582,685,151,1202,1353,29539,216868,246407,10/01/2020 12:00:00 AM,287,373,360
Central,Lancaster County,51103,104,588,692,151,1231,1382,28692,208801,237493,09/01/2020 12:00:00 AM,276,355,343
Central,Lancaster County,51103,105,574,679,152,1177,1329,29272,212795,242067,12/01/2020 12:00:00 AM,279,371,357
Central,Lancaster County,51103,106,577,683,156,1182,1338,29144,219731,248875,11/01/2020 12:00:00 AM,275,381,364
Central,Lancaster County,51103,106,589,695,155,1227,1382,27443,209427,236870,08/01/2020 12:00:00 AM,259,356,341
Central,Lancaster County,51103,107,552,659,148,1206,1354,13135,135738,148873,12/01/2019 12:00:00 AM,123,246,226
Central,Lancaster County,51103,107,585,692,152,1214,1366,27433,208626,236059,07/01/2020 12:00:00 AM,256,357,341
Central,Lancaster County,51103,108,542,650,153,1172,1325,15442,127103,142545,01/01/2020 12:00:00 AM,143,235,219
Central,Lancaster County,51103,109,542,651,150,1184,1334,13613,132299,145912,11/01/2019 12:00:00 AM,125,244,224
Central,Lancaster County,51103,109,545,654,152,1170,1322,14264,128757,143021,02/01/2020 12:00:00 AM,131,236,219
Central,Lancaster County,51103,109,560,669,159,1175,1334,28856,200868,229724,03/01/2020 12:00:00 AM,265,359,343
Central,Lancaster County,51103,109,587,696,164,1218,1382,29670,209865,239535,05/01/2020 12:00:00 AM,272,358,344
Central,Lancaster County,51103,111,582,693,165,1203,1368,29921,208687,238608,06/01/2020 12:00:00 AM,270,359,344
Central,Lancaster County,51103,111,591,702,162,1227,1389,29824,214690,244514,04/01/2020 12:00:00 AM,269,363,348
Central,Lancaster County,51103,113,536,649,155,1160,1315,14181,128507,142688,10/01/2019 12:00:00 AM,125,240,220
Central,Lancaster County,51103,116,540,656,159,1179,1338,14059,133407,147466,08/01/2019 12:00:00 AM,121,247,225
Central,Lancaster County,51103,116,550,666,161,1196,1357,13961,136202,150163,07/01/2019 12:00:00 AM,120,248,225
Central,Lancaster County,51103,117,550,667,157,1221,1378,13904,139330,153234,06/01/2019 12:00:00 AM,119,253,230
Central,Lancaster County,51103,118,539,657,165,1174,1339,14822,131694,146516,09/01/2019 12:00:00 AM,126,244,223
Central,Lancaster County,51103,119,546,665,158,1208,1366,13189,136717,149906,04/01/2019 12:00:00 AM,111,250,225
Central,Lancaster County,51103,119,557,676,159,1234,1393,13906,139227,153133,05/01/2019 12:00:00 AM,117,250,227
Central,Lancaster County,51103,122,567,689,165,1242,1407,14208,142632,156840,03/01/2019 12:00:00 AM,116,252,228
Central,Lancaster County,51103,122,576,698,168,1248,1416,15469,148452,163921,01/01/2019 12:00:00 AM,127,258,235
Central,Lancaster County,51103,124,567,691,174,1223,1397,15717,141985,157702,12/01/2018 12:00:00 AM,127,250,228
Central,Lancaster County,51103,124,568,692,168,1229,1397,15539,139992,155531,11/01/2018 12:00:00 AM,125,246,225
Central,Lancaster County,51103,127,550,677,170,1225,1395,14837,140277,155114,08/01/2018 12:00:00 AM,117,255,229
Central,Lancaster County,51103,128,548,676,177,1218,1395,15653,138094,153747,09/01/2018 12:00:00 AM,122,252,227
Central,Lancaster County,51103,129,534,663,175,1198,1373,15775,135294,151069,07/01/2018 12:00:00 AM,122,253,228
Central,Lancaster County,51103,130,557,687,192,1220,1412,17245,136986,154231,12/01/2017 12:00:00 AM,133,246,224
Central,Lancaster County,51103,131,572,703,177,1248,1425,21507,175212,196719,10/01/2018 12:00:00 AM,164,306,280
Central,Lancaster County,51103,132,532,664,180,1176,1356,16449,134480,150929,06/01/2018 12:00:00 AM,125,253,227
Central,Lancaster County,51103,133,553,686,195,1216,1411,17032,138957,155989,10/01/2017 12:00:00 AM,128,251,227
Central,Lancaster County,51103,133,561,694,199,1238,1437,19133,139496,158629,02/01/2018 12:00:00 AM,144,249,229
Central,Lancaster County,51103,134,546,680,184,1213,1397,16936,142384,159320,05/01/2018 12:00:00 AM,126,261,234
Central,Lancaster County,51103,134,559,693,197,1229,1426,18607,138555,157162,11/01/2017 12:00:00 AM,139,248,227
Central,Lancaster County,51103,134,564,698,190,1255,1445,17281,142675,159956,04/01/2018 12:00:00 AM,129,253,229
Central,Lancaster County,51103,134,567,701,193,1249,1442,18101,142444,160545,03/01/2018 12:00:00 AM,135,251,229
Central,Lancaster County,51103,135,538,673,194,1223,1417,16698,136702,153400,08/01/2016 12:00:00 AM,124,254,228
Central,Lancaster County,51103,135,542,677,189,1219,1408,16613,141025,157638,08/01/2017 12:00:00 AM,123,260,233
Central,Lancaster County,51103,136,536,672,194,1235,1429,16412,137353,153765,07/01/2016 12:00:00 AM,121,256,229
Central,Lancaster County,51103,136,537,673,185,1206,1391,16751,137888,154639,06/01/2017 12:00:00 AM,123,257,230
Central,Lancaster County,51103,136,548,684,184,1237,1421,16608,145357,161965,07/01/2017 12:00:00 AM,122,265,237
Central,Lancaster County,51103,136,557,693,192,1252,1444,17091,147834,164925,09/01/2017 12:00:00 AM,126,265,238
Central,Lancaster County,51103,137,534,671,182,1204,1386,15786,137845,153631,05/01/2017 12:00:00 AM,115,258,229
Central,Lancaster County,51103,137,555,692,206,1217,1423,17904,137308,155212,01/01/2018 12:00:00 AM,131,247,224
Central,Lancaster County,51103,138,549,687,192,1277,1469,15423,142100,157523,04/01/2016 12:00:00 AM,112,259,229
Central,Lancaster County,51103,139,533,672,200,1223,1423,17074,136763,153837,09/01/2016 12:00:00 AM,123,257,229
Central,Lancaster County,51103,139,538,677,195,1237,1432,16656,139606,156262,11/01/2016 12:00:00 AM,120,259,231
Central,Lancaster County,51103,139,546,685,194,1258,1452,15958,139226,155184,05/01/2016 12:00:00 AM,115,255,227
Central,Lancaster County,51103,140,532,672,198,1221,1419,16852,138080,154932,10/01/2016 12:00:00 AM,120,260,231
Central,Lancaster County,51103,140,533,673,199,1220,1419,16429,136114,152543,12/01/2016 12:00:00 AM,117,255,227
Central,Lancaster County,51103,140,537,677,200,1216,1416,19323,137868,157191,04/01/2017 12:00:00 AM,138,257,232
Central,Lancaster County,51103,140,547,687,193,1240,1433,15425,140957,156382,01/01/2017 12:00:00 AM,110,258,228
Central,Lancaster County,51103,141,546,687,203,1257,1460,16814,139760,156574,06/01/2016 12:00:00 AM,119,256,228
Central,Lancaster County,51103,141,549,690,200,1279,1479,17311,140716,158027,03/01/2016 12:00:00 AM,123,256,229
Central,Lancaster County,51103,142,549,691,192,1247,1439,15778,142037,157815,02/01/2017 12:00:00 AM,111,259,228
Central,Lancaster County,51103,142,674,816,197,1539,1736,14578,167445,182023,06/01/2014 12:00:00 AM,103,248,223
Central,Lancaster County,51103,144,534,678,198,1192,1390,17632,135005,152637,03/01/2017 12:00:00 AM,122,253,225
Central,Lancaster County,51103,144,558,702,204,1296,1500,17600,140578,158178,02/01/2016 12:00:00 AM,122,252,225
Central,Lancaster County,51103,144,559,703,210,1299,1509,18742,141083,159825,01/01/2016 12:00:00 AM,130,252,227
Central,Lancaster County,51103,144,589,733,199,1382,1581,15121,156193,171314,02/01/2015 12:00:00 AM,105,265,234
Central,Lancaster County,51103,145,594,739,200,1372,1572,16445,151644,168089,11/01/2014 12:00:00 AM,113,255,227
Central,Lancaster County,51103,145,608,753,214,1381,1595,18042,146437,164479,09/01/2014 12:00:00 AM,124,241,218
Central,Lancaster County,51103,145,623,768,210,1400,1610,17312,150350,167662,08/01/2014 12:00:00 AM,119,241,218
Central,Lancaster County,51103,146,560,706,208,1306,1514,17590,139546,157136,12/01/2015 12:00:00 AM,120,249,223
Central,Lancaster County,51103,146,583,729,208,1361,1569,17942,150305,168247,07/01/2015 12:00:00 AM,123,258,231
Central,Lancaster County,51103,146,584,730,203,1395,1598,17182,156371,173553,05/01/2015 12:00:00 AM,118,268,238
Central,Lancaster County,51103,146,591,737,203,1405,1608,15955,156720,172675,04/01/2015 12:00:00 AM,109,265,234
Central,Lancaster County,51103,146,646,792,212,1465,1677,16598,155763,172361,07/01/2014 12:00:00 AM,114,241,218
Central,Lancaster County,51103,146,720,866,216,1630,1846,20628,194683,215311,12/01/2012 12:00:00 AM,141,270,249
Central,Lancaster County,51103,147,555,702,210,1278,1488,17499,137106,154605,11/01/2015 12:00:00 AM,119,247,220
Central,Lancaster County,51103,147,581,728,206,1376,1582,16302,154082,170384,03/01/2015 12:00:00 AM,111,265,234
Central,Lancaster County,51103,147,593,740,208,1405,1613,18094,156916,175010,06/01/2015 12:00:00 AM,123,265,237
Central,Lancaster County,51103,147,708,855,218,1624,1842,20841,192617,213458,11/01/2012 12:00:00 AM,142,272,250
Central,Lancaster County,51103,147,709,856,218,1580,1798,20164,184613,204777,07/01/2013 12:00:00 AM,137,260,239
Central,Lancaster County,51103,147,732,879,216,1621,1837,19290,193541,212831,05/01/2013 12:00:00 AM,131,264,242
Central,Lancaster County,51103,148,587,735,207,1357,1564,17735,150012,167747,10/01/2014 12:00:00 AM,120,256,228
Central,Lancaster County,51103,148,689,837,222,1583,1805,22083,190169,212252,10/01/2012 12:00:00 AM,149,276,254
Central,Lancaster County,51103,148,737,885,221,1636,1857,19986,193437,213423,04/01/2013 12:00:00 AM,135,262,241
Central,Lancaster County,51103,149,587,736,212,1361,1573,17442,151098,168540,01/01/2015 12:00:00 AM,117,257,229
Central,Lancaster County,51103,149,679,828,210,1534,1744,14688,169508,184196,05/01/2014 12:00:00 AM,99,250,222
Central,Lancaster County,51103,149,701,850,239,1561,1800,24361,195179,219540,02/01/2012 12:00:00 AM,163,278,258
Central,Lancaster County,51103,149,702,851,212,1559,1771,15412,170923,186335,04/01/2014 12:00:00 AM,103,243,219
Central,Lancaster County,51103,150,557,707,217,1271,1488,17544,139765,157309,10/01/2015 12:00:00 AM,117,251,223
Central,Lancaster County,51103,150,703,853,215,1566,1781,16174,173713,189887,03/01/2014 12:00:00 AM,108,247,223
Central,Lancaster County,51103,150,728,878,217,1627,1844,19495,193230,212725,06/01/2013 12:00:00 AM,130,265,242
Central,Lancaster County,51103,151,569,720,223,1325,1548,18574,145671,164245,08/01/2015 12:00:00 AM,123,256,228
Central,Lancaster County,51103,151,699,850,245,1562,1807,25573,192908,218481,01/01/2012 12:00:00 AM,169,276,257
Central,Lancaster County,51103,151,700,851,214,1590,1804,18272,185148,203420,08/01/2013 12:00:00 AM,121,264,239
Central,Lancaster County,51103,151,713,864,217,1588,1805,16499,174429,190928,02/01/2014 12:00:00 AM,109,245,221
Central,Lancaster County,51103,151,735,886,225,1635,1860,21677,197520,219197,02/01/2013 12:00:00 AM,144,269,247
Central,Lancaster County,51103,152,562,714,224,1290,1514,18791,139208,157999,09/01/2015 12:00:00 AM,124,248,221
Central,Lancaster County,51103,152,583,735,219,1349,1568,18799,149438,168237,12/01/2014 12:00:00 AM,124,256,229
Central,Lancaster County,51103,152,692,844,238,1531,1769,23760,193654,217414,06/01/2012 12:00:00 AM,156,280,258
Central,Lancaster County,51103,152,697,849,219,1551,1770,18434,182421,200855,10/01/2013 12:00:00 AM,121,262,237
Central,Lancaster County,51103,152,705,857,240,1575,1815,24304,196674,220978,03/01/2012 12:00:00 AM,160,279,258
Central,Lancaster County,51103,152,706,858,236,1581,1817,23743,200208,223951,04/01/2012 12:00:00 AM,156,284,261
Central,Lancaster County,51103,152,732,884,226,1644,1870,21006,195844,216850,01/01/2013 12:00:00 AM,138,268,245
Central,Lancaster County,51103,153,702,855,223,1579,1802,20318,184289,204607,09/01/2013 12:00:00 AM,133,263,239
Central,Lancaster County,51103,153,703,856,240,1562,1802,24176,196682,220858,05/01/2012 12:00:00 AM,158,280,258
Central,Lancaster County,51103,154,678,832,242,1539,1781,24275,187428,211703,09/01/2012 12:00:00 AM,158,276,254
Central,Lancaster County,51103,154,691,845,236,1556,1792,22936,195691,218627,07/01/2012 12:00:00 AM,149,283,259
Central,Lancaster County,51103,154,693,847,233,1574,1807,22636,193707,216343,08/01/2012 12:00:00 AM,147,280,255
Central,Lancaster County,51103,154,738,892,238,1634,1872,22775,195663,218438,03/01/2013 12:00:00 AM,148,265,245
Central,Lancaster County,51103,155,696,851,224,1537,1761,17749,164686,182435,11/01/2013 12:00:00 AM,115,237,214
Central,Lancaster County,51103,157,702,859,231,1573,1804,17765,169275,187040,01/01/2014 12:00:00 AM,113,241,218
Central,Lancaster County,51103,160,704,864,233,1572,1805,18739,170880,189619,12/01/2013 12:00:00 AM,117,243,219
Central,Lancaster County,51103,99,565,664,131,1144,1275,29955,257904,287859,06/01/2021 12:00:00 AM,303,456,434
Central,Lancaster County,51103,99,581,680,132,1186,1318,31227,265361,296588,04/01/2021 12:00:00 AM,315,457,436
Central,Lunenburg County,51111,186,904,1090,232,1809,2041,18968,204915,223883,04/01/2016 12:00:00 AM,102,227,205
Central,Lunenburg County,51111,187,849,1036,234,1716,1950,22005,202295,224300,05/01/2017 12:00:00 AM,118,238,217
Central,Lunenburg County,51111,188,1021,1209,256,2116,2372,22908,239627,262535,02/01/2015 12:00:00 AM,122,235,217
Central,Lunenburg County,51111,188,1027,1215,250,2144,2394,22246,241929,264175,03/01/2015 12:00:00 AM,118,236,217
Central,Lunenburg County,51111,188,878,1066,236,1774,2010,22055,206780,228835,03/01/2017 12:00:00 AM,117,236,215
Central,Lunenburg County,51111,188,904,1092,242,1796,2038,20642,208647,229289,06/01/2016 12:00:00 AM,110,231,210
Central,Lunenburg County,51111,189,847,1036,240,1723,1963,24086,208253,232339,08/01/2017 12:00:00 AM,127,246,224
Central,Lunenburg County,51111,189,919,1108,244,1830,2074,21375,206157,227532,03/01/2016 12:00:00 AM,113,224,205
Central,Lunenburg County,51111,190,850,1040,247,1742,1989,24759,210320,235079,09/01/2017 12:00:00 AM,130,247,226
Central,Lunenburg County,51111,190,873,1063,237,1767,2004,22436,209958,232394,04/01/2017 12:00:00 AM,118,241,219
Central,Lunenburg County,51111,190,906,1096,245,1811,2056,20914,208213,229127,05/01/2016 12:00:00 AM,110,230,209
Central,Lunenburg County,51111,191,1003,1194,257,2085,2342,22524,240939,263463,05/01/2015 12:00:00 AM,118,240,221
Central,Lunenburg County,51111,191,794,985,254,1593,1847,25143,191274,216417,10/01/2019 12:00:00 AM,132,241,220
Central,Lunenburg County,51111,191,847,1038,237,1730,1967,22480,204707,227187,06/01/2017 12:00:00 AM,118,242,219
Central,Lunenburg County,51111,192,1005,1197,258,2071,2329,22473,233984,256457,06/01/2015 12:00:00 AM,117,233,214
Central,Lunenburg County,51111,192,1011,1203,256,2110,2366,21794,244566,266360,04/01/2015 12:00:00 AM,114,242,221
Central,Lunenburg County,51111,192,799,991,244,1640,1884,23531,199270,222801,02/01/2018 12:00:00 AM,123,249,225
Central,Lunenburg County,51111,192,917,1109,249,1827,2076,21481,213138,234619,07/01/2016 12:00:00 AM,112,232,212
Central,Lunenburg County,51111,193,776,969,244,1560,1804,24468,189687,214155,01/01/2018 12:00:00 AM,127,244,221
Central,Lunenburg County,51111,193,880,1073,241,1782,2023,21744,205383,227127,02/01/2017 12:00:00 AM,113,233,212
Central,Lunenburg County,51111,193,927,1120,249,1843,2092,23060,215524,238584,08/01/2016 12:00:00 AM,119,232,213
Central,Lunenburg County,51111,193,939,1132,245,1869,2114,20906,210179,231085,02/01/2016 12:00:00 AM,108,224,204
Central,Lunenburg County,51111,193,990,1183,254,2036,2290,21647,230473,252120,07/01/2015 12:00:00 AM,112,233,213
Central,Lunenburg County,51111,194,845,1039,245,1737,1982,23480,206142,229622,07/01/2017 12:00:00 AM,121,244,221
Central,Lunenburg County,51111,195,964,1159,260,1937,2197,23268,218730,241998,11/01/2015 12:00:00 AM,119,227,209
Central,Lunenburg County,51111,196,1034,1230,275,2133,2408,25098,240531,265629,01/01/2015 12:00:00 AM,128,233,216
Central,Lunenburg County,51111,196,840,1036,257,1723,1980,27481,218158,245639,12/01/2017 12:00:00 AM,140,260,237
Central,Lunenburg County,51111,196,953,1149,265,1902,2167,23453,211219,234672,01/01/2016 12:00:00 AM,120,222,204
Central,Lunenburg County,51111,197,886,1083,246,1792,2038,22474,205415,227889,01/01/2017 12:00:00 AM,114,232,210
Central,Lunenburg County,51111,197,988,1185,262,2034,2296,23220,227975,251195,08/01/2015 12:00:00 AM,118,231,212
Central,Lunenburg County,51111,198,1044,1242,284,2118,2402,26718,243627,270345,12/01/2014 12:00:00 AM,135,233,218
Central,Lunenburg County,51111,198,1047,1245,280,2118,2398,25501,244126,269627,11/01/2014 12:00:00 AM,129,233,217
Central,Lunenburg County,51111,198,849,1047,261,1713,1974,25983,204949,230932,10/01/2017 12:00:00 AM,131,241,221
Central,Lunenburg County,51111,198,967,1165,271,1968,2239,24500,219028,243528,10/01/2015 12:00:00 AM,124,227,209
Central,Lunenburg County,51111,198,979,1177,270,2016,2286,23866,223058,246924,09/01/2015 12:00:00 AM,121,228,210
Central,Lunenburg County,51111,199,786,985,262,1644,1906,26151,194924,221075,06/01/2019 12:00:00 AM,131,248,224
Central,Lunenburg County,51111,200,769,969,252,1509,1761,25182,181448,206630,07/01/2018 12:00:00 AM,126,236,213
Central,Lunenburg County,51111,200,786,986,268,1584,1852,27037,183404,210441,09/01/2019 12:00:00 AM,135,233,213
Central,Lunenburg County,51111,200,800,1000,266,1658,1924,26052,195589,221641,11/01/2019 12:00:00 AM,130,244,222
Central,Lunenburg County,51111,200,864,1064,264,1732,1996,27243,210102,237345,11/01/2017 12:00:00 AM,136,243,223
Central,Lunenburg County,51111,200,892,1092,256,1784,2040,24385,203854,228239,11/01/2016 12:00:00 AM,122,229,209
Central,Lunenburg County,51111,201,772,973,272,1590,1862,26680,185292,211972,07/01/2019 12:00:00 AM,133,240,218
Central,Lunenburg County,51111,201,794,995,261,1598,1859,26565,200575,227140,03/01/2018 12:00:00 AM,132,253,228
Central,Lunenburg County,51111,201,962,1163,274,1923,2197,24629,212136,236765,12/01/2015 12:00:00 AM,123,221,204
Central,Lunenburg County,51111,202,1040,1242,286,2105,2391,25183,243392,268575,09/01/2014 12:00:00 AM,125,234,216
Central,Lunenburg County,51111,202,1041,1243,307,2105,2412,30037,251153,281190,08/01/2012 12:00:00 AM,149,241,226
Central,Lunenburg County,51111,202,793,995,266,1665,1931,26512,196556,223068,04/01/2019 12:00:00 AM,131,248,224
Central,Lunenburg County,51111,202,799,1001,267,1665,1932,27646,196759,224405,05/01/2019 12:00:00 AM,137,246,224
Central,Lunenburg County,51111,202,885,1087,257,1783,2040,24407,202366,226773,12/01/2016 12:00:00 AM,121,229,209
Central,Lunenburg County,51111,203,1022,1225,310,2080,2390,30331,247936,278267,07/01/2012 12:00:00 AM,149,243,227
Central,Lunenburg County,51111,203,778,981,274,1619,1893,26872,191412,218284,08/01/2019 12:00:00 AM,132,246,223
Central,Lunenburg County,51111,203,785,988,260,1618,1878,26148,196772,222920,02/01/2019 12:00:00 AM,129,251,226
Central,Lunenburg County,51111,203,880,1083,270,1761,2031,26617,201906,228523,10/01/2016 12:00:00 AM,131,229,211
Central,Lunenburg County,51111,203,905,1108,268,1795,2063,26164,207189,233353,09/01/2016 12:00:00 AM,129,229,211
Central,Lunenburg County,51111,204,807,1011,275,1666,1941,27234,198163,225397,12/01/2019 12:00:00 AM,134,246,223
Central,Lunenburg County,51111,205,1031,1236,294,2087,2381,27772,242329,270101,10/01/2014 12:00:00 AM,135,235,219
Central,Lunenburg County,51111,205,1046,1251,284,2131,2415,24194,234050,258244,06/01/2014 12:00:00 AM,118,224,206
Central,Lunenburg County,51111,205,785,990,258,1646,1904,25981,199450,225431,12/01/2018 12:00:00 AM,127,254,228
Central,Lunenburg County,51111,205,785,990,274,1649,1923,49748,283418,333166,03/01/2020 12:00:00 AM,243,361,337
Central,Lunenburg County,51111,206,1050,1256,311,2135,2446,30081,254527,284608,09/01/2012 12:00:00 AM,146,242,227
Central,Lunenburg County,51111,206,772,978,272,1624,1896,26949,185950,212899,02/01/2020 12:00:00 AM,131,241,218
Central,Lunenburg County,51111,206,787,993,270,1572,1842,27067,188502,215569,04/01/2018 12:00:00 AM,131,240,217
Central,Lunenburg County,51111,206,793,999,269,1662,1931,26339,194274,220613,01/01/2020 12:00:00 AM,128,245,221
Central,Lunenburg County,51111,206,800,1006,268,1600,1868,26618,189347,215965,05/01/2018 12:00:00 AM,129,237,215
Central,Lunenburg County,51111,206,805,1011,261,1691,1952,26659,208097,234756,01/01/2019 12:00:00 AM,129,259,232
Central,Lunenburg County,51111,206,805,1011,266,1679,1945,26945,201297,228242,03/01/2019 12:00:00 AM,131,250,226
Central,Lunenburg County,51111,206,861,1067,267,1818,2085,62429,411117,473546,04/01/2021 12:00:00 AM,303,477,444
Central,Lunenburg County,51111,207,1029,1236,292,2105,2397,25675,233171,258846,08/01/2014 12:00:00 AM,124,227,209
Central,Lunenburg County,51111,207,1036,1243,299,2119,2418,26059,231458,257517,05/01/2014 12:00:00 AM,126,223,207
Central,Lunenburg County,51111,207,792,999,271,1579,1850,28354,199246,227600,06/01/2018 12:00:00 AM,137,252,228
Central,Lunenburg County,51111,207,795,1002,257,1629,1886,24778,197537,222315,09/01/2018 12:00:00 AM,120,248,222
Central,Lunenburg County,51111,207,846,1053,275,1782,2057,64096,405459,469555,05/01/2021 12:00:00 AM,310,479,446
Central,Lunenburg County,51111,207,870,1077,270,1839,2109,67953,427524.33,495477.33,02/01/2021 12:00:00 AM,328,491,460
Central,Lunenburg County,51111,207,871,1078,270,1835,2105,60722,391200.84,451922.84,03/01/2021 12:00:00 AM,293,449,419
Central,Lunenburg County,51111,208,1014,1222,290,2068,2358,25813,230694,256507,07/01/2014 12:00:00 AM,124,228,210
Central,Lunenburg County,51111,208,798,1006,261,1622,1883,25621,196004,221625,08/01/2018 12:00:00 AM,123,246,220
Central,Lunenburg County,51111,208,850,1058,283,1797,2080,65273,402725,467998,06/01/2021 12:00:00 AM,314,474,442
Central,Lunenburg County,51111,209,1029,1238,326,2105,2431,32505,248848,281353,06/01/2012 12:00:00 AM,156,242,227
Central,Lunenburg County,51111,209,809,1018,281,1700,1981,52482,291007,343489,04/01/2020 12:00:00 AM,251,360,337
Central,Lunenburg County,51111,210,1039,1249,336,2133,2469,35139,250882,286021,03/01/2012 12:00:00 AM,167,241,229
Central,Lunenburg County,51111,210,1049,1259,323,2140,2463,31677,254804,286481,10/01/2012 12:00:00 AM,151,243,228
Central,Lunenburg County,51111,211,1067,1278,311,2172,2483,29996,259095,289091,12/01/2012 12:00:00 AM,142,243,226
Central,Lunenburg County,51111,211,792,1003,263,1650,1913,26566,199000,225566,11/01/2018 12:00:00 AM,126,251,225
Central,Lunenburg County,51111,211,827,1038,283,1724,2007,51593,296556,348149,05/01/2020 12:00:00 AM,245,359,335
Central,Lunenburg County,51111,211,862,1073,285,1824,2109,62093,385142,447235,01/01/2021 12:00:00 AM,294,447,417
Central,Lunenburg County,51111,211,870,1081,286,1825,2111,55569,330187,385756,12/01/2020 12:00:00 AM,263,380,357
Central,Lunenburg County,51111,212,1036,1248,335,2127,2462,33014,249343,282357,05/01/2012 12:00:00 AM,156,241,226
Central,Lunenburg County,51111,212,866,1078,289,1830,2119,56209,335915,392124,11/01/2020 12:00:00 AM,265,388,364
Central,Lunenburg County,51111,213,1060,1273,321,2158,2479,30293,256893,287186,11/01/2012 12:00:00 AM,142,242,226
Central,Lunenburg County,51111,213,850,1063,285,1783,2068,52280,308482,360762,06/01/2020 12:00:00 AM,245,363,339
Central,Lunenburg County,51111,214,1080,1294,311,2177,2488,28142,239841,267983,01/01/2014 12:00:00 AM,132,222,207
Central,Lunenburg County,51111,214,874,1088,284,1853,2137,52366,317710,370076,09/01/2020 12:00:00 AM,245,364,340
Central,Lunenburg County,51111,215,865,1080,288,1806,2094,55879,333097,388976,10/01/2020 12:00:00 AM,260,385,360
Central,Lunenburg County,51111,216,1077,1293,319,2175,2494,28800,242353,271153,02/01/2014 12:00:00 AM,133,225,210
Central,Lunenburg County,51111,217,1035,1252,358,2116,2474,37327,247872,285199,04/01/2012 12:00:00 AM,172,239,228
Central,Lunenburg County,51111,217,1044,1261,323,2135,2458,31459,253236,284695,01/01/2013 12:00:00 AM,145,243,226
Central,Lunenburg County,51111,217,1045,1262,321,2106,2427,29578,233845,263423,04/01/2014 12:00:00 AM,136,224,209
Central,Lunenburg County,51111,217,1048,1265,340,2133,2473,33585,251700,285285,01/01/2012 12:00:00 AM,155,240,226
Central,Lunenburg County,51111,217,805,1022,272,1666,1938,30448,221987.55,252435.55,10/01/2018 12:00:00 AM,140,276,247
Central,Lunenburg County,51111,218,1039,1257,354,2120,2474,36581,251064,287645,02/01/2012 12:00:00 AM,168,242,229
Central,Lunenburg County,51111,218,1072,1290,315,2159,2474,28629,238646,267275,12/01/2013 12:00:00 AM,131,223,207
Central,Lunenburg County,51111,218,863,1081,286,1800,2086,52902,311838,364740,07/01/2020 12:00:00 AM,243,361,337
Central,Lunenburg County,51111,219,867,1086,289,1828,2117,53336,312794,366130,08/01/2020 12:00:00 AM,244,361,337
Central,Lunenburg County,51111,222,1082,1304,330,2184,2514,30433,242131,272564,03/01/2014 12:00:00 AM,137,224,209
Central,Lunenburg County,51111,222,1084,1306,320,2192,2512,29347,242412,271759,11/01/2013 12:00:00 AM,132,224,208
Central,Lunenburg County,51111,223,1035,1258,336,2104,2440,33392,248716,282108,02/01/2013 12:00:00 AM,150,240,224
Central,Lunenburg County,51111,227,1051,1278,338,2117,2455,34224,253847,288071,05/01/2013 12:00:00 AM,151,242,225
Central,Lunenburg County,51111,228,1035,1263,342,2097,2439,34152,251596,285748,04/01/2013 12:00:00 AM,150,243,226
Central,Lunenburg County,51111,228,1096,1324,338,2205,2543,34577,261688,296265,10/01/2013 12:00:00 AM,152,239,224
Central,Lunenburg County,51111,229,1041,1270,339,2121,2460,34967,254376,289343,03/01/2013 12:00:00 AM,153,244,228
Central,Lunenburg County,51111,238,1077,1315,365,2177,2542,38214,256816,295030,07/01/2013 12:00:00 AM,161,238,224
Central,Lunenburg County,51111,239,1073,1312,366,2156,2522,39121,255955,295076,06/01/2013 12:00:00 AM,164,239,225
Central,Lunenburg County,51111,239,1076,1315,357,2182,2539,36216,255694,291910,08/01/2013 12:00:00 AM,152,238,222
Central,Lunenburg County,51111,239,1080,1319,358,2175,2533,36530,258623,295153,09/01/2013 12:00:00 AM,153,239,224
Central,Middlesex County,51119,100,559,659,157,1224,1381,17972,152000,169972,01/01/2018 12:00:00 AM,180,272,258
Central,Middlesex County,51119,100,562,662,164,1226,1390,18570,150218,168788,11/01/2017 12:00:00 AM,186,267,255
Central,Middlesex County,51119,100,591,691,145,1240,1385,16659,153295,169954,06/01/2019 12:00:00 AM,167,259,246
Central,Middlesex County,51119,100,600,700,166,1293,1459,17964,158282,176246,11/01/2016 12:00:00 AM,180,264,252
Central,Middlesex County,51119,100,605,705,170,1315,1485,19664,158268,177932,05/01/2015 12:00:00 AM,197,262,252
Central,Middlesex County,51119,100,614,714,175,1369,1544,18960,161004,179964,09/01/2016 12:00:00 AM,190,262,252
Central,Middlesex County,51119,101,549,650,153,1182,1335,16573,147738,164311,03/01/2018 12:00:00 AM,164,269,253
Central,Middlesex County,51119,101,556,657,167,1206,1373,18506,152888,171394,07/01/2017 12:00:00 AM,183,275,261
Central,Middlesex County,51119,101,559,660,156,1209,1365,17942,150715,168657,02/01/2018 12:00:00 AM,178,270,256
Central,Middlesex County,51119,101,559,660,159,1239,1398,19125,153367,172492,12/01/2017 12:00:00 AM,189,274,261
Central,Middlesex County,51119,101,561,662,164,1209,1373,18128,151406,169534,10/01/2017 12:00:00 AM,179,270,256
Central,Middlesex County,51119,101,593,694,140,1238,1378,15266,146071,161337,11/01/2019 12:00:00 AM,151,246,232
Central,Middlesex County,51119,101,598,699,168,1304,1472,17962,159638,177600,12/01/2016 12:00:00 AM,178,267,254
Central,Middlesex County,51119,101,612,713,168,1344,1512,17036,160242,177278,03/01/2016 12:00:00 AM,169,262,249
Central,Middlesex County,51119,102,574,676,144,1224,1368,16070,146378,162448,08/01/2019 12:00:00 AM,158,255,240
Central,Middlesex County,51119,102,590,692,152,1263,1415,16125,156890,173015,04/01/2017 12:00:00 AM,158,266,250
Central,Middlesex County,51119,102,602,704,141,1255,1396,15575,149991,165566,12/01/2019 12:00:00 AM,153,249,235
Central,Middlesex County,51119,102,607,709,171,1361,1532,17422,161367,178789,07/01/2016 12:00:00 AM,171,266,252
Central,Middlesex County,51119,102,610,712,164,1305,1469,17314,163110,180424,01/01/2017 12:00:00 AM,170,267,253
Central,Middlesex County,51119,103,561,664,165,1212,1377,19098,156186,175284,08/01/2017 12:00:00 AM,185,278,264
Central,Middlesex County,51119,103,569,672,155,1229,1384,15380,155503,170883,05/01/2017 12:00:00 AM,149,273,254
Central,Middlesex County,51119,103,571,674,148,1191,1339,16458,140804,157262,10/01/2019 12:00:00 AM,160,247,233
Central,Middlesex County,51119,103,598,701,180,1302,1482,21588,155761,177349,04/01/2015 12:00:00 AM,210,260,253
Central,Middlesex County,51119,103,610,713,167,1350,1517,17077,163640,180717,10/01/2016 12:00:00 AM,166,268,253
Central,Middlesex County,51119,103,645,748,145,1326,1471,26702,229469,256171,04/01/2020 12:00:00 AM,259,356,342
Central,Middlesex County,51119,104,558,662,170,1230,1400,20274,157909,178183,09/01/2017 12:00:00 AM,195,283,269
Central,Middlesex County,51119,105,602,707,179,1327,1506,20705,158145,178850,03/01/2015 12:00:00 AM,197,263,253
Central,Middlesex County,51119,106,582,688,160,1229,1389,16815,147628,164443,09/01/2019 12:00:00 AM,159,254,239
Central,Middlesex County,51119,106,607,713,189,1314,1503,20424,157335,177759,04/01/2016 12:00:00 AM,193,259,249
Central,Middlesex County,51119,106,636,742,147,1293,1440,32008,271353,303361,02/01/2021 12:00:00 AM,302,427,409
Central,Middlesex County,51119,107,634,741,152,1294,1446,32908,271335,304243,03/01/2021 12:00:00 AM,308,428,411
Central,Middlesex County,51119,107,651,758,159,1340,1499,29267,230472,259739,06/01/2020 12:00:00 AM,274,354,343
Central,Middlesex County,51119,108,649,757,160,1336,1496,28192,228363,256555,05/01/2020 12:00:00 AM,261,352,339
Central,Middlesex County,51119,109,608,717,191,1341,1532,19425,160710,180135,06/01/2016 12:00:00 AM,178,264,251
Central,Middlesex County,51119,109,624,733,161,1272,1433,29993,231430,261423,12/01/2020 12:00:00 AM,275,371,357
Central,Middlesex County,51119,109,643,752,160,1320,1480,28907,223183,252090,08/01/2020 12:00:00 AM,265,347,335
Central,Middlesex County,51119,109,646,755,166,1328,1494,29364,230137,259501,07/01/2020 12:00:00 AM,269,356,344
Central,Middlesex County,51119,110,605,715,196,1321,1517,20415,158023,178438,05/01/2016 12:00:00 AM,186,261,250
Central,Middlesex County,51119,110,620,730,164,1266,1430,35244,268338,303582,01/01/2021 12:00:00 AM,320,433,416
Central,Middlesex County,51119,110,655,765,183,1456,1639,19132,173720,192852,08/01/2014 12:00:00 AM,174,265,252
Central,Middlesex County,51119,111,613,724,164,1253,1417,37757,286178,323935,06/01/2021 12:00:00 AM,340,467,447
Central,Middlesex County,51119,112,614,726,191,1352,1543,21807,159099,180906,01/01/2015 12:00:00 AM,195,259,249
Central,Middlesex County,51119,112,617,729,169,1275,1444,33075,235031,268106,11/01/2020 12:00:00 AM,295,381,368
Central,Middlesex County,51119,112,620,732,165,1269,1434,38939,285367,324306,04/01/2021 12:00:00 AM,348,460,443
Central,Middlesex County,51119,112,626,738,167,1292,1459,31126,231166,262292,10/01/2020 12:00:00 AM,278,369,355
Central,Middlesex County,51119,112,628,740,182,1374,1556,20931,161088,182019,12/01/2014 12:00:00 AM,187,257,246
Central,Middlesex County,51119,112,655,767,186,1456,1642,19314,172773,192087,09/01/2014 12:00:00 AM,172,264,250
Central,Middlesex County,51119,113,599,712,196,1322,1518,22684,159333,182017,02/01/2015 12:00:00 AM,201,266,256
Central,Middlesex County,51119,113,629,742,168,1298,1466,30321,227436,257757,09/01/2020 12:00:00 AM,268,362,347
Central,Middlesex County,51119,113,666,779,176,1476,1652,17669,176350,194019,07/01/2014 12:00:00 AM,156,265,249
Central,Middlesex County,51119,114,612,726,167,1256,1423,38843,287694,326537,05/01/2021 12:00:00 AM,341,470,450
Central,Middlesex County,51119,114,638,752,195,1390,1585,21858,167539,189397,11/01/2014 12:00:00 AM,192,263,252
Central,Middlesex County,51119,114,649,763,195,1430,1625,21791,174721,196512,10/01/2014 12:00:00 AM,191,269,258
Central,Middlesex County,51119,118,661,779,199,1444,1643,21624,173798,195422,06/01/2014 12:00:00 AM,183,263,251
Central,Middlesex County,51119,118,676,794,181,1441,1622,20458,188137,208595,06/01/2012 12:00:00 AM,173,278,263
Central,Middlesex County,51119,119,664,783,188,1408,1596,21885,183194,205079,05/01/2012 12:00:00 AM,184,276,262
Central,Middlesex County,51119,122,671,793,204,1450,1654,23286,173977,197263,05/01/2014 12:00:00 AM,191,259,249
Central,Middlesex County,51119,123,654,777,195,1386,1581,22115,180580,202695,04/01/2012 12:00:00 AM,180,276,261
Central,Middlesex County,51119,125,635,760,207,1365,1572,23537,172589,196126,01/01/2012 12:00:00 AM,188,272,258
Central,Middlesex County,51119,125,701,826,221,1462,1683,27321,192672,219993,04/01/2013 12:00:00 AM,219,275,266
Central,Middlesex County,51119,126,677,803,206,1427,1633,25112,186216,211328,07/01/2012 12:00:00 AM,199,275,263
Central,Middlesex County,51119,127,694,821,214,1487,1701,23405,178981,202386,03/01/2014 12:00:00 AM,184,258,247
Central,Middlesex County,51119,128,649,777,204,1388,1592,23760,181597,205357,02/01/2012 12:00:00 AM,186,280,264
Central,Middlesex County,51119,128,674,802,223,1451,1674,24722,175024,199746,04/01/2014 12:00:00 AM,193,260,249
Central,Middlesex County,51119,130,687,817,216,1453,1669,26848,190816,217664,08/01/2012 12:00:00 AM,207,278,266
Central,Middlesex County,51119,130,692,822,215,1492,1707,23329,180160,203489,02/01/2014 12:00:00 AM,179,260,248
Central,Middlesex County,51119,130,696,826,227,1469,1696,27876,192251,220127,03/01/2013 12:00:00 AM,214,276,266
Central,Middlesex County,51119,131,649,780,216,1385,1601,25872,181683,207555,03/01/2012 12:00:00 AM,197,280,266
Central,Middlesex County,51119,134,675,809,228,1411,1639,28379,186205,214584,09/01/2012 12:00:00 AM,212,276,265
Central,Middlesex County,51119,135,684,819,227,1442,1669,28929,192592,221521,10/01/2012 12:00:00 AM,214,282,270
Central,Middlesex County,51119,135,684,819,238,1441,1679,28184,172112,200296,12/01/2013 12:00:00 AM,209,252,245
Central,Middlesex County,51119,135,691,826,237,1449,1686,30875,190343,221218,05/01/2013 12:00:00 AM,229,275,268
Central,Middlesex County,51119,136,691,827,230,1462,1692,29547,191344,220891,12/01/2012 12:00:00 AM,217,277,267
Central,Middlesex County,51119,136,691,827,234,1469,1703,27028,176623,203651,01/01/2014 12:00:00 AM,199,256,246
Central,Middlesex County,51119,136,696,832,234,1461,1695,27588,174389,201977,11/01/2013 12:00:00 AM,203,251,243
Central,Middlesex County,51119,137,693,830,240,1463,1703,30661,194096,224757,02/01/2013 12:00:00 AM,224,280,271
Central,Middlesex County,51119,138,690,828,253,1457,1710,32977,189984,222961,07/01/2013 12:00:00 AM,239,275,269
Central,Middlesex County,51119,138,692,830,239,1463,1702,30621,188648,219269,01/01/2013 12:00:00 AM,222,273,264
Central,Middlesex County,51119,140,690,830,258,1447,1705,33831,189256,223087,06/01/2013 12:00:00 AM,242,274,269
Central,Middlesex County,51119,141,683,824,253,1433,1686,31818,188027,219845,09/01/2013 12:00:00 AM,226,275,267
Central,Middlesex County,51119,141,684,825,258,1437,1695,32623,187668,220291,08/01/2013 12:00:00 AM,231,274,267
Central,Middlesex County,51119,142,683,825,247,1437,1684,31265,189915,221180,11/01/2012 12:00:00 AM,220,278,268
Central,Middlesex County,51119,145,678,823,265,1425,1690,33369,186269,219638,10/01/2013 12:00:00 AM,230,275,267
Central,Middlesex County,51119,87,574,661,122,1215,1337,13242,148082,161324,02/01/2019 12:00:00 AM,152,258,244
Central,Middlesex County,51119,89,577,666,131,1221,1352,14496,151334,165830,01/01/2019 12:00:00 AM,163,262,249
Central,Middlesex County,51119,90,585,675,137,1236,1373,14287,152461,166748,03/01/2019 12:00:00 AM,159,261,247
Central,Middlesex County,51119,90,614,704,148,1338,1486,15044,161691,176735,09/01/2015 12:00:00 AM,167,263,251
Central,Middlesex County,51119,90,621,711,147,1352,1499,14702,162745,177447,08/01/2015 12:00:00 AM,163,262,250
Central,Middlesex County,51119,92,571,663,133,1227,1360,14608,150823,165431,12/01/2018 12:00:00 AM,159,264,250
Central,Middlesex County,51119,93,587,680,137,1212,1349,15062,151051,166113,04/01/2019 12:00:00 AM,162,257,244
Central,Middlesex County,51119,93,628,721,162,1373,1535,18390,161417,179807,11/01/2015 12:00:00 AM,198,257,249
Central,Middlesex County,51119,94,546,640,136,1178,1314,13696,144026,157722,06/01/2018 12:00:00 AM,146,264,246
Central,Middlesex County,51119,94,563,657,132,1214,1346,13944,152753,166697,08/01/2018 12:00:00 AM,148,271,254
Central,Middlesex County,51119,94,617,711,163,1341,1504,17939,159258,177197,10/01/2015 12:00:00 AM,191,258,249
Central,Middlesex County,51119,95,551,646,131,1182,1313,13853,145748,159601,07/01/2018 12:00:00 AM,146,265,247
Central,Middlesex County,51119,95,551,646,135,1188,1323,14172,147966,162138,05/01/2018 12:00:00 AM,149,269,251
Central,Middlesex County,51119,95,603,698,155,1304,1459,16198,151889,168087,07/01/2015 12:00:00 AM,171,252,241
Central,Middlesex County,51119,96,554,650,134,1207,1341,13819,147383,161202,09/01/2018 12:00:00 AM,144,266,248
Central,Middlesex County,51119,96,568,664,134,1229,1363,15763,165322,181085,10/01/2018 12:00:00 AM,164,291,273
Central,Middlesex County,51119,96,591,687,142,1242,1384,15560,151683,167243,05/01/2019 12:00:00 AM,162,257,243
Central,Middlesex County,51119,96,601,697,162,1365,1527,15693,164161,179854,08/01/2016 12:00:00 AM,163,273,258
Central,Middlesex County,51119,97,571,668,140,1222,1362,15407,149828,165235,11/01/2018 12:00:00 AM,159,262,247
Central,Middlesex County,51119,97,600,697,165,1293,1458,18247,156565,174812,06/01/2015 12:00:00 AM,188,261,251
Central,Middlesex County,51119,98,597,695,140,1247,1387,15750,146453,162203,01/01/2020 12:00:00 AM,161,245,233
Central,Middlesex County,51119,98,598,696,136,1236,1372,15877,149530,165407,02/01/2020 12:00:00 AM,162,250,238
Central,Middlesex County,51119,98,598,696,152,1279,1431,16829,160828,177657,02/01/2017 12:00:00 AM,172,269,255
Central,Middlesex County,51119,98,613,711,140,1264,1404,26542,216555,243097,03/01/2020 12:00:00 AM,271,353,342
Central,Middlesex County,51119,98,624,722,175,1363,1538,19168,162482,181650,12/01/2015 12:00:00 AM,196,260,252
Central,Middlesex County,51119,99,543,642,146,1179,1325,16161,144997,161158,04/01/2018 12:00:00 AM,163,267,251
Central,Middlesex County,51119,99,560,659,149,1207,1356,15153,155616,170769,06/01/2017 12:00:00 AM,153,278,259
Central,Middlesex County,51119,99,579,678,141,1228,1369,15749,150595,166344,07/01/2019 12:00:00 AM,159,260,245
Central,Middlesex County,51119,99,603,702,141,1302,1443,14735,161934,176669,03/01/2017 12:00:00 AM,149,269,252
Central,Middlesex County,51119,99,609,708,170,1335,1505,17332,158618,175950,01/01/2016 12:00:00 AM,175,260,249
Central,Middlesex County,51119,99,612,711,170,1339,1509,17546,159006,176552,02/01/2016 12:00:00 AM,177,260,248
Central,New Kent County,51127,44,408,452,59,959,1018,7139,113421,120560,04/01/2017 12:00:00 AM,162,278,267
Central,New Kent County,51127,45,393,438,60,921,981,8143,108831,116974,05/01/2017 12:00:00 AM,181,277,267
Central,New Kent County,51127,45,416,461,72,1002,1074,8557,116193,124750,12/01/2016 12:00:00 AM,190,279,271
Central,New Kent County,51127,46,397,443,64,943,1007,8891,112225,121116,06/01/2017 12:00:00 AM,193,283,273
Central,New Kent County,51127,46,417,463,67,995,1062,7609,118095,125704,02/01/2017 12:00:00 AM,165,283,271
Central,New Kent County,51127,46,422,468,73,1032,1105,8711,119271,127982,11/01/2016 12:00:00 AM,189,283,273
Central,New Kent County,51127,46,428,474,69,1014,1083,8042,119796,127838,03/01/2017 12:00:00 AM,175,280,270
Central,New Kent County,51127,46,433,479,65,1042,1107,7066,123037,130103,01/01/2017 12:00:00 AM,154,284,272
Central,New Kent County,51127,47,486,533,94,1101,1195,10757,142086,152843,09/01/2012 12:00:00 AM,229,292,287
Central,New Kent County,51127,48,506,554,90,1114,1204,11517,142518,154035,04/01/2013 12:00:00 AM,240,282,278
Central,New Kent County,51127,49,387,436,73,828,901,8396,99207,107603,01/01/2020 12:00:00 AM,171,256,247
Central,New Kent County,51127,49,395,444,76,947,1023,10438,111481,121919,07/01/2017 12:00:00 AM,213,282,275
Central,New Kent County,51127,49,397,446,73,869,942,9584,105925,115509,11/01/2018 12:00:00 AM,196,267,259
Central,New Kent County,51127,49,404,453,73,955,1028,9427,114789,124216,10/01/2017 12:00:00 AM,192,284,274
Central,New Kent County,51127,49,494,543,98,1123,1221,12006,144292,156298,08/01/2012 12:00:00 AM,245,292,288
Central,New Kent County,51127,49,502,551,93,1096,1189,12015,142023,154038,05/01/2013 12:00:00 AM,245,283,280
Central,New Kent County,51127,50,374,424,72,799,871,7343,97857,105200,10/01/2019 12:00:00 AM,147,262,248
Central,New Kent County,51127,50,394,444,82,834,916,10764,101222,111986,01/01/2019 12:00:00 AM,215,257,252
Central,New Kent County,51127,50,407,457,73,951,1024,9114,112453,121567,12/01/2017 12:00:00 AM,182,276,266
Central,New Kent County,51127,50,486,536,98,1101,1199,12310,141021,153331,10/01/2012 12:00:00 AM,246,290,286
Central,New Kent County,51127,50,499,549,100,1094,1194,12777,138122,150899,03/01/2013 12:00:00 AM,256,277,275
Central,New Kent County,51127,50,512,562,100,1129,1229,12913,140745,153658,02/01/2013 12:00:00 AM,258,275,273
Central,New Kent County,51127,51,387,438,74,846,920,10082,108629,118711,10/01/2018 12:00:00 AM,198,281,271
Central,New Kent County,51127,51,407,458,78,993,1071,10211,115241,125452,08/01/2017 12:00:00 AM,200,283,274
Central,New Kent County,51127,51,498,549,98,1095,1193,12110,139550,151660,11/01/2012 12:00:00 AM,237,280,276
Central,New Kent County,51127,51,502,553,95,1111,1206,12129,142163,154292,07/01/2013 12:00:00 AM,238,283,279
Central,New Kent County,51127,52,375,427,82,793,875,11055,97810,108865,09/01/2019 12:00:00 AM,213,261,255
Central,New Kent County,51127,52,378,430,77,807,884,9042,99922,108964,08/01/2019 12:00:00 AM,174,264,253
Central,New Kent County,51127,52,384,436,77,826,903,9817,99121,108938,06/01/2019 12:00:00 AM,189,258,250
Central,New Kent County,51127,52,390,442,80,863,943,9602,102236,111838,06/01/2018 12:00:00 AM,185,262,253
Central,New Kent County,51127,52,392,444,78,870,948,10183,106270,116453,09/01/2018 12:00:00 AM,196,271,262
Central,New Kent County,51127,52,394,446,73,841,914,9043,105382,114425,12/01/2019 12:00:00 AM,174,267,257
Central,New Kent County,51127,52,398,450,79,885,964,10019,107748,117767,08/01/2018 12:00:00 AM,193,271,262
Central,New Kent County,51127,52,398,450,80,882,962,9991,104838,114829,07/01/2018 12:00:00 AM,192,263,255
Central,New Kent County,51127,52,401,453,85,852,937,10907,100769,111676,02/01/2019 12:00:00 AM,210,251,247
Central,New Kent County,51127,52,403,455,76,963,1039,9583,115940,125523,11/01/2017 12:00:00 AM,184,288,276
Central,New Kent County,51127,52,403,455,81,843,924,10020,102784,112804,04/01/2019 12:00:00 AM,193,255,248
Central,New Kent County,51127,52,403,455,85,953,1038,11100,114001,125101,09/01/2017 12:00:00 AM,213,283,275
Central,New Kent County,51127,52,404,456,93,1002,1095,10958,115533,126491,07/01/2016 12:00:00 AM,211,286,277
Central,New Kent County,51127,52,413,465,89,1020,1109,11257,117648,128905,06/01/2016 12:00:00 AM,216,285,277
Central,New Kent County,51127,52,414,466,82,860,942,10499,102286,112785,03/01/2019 12:00:00 AM,202,247,242
Central,New Kent County,51127,52,451,503,84,1071,1155,9812,126412,136224,10/01/2015 12:00:00 AM,189,280,271
Central,New Kent County,51127,52,462,514,81,1128,1209,8894,135091,143985,08/01/2015 12:00:00 AM,171,292,280
Central,New Kent County,51127,52,464,516,86,1110,1196,9838,132118,141956,09/01/2015 12:00:00 AM,189,285,275
Central,New Kent County,51127,52,489,541,106,1108,1214,13252,142407,155659,07/01/2012 12:00:00 AM,255,291,288
Central,New Kent County,51127,53,379,432,78,801,879,8485,95247,103732,02/01/2020 12:00:00 AM,160,251,240
Central,New Kent County,51127,53,389,442,78,833,911,9371,100724,110095,07/01/2019 12:00:00 AM,177,259,249
Central,New Kent County,51127,53,397,450,79,892,971,9583,103913,113496,05/01/2018 12:00:00 AM,181,262,252
Central,New Kent County,51127,53,399,452,78,922,1000,9640,110592,120232,04/01/2018 12:00:00 AM,182,277,266
Central,New Kent County,51127,53,399,452,83,930,1013,10173,109485,119658,01/01/2018 12:00:00 AM,192,274,265
Central,New Kent County,51127,53,415,468,90,996,1086,11101,115212,126313,05/01/2016 12:00:00 AM,209,278,270
Central,New Kent County,51127,53,422,475,87,999,1086,10387,115826,126213,04/01/2016 12:00:00 AM,196,274,266
Central,New Kent County,51127,53,423,476,80,1018,1098,9449,118554,128003,03/01/2016 12:00:00 AM,178,280,269
Central,New Kent County,51127,53,427,480,77,1023,1100,8762,118793,127555,02/01/2016 12:00:00 AM,165,278,266
Central,New Kent County,51127,53,499,552,97,1106,1203,12368,142976,155344,08/01/2013 12:00:00 AM,233,287,281
Central,New Kent County,51127,54,403,457,88,860,948,11831,106875,118706,12/01/2018 12:00:00 AM,219,265,260
Central,New Kent County,51127,54,413,467,87,1036,1123,10948,121817,132765,10/01/2016 12:00:00 AM,203,295,284
Central,New Kent County,51127,54,427,481,79,1025,1104,8230,120026,128256,01/01/2016 12:00:00 AM,152,281,267
Central,New Kent County,51127,54,464,518,88,1133,1221,9828,136782,146610,07/01/2015 12:00:00 AM,182,295,283
Central,New Kent County,51127,54,486,540,97,1073,1170,12159,136795,148954,10/01/2013 12:00:00 AM,225,281,276
Central,New Kent County,51127,54,495,549,112,1127,1239,14201,145617,159818,06/01/2012 12:00:00 AM,263,294,291
Central,New Kent County,51127,54,501,555,109,1095,1204,14089,138211,152300,12/01/2012 12:00:00 AM,261,276,274
Central,New Kent County,51127,54,503,557,103,1119,1222,13567,142532,156099,06/01/2013 12:00:00 AM,251,283,280
Central,New Kent County,51127,55,377,432,81,802,883,9764,95294,105058,11/01/2019 12:00:00 AM,178,253,243
Central,New Kent County,51127,55,390,445,86,812,898,11505,98498,110003,05/01/2019 12:00:00 AM,209,253,247
Central,New Kent County,51127,55,407,462,96,1014,1110,11424,119156,130580,08/01/2016 12:00:00 AM,208,293,283
Central,New Kent County,51127,55,470,525,103,1063,1166,12423,125614,138037,11/01/2013 12:00:00 AM,226,267,263
Central,New Kent County,51127,55,502,557,112,1104,1216,14472,138718,153190,01/01/2013 12:00:00 AM,263,276,275
Central,New Kent County,51127,56,391,447,87,904,991,10992,106905,117897,02/01/2018 12:00:00 AM,196,273,264
Central,New Kent County,51127,56,402,458,89,831,920,16046,143197,159243,03/01/2020 12:00:00 AM,287,356,348
Central,New Kent County,51127,56,404,460,97,1016,1113,11361,117246,128607,09/01/2016 12:00:00 AM,203,290,280
Central,New Kent County,51127,56,442,498,89,1060,1149,9656,126608,136264,12/01/2015 12:00:00 AM,172,286,274
Central,New Kent County,51127,56,447,503,90,1077,1167,10431,127049,137480,11/01/2015 12:00:00 AM,186,284,273
Central,New Kent County,51127,56,489,545,104,1093,1197,13017,139667,152684,09/01/2013 12:00:00 AM,232,286,280
Central,New Kent County,51127,57,408,465,88,932,1020,10877,111335,122212,03/01/2018 12:00:00 AM,191,273,263
Central,New Kent County,51127,58,480,538,113,1086,1199,13093,126206,139299,12/01/2013 12:00:00 AM,226,263,259
Central,New Kent County,51127,58,484,542,115,1123,1238,13703,130999,144702,01/01/2014 12:00:00 AM,236,271,267
Central,New Kent County,51127,60,467,527,104,1128,1232,11143,135862,147005,06/01/2015 12:00:00 AM,186,291,279
Central,New Kent County,51127,60,486,546,132,1100,1232,18178,142012,160190,04/01/2012 12:00:00 AM,303,292,293
Central,New Kent County,51127,60,493,553,126,1109,1235,17506,142875,160381,05/01/2012 12:00:00 AM,292,290,290
Central,New Kent County,51127,61,450,511,96,924,1020,17458,164162,181620,04/01/2020 12:00:00 AM,286,365,355
Central,New Kent County,51127,61,473,534,110,1128,1238,11934,137215,149149,05/01/2015 12:00:00 AM,196,290,279
Central,New Kent County,51127,61,495,556,121,1152,1273,13968,132648,146616,02/01/2014 12:00:00 AM,229,268,264
Central,New Kent County,51127,61,510,571,112,1189,1301,13186,140647,153833,05/01/2014 12:00:00 AM,216,276,269
Central,New Kent County,51127,62,480,542,79,995,1074,17322,212304,229626,02/01/2021 12:00:00 AM,279,442,424
Central,New Kent County,51127,62,481,543,78,1001,1079,17951,210824,228775,03/01/2021 12:00:00 AM,290,438,421
Central,New Kent County,51127,62,497,559,111,1145,1256,12651,136048,148699,08/01/2014 12:00:00 AM,204,274,266
Central,New Kent County,51127,62,503,565,123,1172,1295,14650,135836,150486,03/01/2014 12:00:00 AM,236,270,266
Central,New Kent County,51127,63,456,519,102,913,1015,18819,158768,177587,07/01/2020 12:00:00 AM,299,348,342
Central,New Kent County,51127,63,461,524,137,1069,1206,19566,135665,155231,02/01/2012 12:00:00 AM,311,294,296
Central,New Kent County,51127,63,472,535,133,1087,1220,18534,138497,157031,03/01/2012 12:00:00 AM,294,293,294
Central,New Kent County,51127,63,474,537,86,974,1060,20526,229838,250364,04/01/2021 12:00:00 AM,326,485,466
Central,New Kent County,51127,63,479,542,115,1142,1257,13213,138508,151721,04/01/2015 12:00:00 AM,210,289,280
Central,New Kent County,51127,63,497,560,108,1132,1240,12580,133373,145953,09/01/2014 12:00:00 AM,200,268,261
Central,New Kent County,51127,63,505,568,123,1179,1302,14854,139470,154324,04/01/2014 12:00:00 AM,236,276,272
Central,New Kent County,51127,64,461,525,140,1084,1224,19548,134104,153652,01/01/2012 12:00:00 AM,305,291,293
Central,New Kent County,51127,64,467,531,105,966,1071,19166,168513,187679,05/01/2020 12:00:00 AM,299,361,353
Central,New Kent County,51127,64,475,539,120,1101,1221,13943,133218,147161,03/01/2015 12:00:00 AM,218,280,273
Central,New Kent County,51127,64,499,563,120,1140,1260,13848,135998,149846,06/01/2014 12:00:00 AM,216,273,266
Central,New Kent County,51127,64,511,575,115,1158,1273,14084,143537,157621,10/01/2014 12:00:00 AM,220,281,274
Central,New Kent County,51127,65,459,524,108,932,1040,19061,162834,181895,06/01/2020 12:00:00 AM,293,355,347
Central,New Kent County,51127,65,497,562,119,1141,1260,12963,136855,149818,07/01/2014 12:00:00 AM,199,275,267
Central,New Kent County,51127,66,466,532,95,958,1053,18374,182600,200974,11/01/2020 12:00:00 AM,278,392,378
Central,New Kent County,51127,67,465,532,107,951,1058,18650,164117,182767,08/01/2020 12:00:00 AM,278,353,344
Central,New Kent County,51127,67,467,534,101,973,1074,18272,171453,189725,09/01/2020 12:00:00 AM,273,367,355
Central,New Kent County,51127,67,475,542,127,1110,1237,14903,134409,149312,02/01/2015 12:00:00 AM,222,283,275
Central,New Kent County,51127,68,463,531,102,954,1056,19659,171110,190769,10/01/2020 12:00:00 AM,289,370,359
Central,New Kent County,51127,68,469,537,103,972,1075,24688,223667,248355,05/01/2021 12:00:00 AM,363,477,462
Central,New Kent County,51127,68,471,539,101,973,1074,23405,229083,252488,06/01/2021 12:00:00 AM,344,486,468
Central,New Kent County,51127,68,507,575,124,1169,1293,15530,144702,160232,11/01/2014 12:00:00 AM,228,285,279
Central,New Kent County,51127,69,479,548,129,1123,1252,15584,134788,150372,01/01/2015 12:00:00 AM,226,281,274
Central,New Kent County,51127,69,487,556,124,1144,1268,15324,141394,156718,12/01/2014 12:00:00 AM,222,290,282
Central,New Kent County,51127,70,458,528,106,925,1031,19371,169479,188850,12/01/2020 12:00:00 AM,277,370,358
Central,New Kent County,51127,70,462,532,107,941,1048,23447,197899,221346,01/01/2021 12:00:00 AM,335,428,416
Central,Northumberland County,51133,113,612,725,134,1281,1415,31615,289967,321582,06/01/2021 12:00:00 AM,280,474,444
Central,Northumberland County,51133,115,606,721,147,1360,1507,13686,156103,169789,04/01/2017 12:00:00 AM,119,258,235
Central,Northumberland County,51133,116,611,727,137,1276,1413,32552,289313,321865,05/01/2021 12:00:00 AM,281,474,443
Central,Northumberland County,51133,117,610,727,138,1281,1419,32412,291611,324023,04/01/2021 12:00:00 AM,277,478,446
Central,Northumberland County,51133,118,607,725,140,1265,1405,32390,270680,303070,02/01/2021 12:00:00 AM,274,446,418
Central,Northumberland County,51133,118,615,733,154,1405,1559,14193,165771,179964,03/01/2017 12:00:00 AM,120,270,246
Central,Northumberland County,51133,118,617,735,140,1285,1425,31886,265467,297353,03/01/2021 12:00:00 AM,270,430,405
Central,Northumberland County,51133,118,636,754,143,1456,1599,13204,167643,180847,02/01/2017 12:00:00 AM,112,264,240
Central,Northumberland County,51133,120,616,736,144,1424,1568,13806,165456,179262,10/01/2016 12:00:00 AM,115,269,244
Central,Northumberland County,51133,120,654,774,146,1535,1681,12610,172445,185055,12/01/2015 12:00:00 AM,105,264,239
Central,Northumberland County,51133,121,606,727,155,1372,1527,14621,159727,174348,05/01/2017 12:00:00 AM,121,264,240
Central,Northumberland County,51133,121,621,742,147,1451,1598,14017,168109,182126,09/01/2016 12:00:00 AM,116,271,245
Central,Northumberland County,51133,122,591,713,158,1350,1508,15113,155279,170392,06/01/2017 12:00:00 AM,124,263,239
Central,Northumberland County,51133,122,628,750,154,1476,1630,15530,171237,186767,08/01/2016 12:00:00 AM,127,273,249
Central,Northumberland County,51133,123,596,719,151,1239,1390,32671,260532,293203,01/01/2021 12:00:00 AM,266,437,408
Central,Northumberland County,51133,123,606,729,157,1401,1558,15763,162822,178585,11/01/2016 12:00:00 AM,128,269,245
Central,Northumberland County,51133,123,622,745,157,1425,1582,14301,164358,178659,01/01/2017 12:00:00 AM,116,264,240
Central,Northumberland County,51133,123,630,753,153,1476,1629,14470,171354,185824,07/01/2016 12:00:00 AM,118,272,247
Central,Northumberland County,51133,123,654,777,151,1543,1694,13273,175111,188384,01/01/2016 12:00:00 AM,108,268,242
Central,Northumberland County,51133,124,587,711,154,1313,1467,14239,152747,166986,09/01/2017 12:00:00 AM,115,260,235
Central,Northumberland County,51133,124,592,716,149,1316,1465,13944,148931,162875,10/01/2017 12:00:00 AM,112,252,227
Central,Northumberland County,51133,124,598,722,172,1279,1451,15794,140765,156559,02/01/2020 12:00:00 AM,127,235,217
Central,Northumberland County,51133,124,617,741,160,1403,1563,15476,162419,177895,12/01/2016 12:00:00 AM,125,263,240
Central,Northumberland County,51133,125,584,709,156,1315,1471,14304,151288,165592,08/01/2017 12:00:00 AM,114,259,234
Central,Northumberland County,51133,125,601,726,173,1280,1453,30788,220026,250814,03/01/2020 12:00:00 AM,246,366,345
Central,Northumberland County,51133,125,651,776,158,1524,1682,14328,176097,190425,02/01/2016 12:00:00 AM,115,271,245
Central,Northumberland County,51133,126,590,716,171,1277,1448,14935,146377,161312,01/01/2020 12:00:00 AM,119,248,225
Central,Northumberland County,51133,126,592,718,157,1344,1501,15202,154928,170130,07/01/2017 12:00:00 AM,121,262,237
Central,Northumberland County,51133,126,640,766,163,1489,1652,15623,172936,188559,05/01/2016 12:00:00 AM,124,270,246
Central,Northumberland County,51133,126,675,801,162,1545,1707,14197,180237,194434,05/01/2015 12:00:00 AM,113,267,243
Central,Northumberland County,51133,127,634,761,165,1483,1648,16328,172307,188635,06/01/2016 12:00:00 AM,129,272,248
Central,Northumberland County,51133,127,646,773,165,1461,1626,14660,168695,183355,10/01/2015 12:00:00 AM,115,261,237
Central,Northumberland County,51133,127,665,792,160,1535,1695,13283,175031,188314,08/01/2015 12:00:00 AM,105,263,238
Central,Northumberland County,51133,127,668,795,166,1528,1694,14300,177806,192106,06/01/2015 12:00:00 AM,113,266,242
Central,Northumberland County,51133,128,628,756,176,1326,1502,32362,229443,261805,04/01/2020 12:00:00 AM,253,365,346
Central,Northumberland County,51133,128,647,775,163,1510,1673,15431,172818,188249,04/01/2016 12:00:00 AM,121,267,243
Central,Northumberland County,51133,128,648,776,163,1496,1659,15179,168285,183464,11/01/2015 12:00:00 AM,119,260,236
Central,Northumberland County,51133,128,654,782,158,1519,1677,12972,175507,188479,07/01/2015 12:00:00 AM,101,268,241
Central,Northumberland County,51133,128,662,790,170,1504,1674,14816,171945,186761,09/01/2015 12:00:00 AM,116,260,236
Central,Northumberland County,51133,129,591,720,160,1248,1408,32269,227361,259630,12/01/2020 12:00:00 AM,250,385,361
Central,Northumberland County,51133,129,599,728,163,1270,1433,31687,231343,263030,11/01/2020 12:00:00 AM,246,386,361
Central,Northumberland County,51133,129,600,729,156,1334,1490,15141,153885,169026,11/01/2017 12:00:00 AM,117,256,232
Central,Northumberland County,51133,129,652,781,164,1524,1688,15191,177145,192336,03/01/2016 12:00:00 AM,118,272,246
Central,Northumberland County,51133,130,596,726,163,1275,1438,14424,142676,157100,05/01/2019 12:00:00 AM,111,239,216
Central,Northumberland County,51133,130,606,736,161,1305,1466,14907,145944,160851,04/01/2019 12:00:00 AM,115,241,219
Central,Northumberland County,51133,130,612,742,159,1325,1484,14820,145313,160133,03/01/2019 12:00:00 AM,114,237,216
Central,Northumberland County,51133,130,693,823,166,1570,1736,14464,180767,195231,04/01/2015 12:00:00 AM,111,261,237
Central,Northumberland County,51133,131,579,710,167,1266,1433,15148,143486,158634,11/01/2019 12:00:00 AM,116,248,223
Central,Northumberland County,51133,131,589,720,165,1296,1461,14956,146192,161148,12/01/2019 12:00:00 AM,114,248,224
Central,Northumberland County,51133,131,596,727,166,1328,1494,16446,147638,164084,04/01/2018 12:00:00 AM,126,248,226
Central,Northumberland County,51133,131,598,729,158,1336,1494,16158,149134,165292,12/01/2017 12:00:00 AM,123,249,227
Central,Northumberland County,51133,131,609,740,159,1319,1478,15457,153425,168882,01/01/2019 12:00:00 AM,118,252,228
Central,Northumberland County,51133,131,614,745,165,1360,1525,16086,154350,170436,12/01/2018 12:00:00 AM,123,251,229
Central,Northumberland County,51133,131,616,747,172,1369,1541,20368,180287,200655,10/01/2018 12:00:00 AM,155,293,269
Central,Northumberland County,51133,131,696,827,164,1509,1673,14732,185634,200366,02/01/2012 12:00:00 AM,112,267,242
Central,Northumberland County,51133,131,769,900,178,1658,1836,15790,194965,210755,04/01/2014 12:00:00 AM,121,254,234
Central,Northumberland County,51133,132,587,719,161,1265,1426,14833,137861,152694,02/01/2019 12:00:00 AM,112,235,212
Central,Northumberland County,51133,132,607,739,172,1362,1534,16832,152460,169292,06/01/2018 12:00:00 AM,128,251,229
Central,Northumberland County,51133,132,738,870,180,1600,1780,16688,187908,204596,06/01/2014 12:00:00 AM,126,255,235
Central,Northumberland County,51133,133,568,701,159,1224,1383,14228,140725,154953,09/01/2019 12:00:00 AM,107,248,221
Central,Northumberland County,51133,133,578,711,163,1245,1408,15531,141707,157238,08/01/2019 12:00:00 AM,117,245,221
Central,Northumberland County,51133,133,684,817,171,1497,1668,15710,185961,201671,04/01/2012 12:00:00 AM,118,272,247
Central,Northumberland County,51133,133,730,863,171,1592,1763,13665,186344,200009,07/01/2014 12:00:00 AM,103,255,232
Central,Northumberland County,51133,133,757,890,176,1652,1828,15519,195951,211470,05/01/2014 12:00:00 AM,117,259,238
Central,Northumberland County,51133,134,597,731,176,1323,1499,17309,149629,166938,07/01/2018 12:00:00 AM,129,251,228
Central,Northumberland County,51133,134,599,733,176,1343,1519,16637,149975,166612,05/01/2018 12:00:00 AM,124,250,227
Central,Northumberland County,51133,134,613,747,174,1362,1536,17263,150905,168168,11/01/2018 12:00:00 AM,129,246,225
Central,Northumberland County,51133,134,616,750,167,1383,1550,16939,157317,174256,03/01/2018 12:00:00 AM,126,255,232
Central,Northumberland County,51133,134,625,759,175,1285,1460,32422,222629,255051,08/01/2020 12:00:00 AM,242,356,336
Central,Northumberland County,51133,134,629,763,183,1303,1486,33451,225096,258547,06/01/2020 12:00:00 AM,250,358,339
Central,Northumberland County,51133,134,632,766,183,1325,1508,34128,227362,261490,05/01/2020 12:00:00 AM,255,360,341
Central,Northumberland County,51133,135,581,716,168,1249,1417,15469,141977,157446,07/01/2019 12:00:00 AM,115,244,220
Central,Northumberland County,51133,135,586,721,169,1273,1442,15382,143181,158563,06/01/2019 12:00:00 AM,114,244,220
Central,Northumberland County,51133,135,598,733,172,1250,1422,33418,228704,262122,10/01/2020 12:00:00 AM,248,382,358
Central,Northumberland County,51133,135,610,745,166,1369,1535,16311,150827,167138,01/01/2018 12:00:00 AM,121,247,224
Central,Northumberland County,51133,135,615,750,174,1281,1455,32267,218234,250501,09/01/2020 12:00:00 AM,239,355,334
Central,Northumberland County,51133,135,668,803,180,1462,1642,17711,180640,198351,05/01/2012 12:00:00 AM,131,270,247
Central,Northumberland County,51133,135,697,832,176,1569,1745,15849,177327,193176,03/01/2015 12:00:00 AM,117,254,232
Central,Northumberland County,51133,135,718,853,166,1616,1782,15294,189887,205181,10/01/2014 12:00:00 AM,113,264,241
Central,Northumberland County,51133,136,606,742,173,1346,1519,16809,152378,169187,08/01/2018 12:00:00 AM,124,251,228
Central,Northumberland County,51133,136,631,767,185,1301,1486,33472,222975,256447,07/01/2020 12:00:00 AM,246,353,334
Central,Northumberland County,51133,136,689,825,175,1484,1659,15853,180858,196711,01/01/2012 12:00:00 AM,117,262,238
Central,Northumberland County,51133,136,714,850,169,1600,1769,15479,187739,203218,11/01/2014 12:00:00 AM,114,263,239
Central,Northumberland County,51133,136,721,857,163,1623,1786,14539,189921,204460,12/01/2014 12:00:00 AM,107,263,239
Central,Northumberland County,51133,136,755,891,187,1657,1844,18573,207415,225988,02/01/2013 12:00:00 AM,137,275,254
Central,Northumberland County,51133,137,578,715,170,1261,1431,16085,144782,160867,10/01/2019 12:00:00 AM,117,250,225
Central,Northumberland County,51133,137,609,746,168,1356,1524,16029,152700,168729,02/01/2018 12:00:00 AM,117,251,226
Central,Northumberland County,51133,137,667,804,191,1442,1633,18216,175928,194144,07/01/2012 12:00:00 AM,133,264,241
Central,Northumberland County,51133,137,691,828,179,1503,1682,16189,186725,202914,03/01/2012 12:00:00 AM,118,270,245
Central,Northumberland County,51133,137,700,837,176,1578,1754,15918,181829,197747,02/01/2015 12:00:00 AM,116,260,236
Central,Northumberland County,51133,137,729,866,172,1608,1780,14122,185192,199314,08/01/2014 12:00:00 AM,103,254,230
Central,Northumberland County,51133,137,769,906,192,1638,1830,17191,192439,209630,03/01/2014 12:00:00 AM,125,250,231
Central,Northumberland County,51133,138,710,848,176,1595,1771,15479,182486,197965,01/01/2015 12:00:00 AM,112,257,233
Central,Northumberland County,51133,138,713,851,182,1579,1761,17080,196911,213991,10/01/2012 12:00:00 AM,124,276,251
Central,Northumberland County,51133,138,765,903,195,1625,1820,18077,188634,206711,02/01/2014 12:00:00 AM,131,247,229
Central,Northumberland County,51133,139,665,804,191,1446,1637,18885,175080,193965,06/01/2012 12:00:00 AM,136,263,241
Central,Northumberland County,51133,139,760,899,190,1682,1872,18746,209449,228195,03/01/2013 12:00:00 AM,135,276,254
Central,Northumberland County,51133,140,608,748,181,1356,1537,18359,152218,170577,09/01/2018 12:00:00 AM,131,250,228
Central,Northumberland County,51133,140,734,874,184,1632,1816,18121,204619,222740,12/01/2012 12:00:00 AM,129,279,255
Central,Northumberland County,51133,141,741,882,190,1631,1821,18192,201704,219896,01/01/2013 12:00:00 AM,129,272,249
Central,Northumberland County,51133,141,751,892,188,1668,1856,17696,206910,224606,07/01/2013 12:00:00 AM,126,276,252
Central,Northumberland County,51133,141,754,895,183,1646,1829,16872,204754,221626,08/01/2013 12:00:00 AM,120,272,248
Central,Northumberland County,51133,142,687,829,195,1522,1717,18514,185722,204236,09/01/2012 12:00:00 AM,130,270,246
Central,Northumberland County,51133,142,752,894,198,1656,1854,18223,207156,225379,06/01/2013 12:00:00 AM,128,275,252
Central,Northumberland County,51133,142,758,900,191,1676,1867,18749,208629,227378,04/01/2013 12:00:00 AM,132,275,253
Central,Northumberland County,51133,143,686,829,198,1487,1685,19197,181031,200228,08/01/2012 12:00:00 AM,134,264,242
Central,Northumberland County,51133,143,719,862,191,1599,1790,18635,199779,218414,11/01/2012 12:00:00 AM,130,278,253
Central,Northumberland County,51133,143,755,898,201,1661,1862,18914,208806,227720,05/01/2013 12:00:00 AM,132,277,254
Central,Northumberland County,51133,144,760,904,203,1620,1823,17604,186849,204453,01/01/2014 12:00:00 AM,122,246,226
Central,Northumberland County,51133,145,721,866,189,1581,1770,16714,177740,194454,09/01/2014 12:00:00 AM,115,247,225
Central,Northumberland County,51133,145,754,899,196,1637,1833,17087,188263,205350,11/01/2013 12:00:00 AM,118,250,228
Central,Northumberland County,51133,146,759,905,194,1629,1823,17867,198906,216773,09/01/2013 12:00:00 AM,122,262,240
Central,Northumberland County,51133,146,761,907,195,1642,1837,16736,188110,204846,12/01/2013 12:00:00 AM,115,247,226
Central,Northumberland County,51133,149,750,899,207,1599,1806,19712,199686,219398,10/01/2013 12:00:00 AM,132,266,244
Central,Nottoway County,51135,265,963,1228,359,2118,2477,35307,250010,285317,10/01/2019 12:00:00 AM,133,260,232
Central,Nottoway County,51135,265,982,1247,362,2145,2507,34920,245853,280773,08/01/2019 12:00:00 AM,132,250,225
Central,Nottoway County,51135,266,1037,1303,339,2255,2594,80894,494206,575100,02/01/2021 12:00:00 AM,304,477,441
Central,Nottoway County,51135,266,972,1238,366,2133,2499,35855,250213,286068,09/01/2019 12:00:00 AM,135,257,231
Central,Nottoway County,51135,267,960,1227,359,2095,2454,34923,242020,276943,11/01/2019 12:00:00 AM,131,252,226
Central,Nottoway County,51135,268,1021,1289,353,2193,2546,85709,491737.38,577446.38,03/01/2021 12:00:00 AM,320,482,448
Central,Nottoway County,51135,268,975,1243,362,2175,2537,33935,255022,288957,12/01/2019 12:00:00 AM,127,262,232
Central,Nottoway County,51135,269,982,1251,366,2127,2493,34340,250762,285102,07/01/2019 12:00:00 AM,128,255,228
Central,Nottoway County,51135,271,937,1208,362,2056,2418,33705,237223,270928,02/01/2020 12:00:00 AM,124,253,224
Central,Nottoway County,51135,271,997,1268,371,2188,2559,34678,251917,286595,05/01/2019 12:00:00 AM,128,253,226
Central,Nottoway County,51135,272,993,1265,372,2173,2545,34520,256665,291185,06/01/2019 12:00:00 AM,127,258,230
Central,Nottoway County,51135,273,949,1222,368,2103,2471,34814,241045,275859,01/01/2020 12:00:00 AM,128,254,226
Central,Nottoway County,51135,275,1151,1426,338,2536,2874,31115,305310,336425,04/01/2017 12:00:00 AM,113,265,236
Central,Nottoway County,51135,275,982,1257,366,2073,2439,84960,470234,555194,06/01/2021 12:00:00 AM,309,479,442
Central,Nottoway County,51135,276,1006,1282,365,2145,2510,86125,485703,571828,04/01/2021 12:00:00 AM,312,483,446
Central,Nottoway County,51135,276,953,1229,377,2078,2455,69032,356076,425108,03/01/2020 12:00:00 AM,250,374,346
Central,Nottoway County,51135,276,973,1249,373,2134,2507,36170,245323,281493,02/01/2019 12:00:00 AM,131,252,225
Central,Nottoway County,51135,278,1008,1286,379,2231,2610,35962,258074,294036,04/01/2019 12:00:00 AM,129,256,229
Central,Nottoway County,51135,279,992,1271,368,2109,2477,87201,480137,567338,05/01/2021 12:00:00 AM,313,484,446
Central,Nottoway County,51135,282,1128,1410,353,2504,2857,32054,298736,330790,05/01/2017 12:00:00 AM,114,265,235
Central,Nottoway County,51135,283,1011,1294,387,2215,2602,71121,383645,454766,04/01/2020 12:00:00 AM,251,379,351
Central,Nottoway County,51135,284,1000,1284,393,2167,2560,76608,399789,476397,11/01/2020 12:00:00 AM,270,400,371
Central,Nottoway County,51135,284,1015,1299,386,2248,2634,36914,258655,295569,03/01/2019 12:00:00 AM,130,255,228
Central,Nottoway County,51135,284,1018,1302,390,2188,2578,87365,457753,545118,01/01/2021 12:00:00 AM,308,450,419
Central,Nottoway County,51135,284,1160,1444,355,2571,2926,32893,305621,338514,03/01/2017 12:00:00 AM,116,263,234
Central,Nottoway County,51135,285,1018,1303,400,2174,2574,72630,378334,450964,08/01/2020 12:00:00 AM,255,372,346
Central,Nottoway County,51135,285,1019,1304,392,2212,2604,75926,402459,478385,12/01/2020 12:00:00 AM,266,395,367
Central,Nottoway County,51135,285,1044,1329,393,2264,2657,72180,389396,461576,05/01/2020 12:00:00 AM,253,373,347
Central,Nottoway County,51135,285,1129,1414,361,2500,2861,32956,295275,328231,06/01/2017 12:00:00 AM,116,262,232
Central,Nottoway County,51135,286,1058,1344,383,2338,2721,37554,274187,311741,11/01/2018 12:00:00 AM,131,259,232
Central,Nottoway County,51135,287,1036,1323,384,2304,2688,37305,266421,303726,12/01/2018 12:00:00 AM,130,257,230
Central,Nottoway County,51135,287,1039,1326,392,2248,2640,72128,386273,458401,06/01/2020 12:00:00 AM,251,372,346
Central,Nottoway County,51135,288,1126,1414,372,2504,2876,34058,297243,331301,07/01/2017 12:00:00 AM,118,264,234
Central,Nottoway County,51135,288,1132,1420,373,2505,2878,35954,292627,328581,10/01/2017 12:00:00 AM,125,259,231
Central,Nottoway County,51135,289,1037,1326,400,2236,2636,73218,384649,457867,07/01/2020 12:00:00 AM,253,371,345
Central,Nottoway County,51135,289,1045,1334,387,2330,2717,37898,284125,322023,01/01/2019 12:00:00 AM,131,272,241
Central,Nottoway County,51135,289,1063,1352,382,2328,2710,38996,291893.97,330889.97,10/01/2018 12:00:00 AM,135,275,245
Central,Nottoway County,51135,289,1077,1366,382,2348,2730,36306,277115,313421,07/01/2018 12:00:00 AM,126,257,229
Central,Nottoway County,51135,290,1010,1300,405,2174,2579,78507,394119,472626,10/01/2020 12:00:00 AM,271,390,364
Central,Nottoway County,51135,290,1139,1429,377,2515,2892,35730,300799,336529,09/01/2017 12:00:00 AM,123,264,235
Central,Nottoway County,51135,290,1142,1432,371,2530,2901,33984,299063,333047,08/01/2017 12:00:00 AM,117,262,233
Central,Nottoway County,51135,291,1013,1304,408,2170,2578,74302,376261,450563,09/01/2020 12:00:00 AM,255,371,346
Central,Nottoway County,51135,291,1074,1365,389,2363,2752,37050,275356,312406,09/01/2018 12:00:00 AM,127,256,229
Central,Nottoway County,51135,292,1086,1378,388,2362,2750,38535,275674,314209,06/01/2018 12:00:00 AM,132,254,228
Central,Nottoway County,51135,292,1120,1412,378,2442,2820,34230,288756,322986,02/01/2018 12:00:00 AM,117,258,229
Central,Nottoway County,51135,293,1136,1429,376,2486,2862,35707,293227,328934,12/01/2017 12:00:00 AM,122,258,230
Central,Nottoway County,51135,294,1090,1384,395,2379,2774,37117,278877,315994,08/01/2018 12:00:00 AM,126,256,228
Central,Nottoway County,51135,294,1120,1414,381,2451,2832,34357,284330,318687,01/01/2018 12:00:00 AM,117,254,225
Central,Nottoway County,51135,294,1163,1457,368,2583,2951,33687,301430,335117,02/01/2017 12:00:00 AM,115,259,230
Central,Nottoway County,51135,295,1142,1437,380,2501,2881,36703,293124,329827,11/01/2017 12:00:00 AM,124,257,230
Central,Nottoway County,51135,296,1088,1384,397,2374,2771,38475,276976,315451,05/01/2018 12:00:00 AM,130,255,228
Central,Nottoway County,51135,296,1110,1406,384,2440,2824,35735,286449,322184,03/01/2018 12:00:00 AM,121,258,229
Central,Nottoway County,51135,300,1174,1474,394,2596,2990,36736,299330,336066,12/01/2016 12:00:00 AM,122,255,228
Central,Nottoway County,51135,301,1109,1410,399,2414,2813,37751,281799,319550,04/01/2018 12:00:00 AM,125,254,227
Central,Nottoway County,51135,301,1170,1471,389,2594,2983,36194,300081,336275,01/01/2017 12:00:00 AM,120,256,229
Central,Nottoway County,51135,303,1187,1490,403,2673,3076,39579,306854,346433,09/01/2016 12:00:00 AM,131,259,233
Central,Nottoway County,51135,305,1197,1502,405,2687,3092,39274,312331,351605,10/01/2016 12:00:00 AM,129,261,234
Central,Nottoway County,51135,309,1187,1496,417,2658,3075,41492,307214,348706,08/01/2016 12:00:00 AM,134,259,233
Central,Nottoway County,51135,310,1167,1477,416,2612,3028,39421,299575,338996,11/01/2016 12:00:00 AM,127,257,230
Central,Nottoway County,51135,318,1192,1510,428,2670,3098,40420,310969,351389,07/01/2016 12:00:00 AM,127,261,233
Central,Nottoway County,51135,324,1194,1518,433,2685,3118,41329,311060,352389,06/01/2016 12:00:00 AM,128,261,232
Central,Nottoway County,51135,324,1269,1593,462,2777,3239,44589,336297,380886,08/01/2015 12:00:00 AM,138,265,239
Central,Nottoway County,51135,326,1179,1505,433,2640,3073,40746,306046,346792,05/01/2016 12:00:00 AM,125,260,230
Central,Nottoway County,51135,329,1261,1590,477,2757,3234,48137,328722,376859,09/01/2015 12:00:00 AM,146,261,237
Central,Nottoway County,51135,330,1211,1541,447,2683,3130,44441,313222,357663,03/01/2016 12:00:00 AM,135,259,232
Central,Nottoway County,51135,332,1182,1514,448,2627,3075,42959,306587,349546,04/01/2016 12:00:00 AM,129,259,231
Central,Nottoway County,51135,332,1218,1550,464,2681,3145,45595,312385,357980,02/01/2016 12:00:00 AM,137,256,231
Central,Nottoway County,51135,332,1262,1594,479,2780,3259,46530,336677,383207,07/01/2015 12:00:00 AM,140,267,240
Central,Nottoway County,51135,333,1228,1561,493,2681,3174,50471,313634,364105,11/01/2015 12:00:00 AM,152,255,233
Central,Nottoway County,51135,333,1244,1577,488,2717,3205,49780,319122,368902,10/01/2015 12:00:00 AM,149,257,234
Central,Nottoway County,51135,335,1257,1592,494,2795,3289,50008,334696,384704,05/01/2015 12:00:00 AM,149,266,242
Central,Nottoway County,51135,336,1279,1615,492,2845,3337,49153,343314,392467,06/01/2015 12:00:00 AM,146,268,243
Central,Nottoway County,51135,341,1226,1567,504,2687,3191,50876,313021,363897,12/01/2015 12:00:00 AM,149,255,232
Central,Nottoway County,51135,342,1202,1544,484,2665,3149,47522,309045,356567,01/01/2016 12:00:00 AM,139,257,231
Central,Nottoway County,51135,342,1267,1609,511,2823,3334,51739,335586,387325,04/01/2015 12:00:00 AM,151,265,241
Central,Nottoway County,51135,348,1322,1670,513,2870,3383,52875,346905,399780,12/01/2014 12:00:00 AM,152,262,239
Central,Nottoway County,51135,349,1273,1622,521,2828,3349,53938,335003,388941,03/01/2015 12:00:00 AM,155,263,240
Central,Nottoway County,51135,352,1340,1692,524,2898,3422,55817,349061,404878,11/01/2014 12:00:00 AM,159,260,239
Central,Nottoway County,51135,353,1297,1650,537,2860,3397,54448,343747,398195,02/01/2015 12:00:00 AM,154,265,241
Central,Nottoway County,51135,357,1313,1670,531,2863,3394,54482,337990,392472,01/01/2015 12:00:00 AM,153,257,235
Central,Nottoway County,51135,357,1363,1720,542,2920,3462,57981,352864,410845,10/01/2014 12:00:00 AM,162,259,239
Central,Nottoway County,51135,363,1390,1753,561,2981,3542,56471,343611,400082,09/01/2014 12:00:00 AM,156,247,228
Central,Nottoway County,51135,369,1376,1745,573,2938,3511,58334,339094,397428,08/01/2014 12:00:00 AM,158,246,228
Central,Nottoway County,51135,374,1381,1755,580,2942,3522,59682,338903,398585,07/01/2014 12:00:00 AM,160,245,227
Central,Nottoway County,51135,375,1400,1775,593,2971,3564,58692,344000,402692,06/01/2014 12:00:00 AM,157,246,227
Central,Nottoway County,51135,375,1405,1780,601,2994,3595,57496,342691,400187,05/01/2014 12:00:00 AM,153,244,225
Central,Nottoway County,51135,379,1404,1783,613,2977,3590,60188,342594,402782,04/01/2014 12:00:00 AM,159,244,226
Central,Nottoway County,51135,383,1421,1804,617,3025,3642,67863,388434,456297,01/01/2012 12:00:00 AM,177,273,253
Central,Nottoway County,51135,383,1434,1817,624,3041,3665,63731,351039,414770,01/01/2014 12:00:00 AM,166,245,228
Central,Nottoway County,51135,383,1441,1824,618,3037,3655,64324,355651,419975,12/01/2013 12:00:00 AM,168,247,230
Central,Nottoway County,51135,383,1470,1853,604,3098,3702,68722,399656,468378,02/01/2013 12:00:00 AM,179,272,253
Central,Nottoway County,51135,385,1407,1792,629,2962,3591,63413,345417,408830,03/01/2014 12:00:00 AM,165,245,228
Central,Nottoway County,51135,386,1404,1790,622,3002,3624,69937,382594,452531,04/01/2012 12:00:00 AM,181,273,253
Central,Nottoway County,51135,386,1414,1800,617,3003,3620,68334,385315,453649,03/01/2012 12:00:00 AM,177,273,252
Central,Nottoway County,51135,386,1418,1804,632,3009,3641,64837,350882,415719,02/01/2014 12:00:00 AM,168,247,230
Central,Nottoway County,51135,387,1449,1836,625,3073,3698,65266,360478,425744,11/01/2013 12:00:00 AM,169,249,232
Central,Nottoway County,51135,388,1402,1790,627,2993,3620,70340,384122,454462,08/01/2012 12:00:00 AM,181,274,254
Central,Nottoway County,51135,388,1412,1800,622,3002,3624,68893,387731,456624,02/01/2012 12:00:00 AM,178,275,254
Central,Nottoway County,51135,388,1457,1845,613,3066,3679,69084,392021,461105,01/01/2013 12:00:00 AM,178,269,250
Central,Nottoway County,51135,389,1478,1867,616,3069,3685,69456,396980,466436,04/01/2013 12:00:00 AM,179,269,250
Central,Nottoway County,51135,390,1407,1797,633,2979,3612,72240,384837,457077,09/01/2012 12:00:00 AM,185,274,254
Central,Nottoway County,51135,391,1456,1847,622,3036,3658,71426,393954,465380,03/01/2013 12:00:00 AM,183,271,252
Central,Nottoway County,51135,391,1492,1883,617,3099,3716,69780,399445,469225,05/01/2013 12:00:00 AM,178,268,249
Central,Nottoway County,51135,393,1384,1777,638,2967,3605,72529,378921,451450,05/01/2012 12:00:00 AM,185,274,254
Central,Nottoway County,51135,393,1491,1884,622,3090,3712,71862,401980,473842,06/01/2013 12:00:00 AM,183,270,252
Central,Nottoway County,51135,395,1433,1828,637,3005,3642,74414,385408,459822,11/01/2012 12:00:00 AM,188,269,252
Central,Nottoway County,51135,396,1373,1769,660,2931,3591,75153,376168,451321,06/01/2012 12:00:00 AM,190,274,255
Central,Nottoway County,51135,396,1426,1822,651,2992,3643,74442,384533,458975,12/01/2012 12:00:00 AM,188,270,252
Central,Nottoway County,51135,396,1447,1843,648,3072,3720,74964,391291,466255,10/01/2013 12:00:00 AM,189,270,253
Central,Nottoway County,51135,398,1469,1867,642,3053,3695,73967,391131,465098,09/01/2013 12:00:00 AM,186,266,249
Central,Nottoway County,51135,398,1490,1888,643,3097,3740,73548,396062,469610,07/01/2013 12:00:00 AM,185,266,249
Central,Nottoway County,51135,399,1465,1864,648,3029,3677,74255,390342,464597,08/01/2013 12:00:00 AM,186,266,249
Central,Nottoway County,51135,402,1376,1778,671,2936,3607,77360,375700,453060,07/01/2012 12:00:00 AM,192,273,255
Central,Nottoway County,51135,403,1427,1830,658,3014,3672,76493,387501,463994,10/01/2012 12:00:00 AM,190,272,254
Central,Petersburg City,51730,1086,4091,5177,1498,7717,9215,335636,1687328,2022964,02/01/2021 12:00:00 AM,309,412,391
Central,Petersburg City,51730,1102,3914,5016,1571,7567,9138,180939,1031761,1212700,04/01/2017 12:00:00 AM,164,264,242
Central,Petersburg City,51730,1105,4068,5173,1545,7672,9217,342860,1675596,2018456,03/01/2021 12:00:00 AM,310,412,390
Central,Petersburg City,51730,1111,4032,5143,1572,7566,9138,378177,1816708,2194885,04/01/2021 12:00:00 AM,340,451,427
Central,Petersburg City,51730,1113,4045,5158,1576,7552,9128,377008,1826899,2203907,05/01/2021 12:00:00 AM,339,452,427
Central,Petersburg City,51730,1120,3926,5046,1602,7602,9204,185975,1048836,1234811,06/01/2017 12:00:00 AM,166,267,245
Central,Petersburg City,51730,1120,4006,5126,1577,7783,9360,181724,1070616,1252340,08/01/2017 12:00:00 AM,162,267,244
Central,Petersburg City,51730,1121,3899,5020,1579,7573,9152,181345,1032072,1213417,07/01/2017 12:00:00 AM,162,265,242
Central,Petersburg City,51730,1126,4001,5127,1593,7735,9328,182938,1049799,1232737,09/01/2017 12:00:00 AM,162,262,240
Central,Petersburg City,51730,1126,4027,5153,1595,7555,9150,354025,1624799,1978824,01/01/2021 12:00:00 AM,314,403,384
Central,Petersburg City,51730,1127,3922,5049,1603,7577,9180,186778,1032751,1219529,05/01/2017 12:00:00 AM,166,263,242
Central,Petersburg City,51730,1129,4004,5133,1643,7782,9425,187668,1031031,1218699,02/01/2017 12:00:00 AM,166,258,237
Central,Petersburg City,51730,1130,3953,5083,1614,7598,9212,190641,1032506,1223147,03/01/2017 12:00:00 AM,169,261,241
Central,Petersburg City,51730,1131,4005,5136,1588,7750,9338,184057,1056345,1240402,10/01/2017 12:00:00 AM,163,264,242
Central,Petersburg City,51730,1131,4123,5254,1597,7709,9306,377435,1864512,2241947,06/01/2021 12:00:00 AM,334,452,427
Central,Petersburg City,51730,1146,4130,5276,1641,7793,9434,313804,1448283,1762087,12/01/2020 12:00:00 AM,274,351,334
Central,Petersburg City,51730,1150,4031,5181,1633,7768,9401,191272,1062718,1253990,11/01/2017 12:00:00 AM,166,264,242
Central,Petersburg City,51730,1153,3879,5032,1650,7484,9134,186496,1007796,1194292,04/01/2018 12:00:00 AM,162,260,237
Central,Petersburg City,51730,1154,3881,5035,1648,7420,9068,297385,1305006,1602391,03/01/2020 12:00:00 AM,258,336,318
Central,Petersburg City,51730,1154,3993,5147,1653,7696,9349,191807,1034441.91,1226248.91,12/01/2017 12:00:00 AM,166,259,238
Central,Petersburg City,51730,1154,4144,5298,1662,7774,9436,319328,1480711,1800039,11/01/2020 12:00:00 AM,277,357,340
Central,Petersburg City,51730,1157,3887,5044,1661,7484,9145,192966,1011067,1204033,03/01/2018 12:00:00 AM,167,260,239
Central,Petersburg City,51730,1157,3995,5152,1714,7759,9473,198973,1017718,1216691,01/01/2017 12:00:00 AM,172,255,236
Central,Petersburg City,51730,1164,3956,5120,1647,7605,9252,187077,1019164,1206241,01/01/2018 12:00:00 AM,161,258,236
Central,Petersburg City,51730,1165,3859,5024,1635,7388,9023,183726,990467,1174193,01/01/2020 12:00:00 AM,158,257,234
Central,Petersburg City,51730,1166,3915,5081,1680,7571,9251,193748,1009101,1202849,05/01/2018 12:00:00 AM,166,258,237
Central,Petersburg City,51730,1166,3979,5145,1662,7666,9328,192659,1037586,1230245,02/01/2018 12:00:00 AM,165,261,239
Central,Petersburg City,51730,1169,3936,5105,1668,7579,9247,188341,1022302,1210643,06/01/2018 12:00:00 AM,161,260,237
Central,Petersburg City,51730,1172,4020,5192,1736,7834,9570,199346,1038262,1237608,12/01/2016 12:00:00 AM,170,258,238
Central,Petersburg City,51730,1174,3847,5021,1645,7365,9010,190576,997053,1187629,02/01/2020 12:00:00 AM,162,259,237
Central,Petersburg City,51730,1175,3933,5108,1684,7454,9138,200741,1007948,1208689,10/01/2018 12:00:00 AM,171,256,237
Central,Petersburg City,51730,1176,4291,5467,1656,8094,9750,302055,1434559,1736614,04/01/2020 12:00:00 AM,257,334,318
Central,Petersburg City,51730,1177,3900,5077,1676,7459,9135,195166,1001725,1196891,11/01/2019 12:00:00 AM,166,257,236
Central,Petersburg City,51730,1180,4018,5198,1761,7826,9587,206041,1029709,1235750,11/01/2016 12:00:00 AM,175,256,238
Central,Petersburg City,51730,1182,3750,4932,1673,7061,8734,193786,945251,1139037,02/01/2019 12:00:00 AM,164,252,231
Central,Petersburg City,51730,1182,3941,5123,1685,7434,9119,201334,1003923,1205257,11/01/2018 12:00:00 AM,170,255,235
Central,Petersburg City,51730,1182,4302,5484,1701,8029,9730,326972,1512291,1839263,10/01/2020 12:00:00 AM,277,352,335
Central,Petersburg City,51730,1185,3941,5126,1714,7540,9254,200701,1013880,1214581,09/01/2018 12:00:00 AM,169,257,237
Central,Petersburg City,51730,1188,3931,5119,1684,7416,9100,202340,1014363,1216703,12/01/2018 12:00:00 AM,170,258,238
Central,Petersburg City,51730,1189,3909,5098,1687,7518,9205,197535,1019691,1217226,12/01/2019 12:00:00 AM,166,261,239
Central,Petersburg City,51730,1190,3999,5189,1734,7575,9309,202693,1030977,1233670,08/01/2019 12:00:00 AM,170,258,238
Central,Petersburg City,51730,1193,3968,5161,1711,7494,9205,202968,1023121,1226089,10/01/2019 12:00:00 AM,170,258,238
Central,Petersburg City,51730,1193,4409,5602,1692,8201,9893,311727,1433866,1745593,09/01/2020 12:00:00 AM,261,325,312
Central,Petersburg City,51730,1194,3939,5133,1700,7391,9091,204692,1045589,1250281,01/01/2019 12:00:00 AM,171,265,244
Central,Petersburg City,51730,1195,4056,5251,1787,7890,9677,206544,1038572,1245116,10/01/2016 12:00:00 AM,173,256,237
Central,Petersburg City,51730,1196,3974,5170,1740,7663,9403,199506,1019843,1219349,08/01/2018 12:00:00 AM,167,257,236
Central,Petersburg City,51730,1201,3986,5187,1726,7460,9186,202636,1011996,1214632,07/01/2019 12:00:00 AM,169,254,234
Central,Petersburg City,51730,1201,4442,5643,1692,8319,10011,308336,1466349,1774685,05/01/2020 12:00:00 AM,257,330,314
Central,Petersburg City,51730,1202,3901,5103,1768,7507,9275,204750,1003166,1207916,07/01/2018 12:00:00 AM,170,257,237
Central,Petersburg City,51730,1203,4138,5341,1831,8008,9839,214066,1057799,1271865,07/01/2016 12:00:00 AM,178,256,238
Central,Petersburg City,51730,1204,4173,5377,1833,8033,9866,214596,1060355,1274951,08/01/2016 12:00:00 AM,178,254,237
Central,Petersburg City,51730,1206,4160,5366,1842,7955,9797,216030,1052609,1268639,06/01/2016 12:00:00 AM,179,253,236
Central,Petersburg City,51730,1208,3958,5166,1729,7460,9189,199536,1008704,1208240,05/01/2019 12:00:00 AM,165,255,234
Central,Petersburg City,51730,1208,4001,5209,1743,7557,9300,203777,1022561,1226338,09/01/2019 12:00:00 AM,169,256,235
Central,Petersburg City,51730,1210,3919,5129,1715,7459,9174,199058,1002721,1201779,04/01/2019 12:00:00 AM,165,256,234
Central,Petersburg City,51730,1211,3945,5156,1726,7451,9177,195470,990717,1186187,03/01/2019 12:00:00 AM,161,251,230
Central,Petersburg City,51730,1214,3970,5184,1730,7466,9196,200070,1009278,1209348,06/01/2019 12:00:00 AM,165,254,233
Central,Petersburg City,51730,1214,4133,5347,1830,7911,9741,214440,1049578,1264018,05/01/2016 12:00:00 AM,177,254,236
Central,Petersburg City,51730,1215,4109,5324,1815,7866,9681,208578,1040381,1248959,04/01/2016 12:00:00 AM,172,253,235
Central,Petersburg City,51730,1219,4115,5334,1856,7933,9789,215235,1043775,1259010,09/01/2016 12:00:00 AM,177,254,236
Central,Petersburg City,51730,1221,4444,5665,1734,8283,10017,315823,1452634,1768457,08/01/2020 12:00:00 AM,259,327,312
Central,Petersburg City,51730,1222,4105,5327,1859,7890,9749,213221,1045578,1258799,03/01/2016 12:00:00 AM,174,255,236
Central,Petersburg City,51730,1230,4118,5348,1889,7913,9802,212502,1040273,1252775,01/01/2016 12:00:00 AM,173,253,234
Central,Petersburg City,51730,1230,4540,5770,1747,8451,10198,320804,1500133,1820937,06/01/2020 12:00:00 AM,261,330,316
Central,Petersburg City,51730,1233,4056,5289,1892,7776,9668,215414,1030251,1245665,02/01/2016 12:00:00 AM,175,254,236
Central,Petersburg City,51730,1233,4231,5464,1905,8114,10019,215755,1068904,1284659,12/01/2015 12:00:00 AM,175,253,235
Central,Petersburg City,51730,1242,4590,5832,1764,8533,10297,323040,1514151,1837191,07/01/2020 12:00:00 AM,260,330,315
Central,Petersburg City,51730,1250,4298,5548,1934,8190,10124,220437,1088884,1309321,11/01/2015 12:00:00 AM,176,253,236
Central,Petersburg City,51730,1253,4399,5652,1933,8341,10274,219538,1105038,1324576,10/01/2015 12:00:00 AM,175,251,234
Central,Petersburg City,51730,1259,4431,5690,1925,8396,10321,220866,1117275,1338141,09/01/2015 12:00:00 AM,175,252,235
Central,Petersburg City,51730,1269,4458,5727,1953,8416,10369,223069,1116217,1339286,08/01/2015 12:00:00 AM,176,250,234
Central,Petersburg City,51730,1276,4688,5964,2025,8712,10737,241573,1216750,1458323,04/01/2012 12:00:00 AM,189,260,245
Central,Petersburg City,51730,1277,4420,5697,1973,8331,10304,224722,1108568,1333290,06/01/2015 12:00:00 AM,176,251,234
Central,Petersburg City,51730,1279,4384,5663,1978,8271,10249,227835,1101481,1329316,05/01/2015 12:00:00 AM,178,251,235
Central,Petersburg City,51730,1284,4318,5602,1979,8196,10175,226836,1091062,1317898,04/01/2015 12:00:00 AM,177,253,235
Central,Petersburg City,51730,1285,4431,5716,1978,8335,10313,225260,1111327,1336587,07/01/2015 12:00:00 AM,175,251,234
Central,Petersburg City,51730,1291,4677,5968,2088,8701,10789,250272,1208236,1458508,03/01/2012 12:00:00 AM,194,258,244
Central,Petersburg City,51730,1294,4271,5565,2022,8117,10139,229703,1083244,1312947,03/01/2015 12:00:00 AM,178,254,236
Central,Petersburg City,51730,1296,4682,5978,2107,8702,10809,254903,1205090,1459993,02/01/2012 12:00:00 AM,197,257,244
Central,Petersburg City,51730,1301,4652,5953,2140,8651,10791,259273,1181937,1441210,01/01/2012 12:00:00 AM,199,254,242
Central,Petersburg City,51730,1304,4742,6046,2095,8771,10866,251417,1226912,1478329,05/01/2012 12:00:00 AM,193,259,245
Central,Petersburg City,51730,1311,4780,6091,2097,8822,10919,253744,1235334,1489078,06/01/2012 12:00:00 AM,194,258,244
Central,Petersburg City,51730,1312,4422,5734,2086,8441,10527,233411,1073484,1306895,09/01/2014 12:00:00 AM,178,243,228
Central,Petersburg City,51730,1314,4822,6136,2082,8948,11030,248345,1252963,1501308,08/01/2012 12:00:00 AM,189,260,245
Central,Petersburg City,51730,1317,4256,5573,2081,8091,10172,240168,1072306,1312474,02/01/2015 12:00:00 AM,182,252,236
Central,Petersburg City,51730,1326,4376,5702,2118,8343,10461,250791,1115026,1365817,11/01/2014 12:00:00 AM,189,255,240
Central,Petersburg City,51730,1329,4385,5714,2139,8378,10517,252231,1117517,1369748,10/01/2014 12:00:00 AM,190,255,240
Central,Petersburg City,51730,1329,4783,6112,2121,8869,10990,256755,1238436,1495191,07/01/2012 12:00:00 AM,193,259,245
Central,Petersburg City,51730,1330,4824,6154,2072,8922,10994,231196,1148763,1379959,01/01/2014 12:00:00 AM,174,238,224
Central,Petersburg City,51730,1331,4499,5830,2125,8537,10662,235720,1098292,1334012,08/01/2014 12:00:00 AM,177,244,229
Central,Petersburg City,51730,1332,4799,6131,2096,8866,10962,248436,1243048,1491484,09/01/2012 12:00:00 AM,187,259,243
Central,Petersburg City,51730,1339,4562,5901,2120,8620,10740,236114,1097902,1334016,07/01/2014 12:00:00 AM,176,241,226
Central,Petersburg City,51730,1340,4314,5654,2141,8194,10335,250730,1089984,1340714,12/01/2014 12:00:00 AM,187,253,237
Central,Petersburg City,51730,1341,4840,6181,2091,8938,11029,236218,1150153,1386371,12/01/2013 12:00:00 AM,176,238,224
Central,Petersburg City,51730,1343,4727,6070,2110,8743,10853,232474,1122356,1354830,03/01/2014 12:00:00 AM,173,237,223
Central,Petersburg City,51730,1345,4728,6073,2128,8711,10839,237950,1133666,1371616,02/01/2014 12:00:00 AM,177,240,226
Central,Petersburg City,51730,1346,4740,6086,2146,8745,10891,240923,1129458,1370381,04/01/2014 12:00:00 AM,179,238,225
Central,Petersburg City,51730,1351,4291,5642,2124,8138,10262,244569,1073464,1318033,01/01/2015 12:00:00 AM,181,250,234
Central,Petersburg City,51730,1353,4834,6187,2136,8938,11074,260789,1249588,1510377,10/01/2012 12:00:00 AM,193,258,244
Central,Petersburg City,51730,1355,4624,5979,2146,8689,10835,240686,1122946,1363632,06/01/2014 12:00:00 AM,178,243,228
Central,Petersburg City,51730,1355,4768,6123,2139,8806,10945,261718,1222567,1484285,12/01/2012 12:00:00 AM,193,256,242
Central,Petersburg City,51730,1355,4843,6198,2145,8885,11030,262917,1268160,1531077,07/01/2013 12:00:00 AM,194,262,247
Central,Petersburg City,51730,1358,4695,6053,2143,8731,10874,238049,1130438,1368487,05/01/2014 12:00:00 AM,175,241,226
Central,Petersburg City,51730,1358,4839,6197,2169,8928,11097,264087,1247896,1511983,08/01/2013 12:00:00 AM,194,258,244
Central,Petersburg City,51730,1359,4798,6157,2143,8824,10967,255084,1219149,1474233,01/01/2013 12:00:00 AM,188,254,239
Central,Petersburg City,51730,1362,4811,6173,2159,8816,10975,255991,1226348,1482339,02/01/2013 12:00:00 AM,188,255,240
Central,Petersburg City,51730,1369,4870,6239,2127,9003,11130,241054,1165496,1406550,11/01/2013 12:00:00 AM,176,239,225
Central,Petersburg City,51730,1370,4795,6165,2186,8830,11016,269448,1228067,1497515,11/01/2012 12:00:00 AM,197,256,243
Central,Petersburg City,51730,1371,4801,6172,2215,8791,11006,267584,1222931,1490515,03/01/2013 12:00:00 AM,195,255,241
Central,Petersburg City,51730,1375,4779,6154,2210,8707,10917,267650,1219199,1486849,04/01/2013 12:00:00 AM,195,255,242
Central,Petersburg City,51730,1375,4797,6172,2226,8750,10976,285829,1260362,1546191,06/01/2013 12:00:00 AM,208,263,251
Central,Petersburg City,51730,1378,4804,6182,2237,8753,10990,274825,1222179,1497004,05/01/2013 12:00:00 AM,199,254,242
Central,Petersburg City,51730,1382,4876,6258,2227,8960,11187,271317,1256249,1527566,09/01/2013 12:00:00 AM,196,258,244
Central,Petersburg City,51730,1392,4882,6274,2209,8968,11177,270353,1260325,1530678,10/01/2013 12:00:00 AM,194,258,244
Central,Powhatan County,51145,100,504,604,143,1158,1301,13728,130704,144432,10/01/2014 12:00:00 AM,137,259,239
Central,Powhatan County,51145,101,518,619,146,1188,1334,12172,128468,140640,09/01/2014 12:00:00 AM,121,248,227
Central,Powhatan County,51145,101,598,699,153,1374,1527,13725,150711,164436,01/01/2014 12:00:00 AM,136,252,235
Central,Powhatan County,51145,103,539,642,151,1234,1385,13568,137491,151059,07/01/2014 12:00:00 AM,132,255,235
Central,Powhatan County,51145,103,545,648,155,1249,1404,14224,137750,151974,03/01/2014 12:00:00 AM,138,253,235
Central,Powhatan County,51145,104,536,640,158,1228,1386,14281,135025,149306,06/01/2014 12:00:00 AM,137,252,233
Central,Powhatan County,51145,105,571,676,164,1304,1468,15999,143956,159955,02/01/2014 12:00:00 AM,152,252,237
Central,Powhatan County,51145,107,541,648,166,1242,1408,15695,135786,151481,04/01/2014 12:00:00 AM,147,251,234
Central,Powhatan County,51145,107,597,704,167,1383,1550,15413,152423,167836,12/01/2013 12:00:00 AM,144,255,238
Central,Powhatan County,51145,107,608,715,156,1399,1555,17658,177996,195654,03/01/2012 12:00:00 AM,165,293,274
Central,Powhatan County,51145,109,530,639,164,1212,1376,14930,133484,148414,05/01/2014 12:00:00 AM,137,252,232
Central,Powhatan County,51145,109,595,704,162,1362,1524,17458,164863,182321,10/01/2013 12:00:00 AM,160,277,259
Central,Powhatan County,51145,109,615,724,159,1450,1609,17984,182638,200622,06/01/2013 12:00:00 AM,165,297,277
Central,Powhatan County,51145,110,595,705,171,1370,1541,17040,151387,168427,11/01/2013 12:00:00 AM,155,254,239
Central,Powhatan County,51145,110,605,715,163,1417,1580,18363,176720,195083,07/01/2013 12:00:00 AM,167,292,273
Central,Powhatan County,51145,111,612,723,166,1408,1574,18949,178486,197435,04/01/2012 12:00:00 AM,171,292,273
Central,Powhatan County,51145,112,602,714,171,1366,1537,19779,173497,193276,01/01/2012 12:00:00 AM,177,288,271
Central,Powhatan County,51145,113,594,707,177,1385,1562,20440,168854,189294,09/01/2013 12:00:00 AM,181,284,268
Central,Powhatan County,51145,113,619,732,163,1397,1560,18001,174972,192973,10/01/2012 12:00:00 AM,159,283,264
Central,Powhatan County,51145,114,593,707,177,1382,1559,20564,168730,189294,08/01/2013 12:00:00 AM,180,285,268
Central,Powhatan County,51145,114,619,733,168,1442,1610,19161,181641,200802,05/01/2013 12:00:00 AM,168,293,274
Central,Powhatan County,51145,115,606,721,169,1384,1553,19756,172513,192269,07/01/2012 12:00:00 AM,172,285,267
Central,Powhatan County,51145,115,617,732,175,1403,1578,20173,176553,196726,05/01/2012 12:00:00 AM,175,286,269
Central,Powhatan County,51145,116,606,722,174,1376,1550,19957,171680,191637,06/01/2012 12:00:00 AM,172,283,265
Central,Powhatan County,51145,116,611,727,171,1398,1569,19829,178775,198604,02/01/2012 12:00:00 AM,171,293,273
Central,Powhatan County,51145,116,627,743,168,1424,1592,18753,176123,194876,11/01/2012 12:00:00 AM,162,281,262
Central,Powhatan County,51145,116,629,745,165,1432,1597,18494,178430,196924,12/01/2012 12:00:00 AM,159,284,264
Central,Powhatan County,51145,117,620,737,170,1443,1613,19354,181607,200961,04/01/2013 12:00:00 AM,165,293,273
Central,Powhatan County,51145,118,608,726,181,1386,1567,20786,170839,191625,08/01/2012 12:00:00 AM,176,281,264
Central,Powhatan County,51145,118,627,745,167,1448,1615,18262,179312,197574,01/01/2013 12:00:00 AM,155,286,265
Central,Powhatan County,51145,119,607,726,180,1364,1544,21723,170248,191971,09/01/2012 12:00:00 AM,183,280,264
Central,Powhatan County,51145,121,617,738,184,1419,1603,21559,178654,200213,03/01/2013 12:00:00 AM,178,290,271
Central,Powhatan County,51145,123,630,753,181,1458,1639,20713,182856,203569,02/01/2013 12:00:00 AM,168,290,270
Central,Powhatan County,51145,78,464,542,96,1036,1132,22653,234752,257405,04/01/2021 12:00:00 AM,290,506,475
Central,Powhatan County,51145,79,488,567,91,1087,1178,21292,223496,244788,02/01/2021 12:00:00 AM,270,458,432
Central,Powhatan County,51145,80,402,482,102,894,996,9164,105061,114225,06/01/2019 12:00:00 AM,115,261,237
Central,Powhatan County,51145,80,427,507,110,988,1098,10757,111811,122568,02/01/2020 12:00:00 AM,134,262,242
Central,Powhatan County,51145,80,435,515,104,1006,1110,18953,172898,191851,03/01/2020 12:00:00 AM,237,397,373
Central,Powhatan County,51145,80,474,554,94,1060,1154,21314,220153,241467,03/01/2021 12:00:00 AM,266,464,436
Central,Powhatan County,51145,81,422,503,110,958,1068,10519,107614,118133,01/01/2020 12:00:00 AM,130,255,235
Central,Powhatan County,51145,81,490,571,101,1097,1198,22635,229425,252060,01/01/2021 12:00:00 AM,279,468,441
Central,Powhatan County,51145,82,394,476,106,878,984,9822,102088,111910,05/01/2019 12:00:00 AM,120,259,235
Central,Powhatan County,51145,82,401,483,101,912,1013,9112,105739,114851,04/01/2019 12:00:00 AM,111,264,238
Central,Powhatan County,51145,82,413,495,108,904,1012,10768,104629,115397,07/01/2019 12:00:00 AM,131,253,233
Central,Powhatan County,51145,82,452,534,106,1004,1110,25080,223233,248313,05/01/2021 12:00:00 AM,306,494,465
Central,Powhatan County,51145,82,459,541,106,1013,1119,25158,231852,257010,06/01/2021 12:00:00 AM,307,505,475
Central,Powhatan County,51145,82,485,567,105,1123,1228,19317,191698,211015,04/01/2020 12:00:00 AM,236,395,372
Central,Powhatan County,51145,82,489,571,105,1132,1237,19615,192696,212311,05/01/2020 12:00:00 AM,239,394,372
Central,Powhatan County,51145,82,496,578,107,1148,1255,19912,194613,214525,09/01/2020 12:00:00 AM,243,392,371
Central,Powhatan County,51145,83,383,466,100,864,964,9477,99902,109379,02/01/2019 12:00:00 AM,114,261,235
Central,Powhatan County,51145,83,410,493,107,918,1025,10170,106112,116282,08/01/2019 12:00:00 AM,123,259,236
Central,Powhatan County,51145,83,499,582,105,1143,1248,19270,194914,214184,08/01/2020 12:00:00 AM,232,391,368
Central,Powhatan County,51145,84,440,524,115,998,1113,11642,110807,122449,10/01/2019 12:00:00 AM,139,252,234
Central,Powhatan County,51145,84,497,581,109,1155,1264,20061,196916,216977,07/01/2020 12:00:00 AM,239,396,373
Central,Powhatan County,51145,84,498,582,107,1154,1261,19874,196078,215952,06/01/2020 12:00:00 AM,237,394,371
Central,Powhatan County,51145,85,435,520,116,983,1099,11870,112079,123949,12/01/2019 12:00:00 AM,140,258,238
Central,Powhatan County,51145,85,486,571,112,1098,1210,21811,203023,224834,11/01/2020 12:00:00 AM,257,418,394
Central,Powhatan County,51145,85,496,581,112,1117,1229,21773,202375,224148,12/01/2020 12:00:00 AM,256,408,386
Central,Powhatan County,51145,86,416,502,107,939,1046,10314,115116,125430,01/01/2019 12:00:00 AM,120,277,250
Central,Powhatan County,51145,86,429,515,113,1012,1125,12267,117207,129474,09/01/2017 12:00:00 AM,143,273,251
Central,Powhatan County,51145,86,446,532,114,1040,1154,10978,119061,130039,08/01/2016 12:00:00 AM,128,267,244
Central,Powhatan County,51145,86,453,539,120,1049,1169,12185,119899,132084,04/01/2016 12:00:00 AM,142,265,245
Central,Powhatan County,51145,86,481,567,113,1113,1226,21736,198583,220319,10/01/2020 12:00:00 AM,253,413,389
Central,Powhatan County,51145,87,398,485,108,898,1006,10464,104244,114708,03/01/2019 12:00:00 AM,120,262,237
Central,Powhatan County,51145,87,418,505,107,945,1052,10006,112409,122415,10/01/2018 12:00:00 AM,115,269,242
Central,Powhatan County,51145,87,425,512,109,965,1074,10491,111549,122040,11/01/2018 12:00:00 AM,121,262,238
Central,Powhatan County,51145,87,436,523,117,1033,1150,10961,118866,129827,07/01/2016 12:00:00 AM,126,273,248
Central,Powhatan County,51145,87,439,526,119,992,1111,12066,113317,125383,11/01/2019 12:00:00 AM,139,258,238
Central,Powhatan County,51145,87,451,538,118,1043,1161,11889,118495,130384,09/01/2016 12:00:00 AM,137,263,242
Central,Powhatan County,51145,87,452,539,125,1038,1163,12602,121168,133770,05/01/2016 12:00:00 AM,145,268,248
Central,Powhatan County,51145,87,456,543,110,1067,1177,10169,120752,130921,12/01/2015 12:00:00 AM,117,265,241
Central,Powhatan County,51145,87,464,551,114,1094,1208,10852,124709,135561,02/01/2016 12:00:00 AM,125,269,246
Central,Powhatan County,51145,88,412,500,109,938,1047,10501,109478,119979,12/01/2018 12:00:00 AM,119,266,240
Central,Powhatan County,51145,88,414,502,114,978,1092,19690,109933,129623,10/01/2017 12:00:00 AM,224,266,258
Central,Powhatan County,51145,88,420,508,107,930,1037,10608,109411,120019,09/01/2018 12:00:00 AM,121,261,236
Central,Powhatan County,51145,88,427,515,108,958,1066,10661,110161,120822,08/01/2018 12:00:00 AM,121,258,235
Central,Powhatan County,51145,88,436,524,110,974,1084,11324,113393,124717,07/01/2018 12:00:00 AM,129,260,238
Central,Powhatan County,51145,88,448,536,117,1038,1155,11337,120709,132046,03/01/2016 12:00:00 AM,129,269,246
Central,Powhatan County,51145,88,452,540,115,1060,1175,10900,119561,130461,01/01/2016 12:00:00 AM,124,265,242
Central,Powhatan County,51145,88,500,588,125,1145,1270,12213,131088,143301,05/01/2015 12:00:00 AM,139,262,244
Central,Powhatan County,51145,89,418,507,111,962,1073,10160,111273,121433,01/01/2018 12:00:00 AM,114,266,240
Central,Powhatan County,51145,89,418,507,117,972,1089,12589,113851,126440,08/01/2017 12:00:00 AM,141,272,249
Central,Powhatan County,51145,89,426,515,117,954,1071,11441,107490,118931,09/01/2019 12:00:00 AM,129,252,231
Central,Powhatan County,51145,89,447,536,129,1034,1163,12900,119278,132178,06/01/2016 12:00:00 AM,145,267,247
Central,Powhatan County,51145,90,419,509,111,966,1077,10184,111240,121424,02/01/2018 12:00:00 AM,113,265,239
Central,Powhatan County,51145,90,437,527,125,1013,1138,12441,114128,126569,10/01/2016 12:00:00 AM,138,261,240
Central,Powhatan County,51145,91,410,501,116,944,1060,12761,106470,119231,12/01/2017 12:00:00 AM,140,260,238
Central,Powhatan County,51145,91,426,517,117,965,1082,11144,111556,122700,03/01/2018 12:00:00 AM,122,262,237
Central,Powhatan County,51145,91,427,518,117,966,1083,11275,114034,125309,04/01/2018 12:00:00 AM,124,267,242
Central,Powhatan County,51145,91,437,528,110,993,1103,10532,113778,124310,06/01/2018 12:00:00 AM,116,260,235
Central,Powhatan County,51145,91,440,531,115,1014,1129,10870,112871,123741,12/01/2016 12:00:00 AM,119,257,233
Central,Powhatan County,51145,91,462,553,121,1061,1182,11438,120405,131843,11/01/2015 12:00:00 AM,126,261,238
Central,Powhatan County,51145,91,470,561,127,1079,1206,12423,119335,131758,10/01/2015 12:00:00 AM,137,254,235
Central,Powhatan County,51145,91,480,571,127,1106,1233,12731,123614,136345,07/01/2015 12:00:00 AM,140,258,239
Central,Powhatan County,51145,91,483,574,131,1099,1230,13679,123749,137428,06/01/2015 12:00:00 AM,150,256,239
Central,Powhatan County,51145,92,426,518,114,961,1075,11564,113922,125486,05/01/2018 12:00:00 AM,126,267,242
Central,Powhatan County,51145,93,420,513,121,976,1097,13246,112431,125677,11/01/2017 12:00:00 AM,142,268,245
Central,Powhatan County,51145,93,469,562,128,1090,1218,12746,121559,134305,09/01/2015 12:00:00 AM,137,259,239
Central,Powhatan County,51145,93,483,576,125,1127,1252,12640,130796,143436,08/01/2015 12:00:00 AM,136,271,249
Central,Powhatan County,51145,93,493,586,125,1145,1270,11519,129345,140864,02/01/2015 12:00:00 AM,124,262,240
Central,Powhatan County,51145,93,498,591,135,1130,1265,13358,128886,142244,03/01/2015 12:00:00 AM,144,259,241
Central,Powhatan County,51145,94,419,513,120,968,1088,13162,110786,123948,05/01/2017 12:00:00 AM,140,264,242
Central,Powhatan County,51145,94,446,540,129,1025,1154,12313,115783,128096,11/01/2016 12:00:00 AM,131,260,237
Central,Powhatan County,51145,94,507,601,124,1178,1302,10909,130855,141764,01/01/2015 12:00:00 AM,116,258,236
Central,Powhatan County,51145,95,421,516,121,988,1109,13220,116206,129426,07/01/2017 12:00:00 AM,139,276,251
Central,Powhatan County,51145,95,430,525,120,992,1112,11452,113424,124876,02/01/2017 12:00:00 AM,121,264,238
Central,Powhatan County,51145,95,430,525,121,991,1112,13011,116730,129741,06/01/2017 12:00:00 AM,137,271,247
Central,Powhatan County,51145,95,437,532,117,989,1106,11911,115008,126919,03/01/2017 12:00:00 AM,125,263,239
Central,Powhatan County,51145,96,430,526,124,1009,1133,11852,110585,122437,01/01/2017 12:00:00 AM,123,257,233
Central,Powhatan County,51145,97,431,528,120,988,1108,12638,113072,125710,04/01/2017 12:00:00 AM,130,262,238
Central,Powhatan County,51145,97,496,593,147,1138,1285,15212,131098,146310,04/01/2015 12:00:00 AM,157,264,247
Central,Powhatan County,51145,97,504,601,128,1175,1303,11703,130634,142337,12/01/2014 12:00:00 AM,121,259,237
Central,Powhatan County,51145,99,492,591,138,1136,1274,12738,126986,139724,11/01/2014 12:00:00 AM,129,258,236
Central,Powhatan County,51145,99,534,633,142,1224,1366,11786,134033,145819,08/01/2014 12:00:00 AM,119,251,230
Central,Prince Edward County,51147,326,1212,1538,390,2572,2962,93380,577393,670773,04/01/2021 12:00:00 AM,286,476,436
Central,Prince Edward County,51147,327,1222,1549,379,2603,2982,86894.92,553729,640623.92,03/01/2021 12:00:00 AM,266,453,414
Central,Prince Edward County,51147,328,1202,1530,379,2551,2930,88384,547486.93,635870.93,02/01/2021 12:00:00 AM,269,455,416
Central,Prince Edward County,51147,329,1107,1436,403,2426,2829,33348,271511,304859,02/01/2020 12:00:00 AM,101,245,212
Central,Prince Edward County,51147,329,1120,1449,403,2446,2849,75013,415609,490622,03/01/2020 12:00:00 AM,228,371,339
Central,Prince Edward County,51147,331,1176,1507,402,2514,2916,75004,431498,506502,04/01/2020 12:00:00 AM,227,367,336
Central,Prince Edward County,51147,332,1112,1444,402,2448,2850,33424,278993,312417,11/01/2019 12:00:00 AM,101,251,216
Central,Prince Edward County,51147,332,1114,1446,412,2436,2848,34793,274542,309335,12/01/2019 12:00:00 AM,105,246,214
Central,Prince Edward County,51147,332,1184,1516,399,2506,2905,94322,565806,660128,05/01/2021 12:00:00 AM,284,478,435
Central,Prince Edward County,51147,333,1115,1448,398,2445,2843,33415,276337,309752,10/01/2019 12:00:00 AM,100,248,214
Central,Prince Edward County,51147,334,1124,1458,413,2446,2859,34027,274753,308780,01/01/2020 12:00:00 AM,102,244,212
Central,Prince Edward County,51147,334,1181,1515,408,2488,2896,92320,524840,617160,01/01/2021 12:00:00 AM,276,444,407
Central,Prince Edward County,51147,335,1122,1457,398,2445,2843,33566,276938,310504,08/01/2019 12:00:00 AM,100,247,213
Central,Prince Edward County,51147,337,1118,1455,428,2431,2859,34798,277953,312751,05/01/2019 12:00:00 AM,103,249,215
Central,Prince Edward County,51147,337,1122,1459,402,2461,2863,34119,280268,314387,09/01/2019 12:00:00 AM,101,250,215
Central,Prince Edward County,51147,337,1202,1539,404,2537,2941,95416,567452,662868,06/01/2021 12:00:00 AM,283,472,431
Central,Prince Edward County,51147,338,1211,1549,414,2579,2993,77254,441797,519051,05/01/2020 12:00:00 AM,229,365,335
Central,Prince Edward County,51147,340,1195,1535,428,2492,2920,81562,449894,531456,12/01/2020 12:00:00 AM,240,376,346
Central,Prince Edward County,51147,341,1194,1535,418,2532,2950,82343,465357,547700,11/01/2020 12:00:00 AM,241,390,357
Central,Prince Edward County,51147,342,1115,1457,422,2415,2837,36073,278369,314442,07/01/2019 12:00:00 AM,105,250,216
Central,Prince Edward County,51147,343,1212,1555,422,2595,3017,83447,468979,552426,10/01/2020 12:00:00 AM,243,387,355
Central,Prince Edward County,51147,343,1225,1568,430,2630,3060,79023,454583,533606,09/01/2020 12:00:00 AM,230,371,340
Central,Prince Edward County,51147,344,1067,1411,450,2342,2792,40429,261449,301878,02/01/2019 12:00:00 AM,118,245,214
Central,Prince Edward County,51147,344,1216,1560,421,2571,2992,79047,447665,526712,06/01/2020 12:00:00 AM,230,368,338
Central,Prince Edward County,51147,344,1239,1583,423,2636,3059,78675,452033,530708,07/01/2020 12:00:00 AM,229,365,335
Central,Prince Edward County,51147,345,1109,1454,448,2477,2925,39285,275353,314638,03/01/2019 12:00:00 AM,114,248,216
Central,Prince Edward County,51147,345,1121,1466,443,2463,2906,37926,279360,317286,04/01/2019 12:00:00 AM,110,249,216
Central,Prince Edward County,51147,346,1129,1475,429,2440,2869,36321,280594,316915,06/01/2019 12:00:00 AM,105,249,215
Central,Prince Edward County,51147,346,1232,1578,459,2753,3212,41343,314695,356038,02/01/2017 12:00:00 AM,119,255,226
Central,Prince Edward County,51147,347,1253,1600,456,2798,3254,40918,318889,359807,01/01/2017 12:00:00 AM,118,255,225
Central,Prince Edward County,51147,347,1261,1608,472,2821,3293,40060,323906,363966,08/01/2016 12:00:00 AM,115,257,226
Central,Prince Edward County,51147,348,1238,1586,433,2641,3074,81384,450664,532048,08/01/2020 12:00:00 AM,234,364,335
Central,Prince Edward County,51147,348,1251,1599,483,2789,3272,42943,319653,362596,09/01/2016 12:00:00 AM,123,256,227
Central,Prince Edward County,51147,349,1229,1578,473,2756,3229,42692,314648,357340,12/01/2016 12:00:00 AM,122,256,226
Central,Prince Edward County,51147,350,1250,1600,474,2803,3277,40519,318782,359301,07/01/2016 12:00:00 AM,116,255,225
Central,Prince Edward County,51147,351,1233,1584,483,2789,3272,43601,320290,363891,11/01/2016 12:00:00 AM,124,260,230
Central,Prince Edward County,51147,354,1127,1481,466,2513,2979,42883,300268,343151,01/01/2019 12:00:00 AM,121,266,232
Central,Prince Edward County,51147,354,1246,1600,490,2774,3264,42938,318186,361124,10/01/2016 12:00:00 AM,121,255,226
Central,Prince Edward County,51147,355,1259,1614,480,2804,3284,40106,319515,359621,06/01/2016 12:00:00 AM,113,254,223
Central,Prince Edward County,51147,357,1124,1481,472,2488,2960,44260,278421,322681,12/01/2018 12:00:00 AM,124,248,218
Central,Prince Edward County,51147,358,1272,1630,501,2802,3303,42556,318516,361072,02/01/2016 12:00:00 AM,119,250,222
Central,Prince Edward County,51147,360,1192,1552,492,2690,3182,44440,308107,352547,03/01/2017 12:00:00 AM,123,258,227
Central,Prince Edward County,51147,362,1120,1482,470,2481,2951,42997,281138,324135,11/01/2018 12:00:00 AM,119,251,219
Central,Prince Edward County,51147,362,1122,1484,477,2469,2946,50167,329528.73,379695.73,10/01/2018 12:00:00 AM,139,294,256
Central,Prince Edward County,51147,362,1126,1488,483,2498,2981,43018,279563,322581,09/01/2018 12:00:00 AM,119,248,217
Central,Prince Edward County,51147,363,1263,1626,496,2789,3285,43744,320325,364069,04/01/2016 12:00:00 AM,121,254,224
Central,Prince Edward County,51147,365,1126,1491,491,2493,2984,43769,280084,323853,08/01/2018 12:00:00 AM,120,249,217
Central,Prince Edward County,51147,365,1266,1631,494,2802,3296,42606,317420,360026,05/01/2016 12:00:00 AM,117,251,221
Central,Prince Edward County,51147,366,1271,1637,512,2813,3325,43641,321399,365040,03/01/2016 12:00:00 AM,119,253,223
Central,Prince Edward County,51147,368,1123,1491,493,2479,2972,43767,281307,325074,07/01/2018 12:00:00 AM,119,250,218
Central,Prince Edward County,51147,370,1287,1657,524,2849,3373,46890,324338,371228,01/01/2016 12:00:00 AM,127,252,224
Central,Prince Edward County,51147,371,1189,1560,500,2667,3167,46019,308584,354603,04/01/2017 12:00:00 AM,124,260,227
Central,Prince Edward County,51147,372,1127,1499,482,2537,3019,40586,282546,323132,05/01/2018 12:00:00 AM,109,251,216
Central,Prince Edward County,51147,372,1130,1502,491,2530,3021,42242,285446,327688,06/01/2018 12:00:00 AM,114,253,218
Central,Prince Edward County,51147,373,1180,1553,507,2662,3169,47992,308330,356322,05/01/2017 12:00:00 AM,129,261,229
Central,Prince Edward County,51147,373,1294,1667,529,2855,3384,47696,322981,370677,12/01/2015 12:00:00 AM,128,250,222
Central,Prince Edward County,51147,375,1118,1493,494,2505,2999,42137,276858,318995,04/01/2018 12:00:00 AM,112,248,214
Central,Prince Edward County,51147,377,1119,1496,504,2512,3016,44265,277810,322075,03/01/2018 12:00:00 AM,117,248,215
Central,Prince Edward County,51147,377,1302,1679,518,2890,3408,44718,325482,370200,10/01/2015 12:00:00 AM,119,250,220
Central,Prince Edward County,51147,378,1157,1535,509,2639,3148,45190,308752,353942,07/01/2017 12:00:00 AM,120,267,231
Central,Prince Edward County,51147,379,1303,1682,528,2899,3427,46263,332106,378369,11/01/2015 12:00:00 AM,122,255,225
Central,Prince Edward County,51147,380,1166,1546,513,2631,3144,46344,302874,349218,06/01/2017 12:00:00 AM,122,260,226
Central,Prince Edward County,51147,382,1153,1535,511,2618,3129,44201,304619,348820,08/01/2017 12:00:00 AM,116,264,227
Central,Prince Edward County,51147,384,1131,1515,516,2556,3072,45898,285484,331382,02/01/2018 12:00:00 AM,120,252,219
Central,Prince Edward County,51147,385,1319,1704,535,2960,3495,46502,343912,390414,08/01/2015 12:00:00 AM,121,261,229
Central,Prince Edward County,51147,387,1312,1699,537,2938,3475,47450,337504,384954,09/01/2015 12:00:00 AM,123,257,227
Central,Prince Edward County,51147,388,1150,1538,511,2610,3121,43650,302982,346632,09/01/2017 12:00:00 AM,113,263,225
Central,Prince Edward County,51147,390,1122,1512,522,2546,3068,46926,284447,331373,11/01/2017 12:00:00 AM,120,254,219
Central,Prince Edward County,51147,390,1142,1532,520,2586,3106,46425,295855,342280,10/01/2017 12:00:00 AM,119,259,223
Central,Prince Edward County,51147,390,1327,1717,547,2916,3463,50246,334143,384389,01/01/2015 12:00:00 AM,129,252,224
Central,Prince Edward County,51147,391,1132,1523,525,2576,3101,44467,288915,333382,01/01/2018 12:00:00 AM,114,255,219
Central,Prince Edward County,51147,392,1124,1516,526,2557,3083,47066,283316,330382,12/01/2017 12:00:00 AM,120,252,218
Central,Prince Edward County,51147,392,1365,1757,600,3054,3654,57219,367459,424678,04/01/2012 12:00:00 AM,146,269,242
Central,Prince Edward County,51147,393,1317,1710,556,2937,3493,52618,334837,387455,04/01/2015 12:00:00 AM,134,254,227
Central,Prince Edward County,51147,393,1335,1728,545,2969,3514,50570,335396,385966,03/01/2015 12:00:00 AM,129,251,223
Central,Prince Edward County,51147,393,1369,1762,609,3047,3656,60686,367967,428653,05/01/2012 12:00:00 AM,154,269,243
Central,Prince Edward County,51147,393,1376,1769,589,3102,3691,57490,376512,434002,01/01/2012 12:00:00 AM,146,274,245
Central,Prince Edward County,51147,393,1384,1777,602,3069,3671,59899,370626,430525,06/01/2012 12:00:00 AM,152,268,242
Central,Prince Edward County,51147,394,1382,1776,593,3118,3711,59422,378164,437586,02/01/2012 12:00:00 AM,151,274,246
Central,Prince Edward County,51147,395,1318,1713,558,2917,3475,52721,334687,387408,02/01/2015 12:00:00 AM,133,254,226
Central,Prince Edward County,51147,395,1322,1717,554,2974,3528,48849,340318,389167,07/01/2015 12:00:00 AM,124,257,227
Central,Prince Edward County,51147,398,1384,1782,608,3086,3694,60397,372699,433096,07/01/2012 12:00:00 AM,152,269,243
Central,Prince Edward County,51147,399,1303,1702,554,2907,3461,48908,335374,384282,06/01/2015 12:00:00 AM,123,257,226
Central,Prince Edward County,51147,399,1330,1729,590,2950,3540,51233,331567,382800,07/01/2014 12:00:00 AM,128,249,221
Central,Prince Edward County,51147,399,1376,1775,606,3120,3726,60009,373161,433170,03/01/2012 12:00:00 AM,150,271,244
Central,Prince Edward County,51147,399,1380,1779,580,3047,3627,48978,340239,389217,05/01/2014 12:00:00 AM,123,247,219
Central,Prince Edward County,51147,400,1309,1709,569,2921,3490,53353,335645,388998,05/01/2015 12:00:00 AM,133,256,228
Central,Prince Edward County,51147,401,1354,1755,586,3021,3607,49105,336114,385219,06/01/2014 12:00:00 AM,122,248,219
Central,Prince Edward County,51147,403,1398,1801,629,3121,3750,62737,374479,437216,08/01/2012 12:00:00 AM,156,268,243
Central,Prince Edward County,51147,403,1409,1812,625,3115,3740,64370,367397,431767,03/01/2013 12:00:00 AM,160,261,238
Central,Prince Edward County,51147,403,1444,1847,599,3161,3760,50883,358531,409414,11/01/2013 12:00:00 AM,126,248,222
Central,Prince Edward County,51147,404,1317,1721,589,2923,3512,52799,324039,376838,08/01/2014 12:00:00 AM,131,246,219
Central,Prince Edward County,51147,405,1397,1802,627,3099,3726,61367,375150,436517,09/01/2012 12:00:00 AM,152,269,242
Central,Prince Edward County,51147,405,1426,1831,607,3113,3720,50718,348592,399310,01/01/2014 12:00:00 AM,125,244,218
Central,Prince Edward County,51147,407,1291,1698,586,2849,3435,52284,314004,366288,09/01/2014 12:00:00 AM,128,243,216
Central,Prince Edward County,51147,407,1421,1828,613,3154,3767,61710,381589,443299,10/01/2012 12:00:00 AM,152,269,243
Central,Prince Edward County,51147,407,1426,1833,604,3130,3734,51054,350694,401748,03/01/2014 12:00:00 AM,125,246,219
Central,Prince Edward County,51147,408,1404,1812,630,3127,3757,65618,374481,440099,02/01/2013 12:00:00 AM,161,267,243
Central,Prince Edward County,51147,408,1413,1821,614,3132,3746,62332,375770,438102,11/01/2012 12:00:00 AM,153,266,241
Central,Prince Edward County,51147,409,1434,1843,612,3138,3750,49910,351224,401134,12/01/2013 12:00:00 AM,122,245,218
Central,Prince Edward County,51147,410,1300,1710,587,2853,3440,57087,326626,383713,10/01/2014 12:00:00 AM,139,251,224
Central,Prince Edward County,51147,411,1425,1836,618,3129,3747,52635,352841,405476,02/01/2014 12:00:00 AM,128,248,221
Central,Prince Edward County,51147,412,1304,1716,596,2868,3464,57996,329604,387600,11/01/2014 12:00:00 AM,141,253,226
Central,Prince Edward County,51147,412,1313,1725,603,2871,3474,58784,327241,386025,12/01/2014 12:00:00 AM,143,249,224
Central,Prince Edward County,51147,412,1412,1824,604,3093,3697,51414,347509,398923,04/01/2014 12:00:00 AM,125,246,219
Central,Prince Edward County,51147,414,1402,1816,634,3109,3743,65357,372660,438017,12/01/2012 12:00:00 AM,158,266,241
Central,Prince Edward County,51147,414,1417,1831,649,3148,3797,65192,372673,437865,04/01/2013 12:00:00 AM,157,263,239
Central,Prince Edward County,51147,414,1460,1874,653,3185,3838,64672,390307,454979,08/01/2013 12:00:00 AM,156,267,243
Central,Prince Edward County,51147,414,1462,1876,654,3238,3892,65277,400221,465498,06/01/2013 12:00:00 AM,158,274,248
Central,Prince Edward County,51147,415,1405,1820,654,3115,3769,67534,370506,438040,01/01/2013 12:00:00 AM,163,264,241
Central,Prince Edward County,51147,416,1448,1864,652,3210,3862,64586,383851,448437,05/01/2013 12:00:00 AM,155,265,241
Central,Prince Edward County,51147,418,1450,1868,632,3160,3792,61402,387245,448647,10/01/2013 12:00:00 AM,147,267,240
Central,Prince Edward County,51147,418,1466,1884,665,3230,3895,66888,393984,460872,07/01/2013 12:00:00 AM,160,269,245
Central,Prince Edward County,51147,419,1445,1864,654,3147,3801,63935,385745,449680,09/01/2013 12:00:00 AM,153,267,241
Central,Richmond City,51760,4003,14203,18206,5676,28835,34511,614577,3823740.32,4438317.32,02/01/2020 12:00:00 AM,154,269,244
Central,Richmond City,51760,4004,14321,18325,5723,29112,34835,619688,3837060.5,4456748.5,01/01/2020 12:00:00 AM,155,268,243
Central,Richmond City,51760,4026,18137,22163,5507,34756,40263,1238761,7550893,8789654,02/01/2021 12:00:00 AM,308,416,397
Central,Richmond City,51760,4029,14413,18442,5770,29141,34911,1049905,5089009,6138914,03/01/2020 12:00:00 AM,261,353,333
Central,Richmond City,51760,4091,14530,18621,5832,29484,35316,641955,3899419,4541374,12/01/2019 12:00:00 AM,157,268,244
Central,Richmond City,51760,4103,14550,18653,5827,29666,35493,645017,3922626.01,4567643.01,10/01/2019 12:00:00 AM,157,270,245
Central,Richmond City,51760,4108,13836,17944,5794,28392,34186,639238,3754607,4393845,02/01/2019 12:00:00 AM,156,271,245
Central,Richmond City,51760,4113,14560,18673,5852,29721,35573,646596,3906592.93,4553188.93,11/01/2019 12:00:00 AM,157,268,244
Central,Richmond City,51760,4140,14603,18743,5884,29889,35773,651717,3972323,4624040,09/01/2019 12:00:00 AM,157,272,247
Central,Richmond City,51760,4155,18550,22705,5728,35349,41077,1277708,7543902,8821610,03/01/2021 12:00:00 AM,308,407,389
Central,Richmond City,51760,4168,14640,18808,5944,30055,35999,657870,3982856,4640726,08/01/2019 12:00:00 AM,158,272,247
Central,Richmond City,51760,4172,14511,18683,5924,29806,35730,649462,3909761,4559223,07/01/2019 12:00:00 AM,156,269,244
Central,Richmond City,51760,4194,16784,20978,6130,32526,38656,1184431,6113041,7297472,11/01/2020 12:00:00 AM,282,364,348
Central,Richmond City,51760,4196,18774,22970,5886,35527,41413,1389597,8510095,9899692,04/01/2021 12:00:00 AM,331,453,431
Central,Richmond City,51760,4219,14608,18827,5977,29920,35897,660012,3937732,4597744,06/01/2019 12:00:00 AM,156,270,244
Central,Richmond City,51760,4223,16761,20984,6089,32833,38922,1109294,5829239,6938533,04/01/2020 12:00:00 AM,263,348,331
Central,Richmond City,51760,4224,19068,23292,5973,36017,41990,1414820,8628115,10042935,05/01/2021 12:00:00 AM,335,452,431
Central,Richmond City,51760,4233,16987,21220,6183,32603,38786,1202234,6141316,7343550,12/01/2020 12:00:00 AM,284,362,346
Central,Richmond City,51760,4234,17175,21409,6179,32824,39003,1367110,7056952,8424062,01/01/2021 12:00:00 AM,323,411,393
Central,Richmond City,51760,4237,17175,21412,6177,33155,39332,1185723,6207737,7393460,10/01/2020 12:00:00 AM,280,361,345
Central,Richmond City,51760,4243,14685,18928,6033,30076,36109,666218,3974171,4640389,05/01/2019 12:00:00 AM,157,271,245
Central,Richmond City,51760,4251,14721,18972,6020,30156,36176,669188,3980215,4649403,04/01/2019 12:00:00 AM,157,270,245
Central,Richmond City,51760,4251,19288,23539,6048,36450,42498,1425068,8730152,10155220,06/01/2021 12:00:00 AM,335,453,431
Central,Richmond City,51760,4284,14681,18965,6081,30129,36210,671803,3929849,4601652,03/01/2019 12:00:00 AM,157,268,243
Central,Richmond City,51760,4288,17721,22009,6205,34234,40439,1125895,6005596,7131491,09/01/2020 12:00:00 AM,263,339,324
Central,Richmond City,51760,4302,14921,19223,6117,30821,36938,718191,4327876,5046067,01/01/2019 12:00:00 AM,167,290,263
Central,Richmond City,51760,4312,17575,21887,6249,34116,40365,1146281,6040187.27,7186468.27,05/01/2020 12:00:00 AM,266,344,328
Central,Richmond City,51760,4338,14963,19301,6182,31131,37313,706050,4127911,4833961,12/01/2018 12:00:00 AM,163,276,250
Central,Richmond City,51760,4345,15150,19495,6248,31550,37798,715703,4224050,4939753,10/01/2018 12:00:00 AM,165,279,253
Central,Richmond City,51760,4350,15147,19497,6273,31742,38015,713199,4192720,4905919,07/01/2018 12:00:00 AM,164,277,252
Central,Richmond City,51760,4354,18174,22528,6297,34907,41204,1144134,6116456,7260590,08/01/2020 12:00:00 AM,263,337,322
Central,Richmond City,51760,4361,15143,19504,6264,31419,37683,722381,4175233,4897614,11/01/2018 12:00:00 AM,166,276,251
Central,Richmond City,51760,4377,15362,19739,6297,32183,38480,712699,4270130,4982829,08/01/2018 12:00:00 AM,163,278,252
Central,Richmond City,51760,4379,17951,22330,6342,34695,41037,1162246,6111335,7273581,06/01/2020 12:00:00 AM,265,340,326
Central,Richmond City,51760,4381,15219,19600,6250,31711,37961,708257,4235506,4943763,03/01/2018 12:00:00 AM,162,278,252
Central,Richmond City,51760,4381,15793,20174,6213,33130,39343,711511,4527470,5238981,07/01/2017 12:00:00 AM,162,287,260
Central,Richmond City,51760,4390,15154,19544,6274,31845,38119,710071,4264876,4974947,02/01/2018 12:00:00 AM,162,281,255
Central,Richmond City,51760,4390,16165,20555,6149,33703,39852,700889,4543449,5244338,04/01/2017 12:00:00 AM,160,281,255
Central,Richmond City,51760,4391,15095,19486,6344,31612,37956,721341,4168485,4889826,09/01/2018 12:00:00 AM,164,276,251
Central,Richmond City,51760,4395,15252,19647,6322,31866,38188,714044,4260811,4974855,05/01/2018 12:00:00 AM,162,279,253
Central,Richmond City,51760,4404,16194,20598,6199,33784,39983,711310,4610732,5322042,05/01/2017 12:00:00 AM,162,285,258
Central,Richmond City,51760,4412,15236,19648,6330,31760,38090,716228,4229729,4945957,04/01/2018 12:00:00 AM,162,278,252
Central,Richmond City,51760,4412,15793,20205,6282,33198,39480,738955,4547387.5,5286342.5,09/01/2017 12:00:00 AM,167,288,262
Central,Richmond City,51760,4413,15313,19726,6341,32145,38486,720661,4296287,5016948,06/01/2018 12:00:00 AM,163,281,254
Central,Richmond City,51760,4416,16714,21130,6123,34619,40742,688570,4664927,5353497,03/01/2017 12:00:00 AM,156,279,253
Central,Richmond City,51760,4417,16075,20492,6234,33602,39836,710497,4613956,5324453,06/01/2017 12:00:00 AM,161,287,260
Central,Richmond City,51760,4432,15366,19798,6325,32349,38674,730755,4338332,5069087,12/01/2017 12:00:00 AM,165,282,256
Central,Richmond City,51760,4436,18328,22764,6446,35405,41851,1176920,6214046.05,7390966.05,07/01/2020 12:00:00 AM,265,339,325
Central,Richmond City,51760,4437,15271,19708,6344,32076,38420,709988,4293149,5003137,01/01/2018 12:00:00 AM,160,281,254
Central,Richmond City,51760,4441,15710,20151,6301,32921,39222,734575,4468677,5203252,10/01/2017 12:00:00 AM,165,284,258
Central,Richmond City,51760,4441,15958,20399,6321,33461,39782,743615,4595660,5339275,08/01/2017 12:00:00 AM,167,288,262
Central,Richmond City,51760,4443,15553,19996,6351,32806,39157,739941,4418374,5158315,11/01/2017 12:00:00 AM,167,284,258
Central,Richmond City,51760,4593,17236,21829,6422,35865,42287,705306,4717734,5423040,02/01/2017 12:00:00 AM,154,274,248
Central,Richmond City,51760,4664,17401,22065,6634,36275,42909,731593,4746943,5478536,01/01/2017 12:00:00 AM,157,273,248
Central,Richmond City,51760,4732,17426,22158,6826,36346,43172,766170,4782342,5548512,12/01/2016 12:00:00 AM,162,274,250
Central,Richmond City,51760,4759,17419,22178,6930,36256,43186,782169,4780291,5562460,11/01/2016 12:00:00 AM,164,274,251
Central,Richmond City,51760,4798,17839,22637,6953,37063,44016,803689,5009948,5813637,06/01/2016 12:00:00 AM,168,281,257
Central,Richmond City,51760,4807,17898,22705,7026,37095,44121,785167,4891858,5677025,07/01/2016 12:00:00 AM,163,273,250
Central,Richmond City,51760,4810,17872,22682,6980,37175,44155,767040,4862486,5629526,04/01/2016 12:00:00 AM,159,272,248
Central,Richmond City,51760,4819,17861,22680,6973,37202,44175,772790,4864226,5637016,05/01/2016 12:00:00 AM,160,272,249
Central,Richmond City,51760,4822,17685,22507,7052,36626,43678,799621,4832019,5631640,10/01/2016 12:00:00 AM,166,273,250
Central,Richmond City,51760,4828,17979,22807,7073,37323,44396,780198,4887632,5667830,03/01/2016 12:00:00 AM,162,272,249
Central,Richmond City,51760,4843,17983,22826,7175,37192,44367,792225,4891617,5683842,02/01/2016 12:00:00 AM,164,272,249
Central,Richmond City,51760,4851,17875,22726,7045,37071,44116,791408,4851760,5643168,09/01/2016 12:00:00 AM,163,271,248
Central,Richmond City,51760,4859,17949,22808,7065,37210,44275,785153,4895718,5680871,08/01/2016 12:00:00 AM,162,273,249
Central,Richmond City,51760,4888,18597,23485,7374,38465,45839,826878,5122213,5949091,05/01/2015 12:00:00 AM,169,275,253
Central,Richmond City,51760,4893,18061,22954,7275,37338,44613,800017,4877488,5677505,01/01/2016 12:00:00 AM,164,270,247
Central,Richmond City,51760,4916,18714,23630,7358,38674,46032,825297,5168624,5993921,06/01/2015 12:00:00 AM,168,276,254
Central,Richmond City,51760,4933,18600,23533,7367,38676,46043,822402,5129736,5952138,07/01/2015 12:00:00 AM,167,276,253
Central,Richmond City,51760,4965,18274,23239,7364,37825,45189,812845,4976208,5789053,12/01/2015 12:00:00 AM,164,272,249
Central,Richmond City,51760,4966,18606,23572,7564,38377,45941,846076,5093465,5939541,04/01/2015 12:00:00 AM,170,274,252
Central,Richmond City,51760,4971,18496,23467,7360,38356,45716,816948,5076240,5893188,10/01/2015 12:00:00 AM,164,274,251
Central,Richmond City,51760,4975,18602,23577,7418,38663,46081,822489,5132118,5954607,08/01/2015 12:00:00 AM,165,276,253
Central,Richmond City,51760,4976,18344,23320,7422,37991,45413,826095,5031207,5857302,11/01/2015 12:00:00 AM,166,274,251
Central,Richmond City,51760,4977,18685,23662,7666,38394,46060,858317,5113934,5972251,03/01/2015 12:00:00 AM,172,274,252
Central,Richmond City,51760,5007,18473,23480,7463,38334,45797,830949,5089760,5920709,09/01/2015 12:00:00 AM,166,276,252
Central,Richmond City,51760,5028,18726,23754,7809,38368,46177,872843,5148161,6021004,02/01/2015 12:00:00 AM,174,275,253
Central,Richmond City,51760,5070,21553,26623,7994,42065,50059,864042,5627440,6491482,08/01/2014 12:00:00 AM,170,261,244
Central,Richmond City,51760,5075,21643,26718,8094,42043,50137,872825,5621827,6494652,07/01/2014 12:00:00 AM,172,260,243
Central,Richmond City,51760,5075,21916,26991,8100,42250,50350,873256,5688128,6561384,06/01/2014 12:00:00 AM,172,260,243
Central,Richmond City,51760,5079,22037,27116,8099,42292,50391,874869,5692360,6567229,05/01/2014 12:00:00 AM,172,258,242
Central,Richmond City,51760,5104,22222,27326,8181,42474,50655,881661,5718635,6600296,04/01/2014 12:00:00 AM,173,257,242
Central,Richmond City,51760,5124,21109,26233,7977,41627,49604,903390,5729104,6632494,10/01/2014 12:00:00 AM,176,271,253
Central,Richmond City,51760,5128,21274,26402,8061,41753,49814,871105,5553971,6425076,09/01/2014 12:00:00 AM,170,261,243
Central,Richmond City,51760,5142,20313,25455,8030,40472,48502,918202,5514305,6432507,12/01/2014 12:00:00 AM,179,271,253
Central,Richmond City,51760,5166,22591,27757,8345,42879,51224,909479,5758322,6667801,03/01/2014 12:00:00 AM,176,255,240
Central,Richmond City,51760,5177,19453,24630,8062,39278,47340,903403,5258902,6162305,01/01/2015 12:00:00 AM,175,270,250
Central,Richmond City,51760,5181,20562,25743,8126,40779,48905,931441,5578726,6510167,11/01/2014 12:00:00 AM,180,271,253
Central,Richmond City,51760,5255,22935,28190,8505,43368,51873,927618,5828169,6755787,02/01/2014 12:00:00 AM,177,254,240
Central,Richmond City,51760,5334,23855,29189,8531,44866,53397,946543,6040423,6986966,12/01/2013 12:00:00 AM,177,253,239
Central,Richmond City,51760,5335,23331,28666,8598,43978,52576,937091,5874002,6811093,01/01/2014 12:00:00 AM,176,252,238
Central,Richmond City,51760,5374,24196,29570,8591,45324,53915,958535,6103643,7062178,11/01/2013 12:00:00 AM,178,252,239
Central,Richmond City,51760,5419,24507,29926,8694,45736,54430,1052611,6611590,7664201,10/01/2013 12:00:00 AM,194,270,256
Central,Richmond City,51760,5461,24452,29913,9078,45070,54148,1103497,6508741,7612238,04/01/2013 12:00:00 AM,202,266,254
Central,Richmond City,51760,5466,24525,29991,8983,45316,54299,1087269,6553694,7640963,05/01/2013 12:00:00 AM,199,267,255
Central,Richmond City,51760,5470,23682,29152,9375,43448,52823,1156799,6283691,7440490,04/01/2012 12:00:00 AM,211,265,255
Central,Richmond City,51760,5473,23869,29342,9330,43818,53148,1149605,6359018,7508623,05/01/2012 12:00:00 AM,210,266,256
Central,Richmond City,51760,5481,24585,30066,8909,45789,54698,1063411,6611277,7674688,08/01/2013 12:00:00 AM,194,269,255
Central,Richmond City,51760,5481,24640,30121,8917,45741,54658,1071893,6575929,7647822,07/01/2013 12:00:00 AM,196,267,254
Central,Richmond City,51760,5485,24656,30141,8851,45914,54765,1059333,6595520,7654853,09/01/2013 12:00:00 AM,193,268,254
Central,Richmond City,51760,5487,24589,30076,8996,45531,54527,1084466,6573155,7657621,06/01/2013 12:00:00 AM,198,267,255
Central,Richmond City,51760,5499,23682,29181,9461,43369,52830,1168350,6284745,7453095,03/01/2012 12:00:00 AM,212,265,255
Central,Richmond City,51760,5519,24621,30140,9263,45208,54471,1145679,6563721,7709400,08/01/2012 12:00:00 AM,208,267,256
Central,Richmond City,51760,5525,24371,29896,9357,44683,54040,1157181,6489966,7647147,07/01/2012 12:00:00 AM,209,266,256
Central,Richmond City,51760,5528,23598,29126,9570,43122,52692,1185427,6253920,7439347,02/01/2012 12:00:00 AM,214,265,255
Central,Richmond City,51760,5536,24066,29602,9498,44123,53621,1173552,6395454,7569006,06/01/2012 12:00:00 AM,212,266,256
Central,Richmond City,51760,5542,23454,28996,9649,42991,52640,1202247,6176863,7379110,01/01/2012 12:00:00 AM,217,263,254
Central,Richmond City,51760,5542,24380,29922,9321,44875,54196,1137739,6482899,7620638,03/01/2013 12:00:00 AM,205,266,255
Central,Richmond City,51760,5552,24802,30354,9325,45519,54844,1158535,6636678,7795213,10/01/2012 12:00:00 AM,209,268,257
Central,Richmond City,51760,5570,24502,30072,9385,45109,54494,1145102,6518106,7663208,02/01/2013 12:00:00 AM,206,266,255
Central,Richmond City,51760,5570,24665,30235,9325,45466,54791,1151154,6609219,7760373,12/01/2012 12:00:00 AM,207,268,257
Central,Richmond City,51760,5581,24553,30134,9375,45370,54745,1140026,6522857,7662883,01/01/2013 12:00:00 AM,204,266,254
Central,Richmond City,51760,5593,24591,30184,9370,45129,54499,1160696,6564046,7724742,09/01/2012 12:00:00 AM,208,267,256
Central,Richmond City,51760,5618,24763,30381,9455,45483,54938,1183165,6598376,7781541,11/01/2012 12:00:00 AM,211,266,256
Central,Richmond County,51159,120,611,731,163,1302,1465,16227,170269,186496,03/01/2012 12:00:00 AM,135,279,255
Central,Richmond County,51159,120,614,734,156,1322,1478,16187,169369,185556,01/01/2012 12:00:00 AM,135,276,253
Central,Richmond County,51159,121,618,739,163,1339,1502,16702,172844,189546,02/01/2012 12:00:00 AM,138,280,256
Central,Richmond County,51159,124,608,732,172,1264,1436,15485,152687,168172,03/01/2016 12:00:00 AM,125,251,230
Central,Richmond County,51159,124,613,737,170,1282,1452,15322,153259,168581,04/01/2016 12:00:00 AM,124,250,229
Central,Richmond County,51159,124,619,743,162,1316,1478,16752,172464,189216,04/01/2012 12:00:00 AM,135,279,255
Central,Richmond County,51159,125,626,751,163,1357,1520,14259,160152,174411,07/01/2014 12:00:00 AM,114,256,232
Central,Richmond County,51159,125,648,773,187,1388,1575,18420,179274,197694,10/01/2013 12:00:00 AM,147,277,256
Central,Richmond County,51159,126,615,741,172,1297,1469,15759,156894,172653,10/01/2015 12:00:00 AM,125,255,233
Central,Richmond County,51159,126,662,788,189,1398,1587,19630,179652,199282,09/01/2013 12:00:00 AM,156,271,253
Central,Richmond County,51159,126,663,789,193,1394,1587,20313,179226,199539,08/01/2013 12:00:00 AM,161,270,253
Central,Richmond County,51159,127,604,731,175,1284,1459,16608,157692,174300,09/01/2015 12:00:00 AM,131,261,238
Central,Richmond County,51159,127,608,735,170,1283,1453,18243,168186,186429,05/01/2012 12:00:00 AM,144,277,254
Central,Richmond County,51159,127,610,737,171,1294,1465,17793,168754,186547,06/01/2012 12:00:00 AM,140,277,253
Central,Richmond County,51159,127,622,749,159,1346,1505,15062,157299,172361,09/01/2014 12:00:00 AM,119,253,230
Central,Richmond County,51159,127,644,771,188,1344,1532,20799,174314,195113,04/01/2013 12:00:00 AM,164,271,253
Central,Richmond County,51159,127,644,771,197,1345,1542,21333,174358,195691,07/01/2013 12:00:00 AM,168,271,254
Central,Richmond County,51159,127,650,777,193,1353,1546,22097,174041,196138,03/01/2013 12:00:00 AM,174,268,252
Central,Richmond County,51159,128,637,765,189,1328,1517,21361,169199,190560,05/01/2013 12:00:00 AM,167,266,249
Central,Richmond County,51159,128,648,776,195,1395,1590,18381,168829,187210,11/01/2013 12:00:00 AM,144,261,241
Central,Richmond County,51159,129,598,727,176,1269,1445,15531,153498,169029,06/01/2016 12:00:00 AM,120,257,233
Central,Richmond County,51159,129,625,754,178,1312,1490,16184,159422,175606,11/01/2015 12:00:00 AM,125,255,233
Central,Richmond County,51159,129,645,774,188,1378,1566,16966,165699,182665,04/01/2014 12:00:00 AM,132,257,236
Central,Richmond County,51159,129,646,775,191,1384,1575,18426,166607,185033,12/01/2013 12:00:00 AM,143,258,239
Central,Richmond County,51159,130,588,718,183,1257,1440,17130,150847,167977,03/01/2015 12:00:00 AM,132,257,234
Central,Richmond County,51159,130,607,737,177,1269,1446,15483,152228,167711,05/01/2016 12:00:00 AM,119,251,228
Central,Richmond County,51159,130,611,741,181,1307,1488,17958,157625,175583,08/01/2015 12:00:00 AM,138,258,237
Central,Richmond County,51159,130,624,754,186,1295,1481,16991,155193,172184,02/01/2016 12:00:00 AM,131,249,228
Central,Richmond County,51159,130,627,757,185,1313,1498,19457,169818,189275,12/01/2012 12:00:00 AM,150,271,250
Central,Richmond County,51159,130,632,762,192,1372,1564,18317,162312,180629,06/01/2014 12:00:00 AM,141,257,237
Central,Richmond County,51159,130,638,768,192,1348,1540,21277,172344,193621,06/01/2013 12:00:00 AM,164,270,252
Central,Richmond County,51159,130,639,769,190,1337,1527,19746,170336,190082,01/01/2013 12:00:00 AM,152,267,247
Central,Richmond County,51159,130,642,772,193,1368,1561,18720,162098,180818,05/01/2014 12:00:00 AM,144,252,234
Central,Richmond County,51159,131,591,722,192,1271,1463,19223,152733,171956,06/01/2015 12:00:00 AM,147,258,238
Central,Richmond County,51159,131,607,738,169,1294,1463,17222,157241,174463,11/01/2014 12:00:00 AM,131,259,236
Central,Richmond County,51159,131,609,740,174,1305,1479,17731,159071,176802,10/01/2014 12:00:00 AM,135,261,239
Central,Richmond County,51159,131,621,752,165,1354,1519,14484,159312,173796,08/01/2014 12:00:00 AM,111,257,231
Central,Richmond County,51159,131,633,764,196,1367,1563,16587,165161,181748,03/01/2014 12:00:00 AM,127,261,238
Central,Richmond County,51159,132,592,724,166,1259,1425,15319,149716,165035,10/01/2016 12:00:00 AM,116,253,228
Central,Richmond County,51159,132,597,729,193,1283,1476,19275,155495,174770,07/01/2015 12:00:00 AM,146,260,240
Central,Richmond County,51159,132,599,731,188,1282,1470,18079,155060,173139,04/01/2015 12:00:00 AM,137,259,237
Central,Richmond County,51159,132,601,733,172,1284,1456,17176,153059,170235,12/01/2014 12:00:00 AM,130,255,232
Central,Richmond County,51159,132,618,750,187,1288,1475,17472,152855,170327,12/01/2015 12:00:00 AM,132,247,227
Central,Richmond County,51159,132,624,756,188,1301,1489,17953,155633,173586,01/01/2016 12:00:00 AM,136,249,230
Central,Richmond County,51159,132,640,772,200,1369,1569,18478,162535,181013,01/01/2014 12:00:00 AM,140,254,234
Central,Richmond County,51159,133,555,688,162,1187,1349,14663,142638,157301,06/01/2017 12:00:00 AM,110,257,229
Central,Richmond County,51159,133,566,699,164,1230,1394,14639,150377,165016,05/01/2017 12:00:00 AM,110,266,236
Central,Richmond County,51159,133,590,723,179,1267,1446,16965,152977,169942,02/01/2015 12:00:00 AM,128,259,235
Central,Richmond County,51159,133,596,729,192,1271,1463,17956,151739,169695,07/01/2016 12:00:00 AM,135,255,233
Central,Richmond County,51159,133,609,742,186,1267,1453,19491,166838,186329,08/01/2012 12:00:00 AM,147,274,251
Central,Richmond County,51159,133,611,744,188,1258,1446,19960,164341,184301,09/01/2012 12:00:00 AM,150,269,248
Central,Richmond County,51159,133,644,777,208,1342,1550,23105,173681,196786,02/01/2013 12:00:00 AM,174,270,253
Central,Richmond County,51159,134,571,705,162,1234,1396,14490,148027,162517,03/01/2017 12:00:00 AM,108,259,231
Central,Richmond County,51159,134,590,724,167,1270,1437,15902,149323,165225,11/01/2016 12:00:00 AM,119,253,228
Central,Richmond County,51159,134,595,729,194,1269,1463,19417,153774,173191,05/01/2015 12:00:00 AM,145,258,238
Central,Richmond County,51159,134,622,756,193,1287,1480,20413,164412,184825,11/01/2012 12:00:00 AM,152,264,244
Central,Richmond County,51159,134,647,781,198,1388,1586,18184,166332,184516,02/01/2014 12:00:00 AM,136,257,236
Central,Richmond County,51159,135,575,710,164,1250,1414,14784,152479,167263,04/01/2017 12:00:00 AM,110,265,236
Central,Richmond County,51159,135,586,721,178,1256,1434,16770,146552,163322,01/01/2015 12:00:00 AM,124,250,227
Central,Richmond County,51159,135,594,729,192,1253,1445,18803,149473,168276,09/01/2016 12:00:00 AM,139,252,231
Central,Richmond County,51159,135,629,764,197,1292,1489,20974,166047,187021,10/01/2012 12:00:00 AM,155,264,245
Central,Richmond County,51159,136,592,728,194,1264,1458,18397,148991,167388,08/01/2016 12:00:00 AM,135,252,230
Central,Richmond County,51159,136,610,746,188,1279,1467,19233,165925,185158,07/01/2012 12:00:00 AM,141,272,248
Central,Richmond County,51159,137,513,650,188,1117,1305,16453,132082,148535,02/01/2019 12:00:00 AM,120,257,229
Central,Richmond County,51159,137,569,706,168,1243,1411,15058,148077,163135,02/01/2017 12:00:00 AM,110,260,231
Central,Richmond County,51159,138,554,692,176,1204,1380,16815,146136,162951,07/01/2017 12:00:00 AM,122,264,235
Central,Richmond County,51159,138,572,710,177,1246,1423,16764,147635,164399,01/01/2017 12:00:00 AM,121,258,232
Central,Richmond County,51159,138,582,720,177,1252,1429,17524,147269,164793,12/01/2016 12:00:00 AM,127,253,229
Central,Richmond County,51159,142,535,677,192,1155,1347,16719,136809,153528,03/01/2019 12:00:00 AM,118,256,227
Central,Richmond County,51159,142,548,690,196,1178,1374,17870,142266,160136,01/01/2019 12:00:00 AM,126,260,232
Central,Richmond County,51159,143,505,648,197,1087,1284,15820,131234,147054,07/01/2019 12:00:00 AM,111,260,227
Central,Richmond County,51159,144,538,682,194,1183,1377,19546,142878,162424,09/01/2017 12:00:00 AM,136,266,238
Central,Richmond County,51159,144,539,683,198,1183,1381,20811,143975,164786,10/01/2017 12:00:00 AM,145,267,241
Central,Richmond County,51159,144,550,694,192,1199,1391,18789,146408,165197,08/01/2017 12:00:00 AM,130,266,238
Central,Richmond County,51159,145,481,626,186,988,1174,42728,222285,265013,04/01/2021 12:00:00 AM,295,462,423
Central,Richmond County,51159,145,483,628,189,980,1169,43638,226008,269646,05/01/2021 12:00:00 AM,301,468,429
Central,Richmond County,51159,145,502,647,199,1075,1274,16121,132327,148448,08/01/2019 12:00:00 AM,111,264,229
Central,Richmond County,51159,145,544,689,200,1156,1356,17562,140455,158017,09/01/2018 12:00:00 AM,121,258,229
Central,Richmond County,51159,146,491,637,190,1002,1192,43247,209137,252384,03/01/2021 12:00:00 AM,296,426,396
Central,Richmond County,51159,146,501,647,192,1030,1222,43204,219045,262249,02/01/2021 12:00:00 AM,296,437,405
Central,Richmond County,51159,146,533,679,201,1130,1331,17598,135757,153355,08/01/2018 12:00:00 AM,121,255,226
Central,Richmond County,51159,146,534,680,198,1148,1346,17930,137676,155606,12/01/2018 12:00:00 AM,123,258,229
Central,Richmond County,51159,146,541,687,196,1132,1328,21517.61,154119.42,175637.03,10/01/2018 12:00:00 AM,147,285,256
Central,Richmond County,51159,147,523,670,204,1129,1333,16612,135407,152019,06/01/2019 12:00:00 AM,113,259,227
Central,Richmond County,51159,147,525,672,203,1149,1352,18566,140476,159042,02/01/2018 12:00:00 AM,126,268,237
Central,Richmond County,51159,147,538,685,197,1154,1351,17212,135312,152524,11/01/2018 12:00:00 AM,117,252,223
Central,Richmond County,51159,147,541,688,206,1176,1382,20594,139790,160384,11/01/2017 12:00:00 AM,140,258,233
Central,Richmond County,51159,148,480,628,193,977,1170,44158,223386,267544,06/01/2021 12:00:00 AM,298,465,426
Central,Richmond County,51159,148,488,636,202,1010,1212,15898,122540,138438,02/01/2020 12:00:00 AM,107,251,218
Central,Richmond County,51159,148,504,652,195,1027,1222,43280,213538,256818,01/01/2021 12:00:00 AM,292,424,394
Central,Richmond County,51159,148,516,664,195,1054,1249,38306,193187,231493,11/01/2020 12:00:00 AM,259,374,349
Central,Richmond County,51159,148,526,674,200,1135,1335,16888,134697,151585,04/01/2019 12:00:00 AM,114,256,225
Central,Richmond County,51159,149,482,631,215,997,1212,18816,123597,142413,11/01/2019 12:00:00 AM,126,256,226
Central,Richmond County,51159,149,500,649,208,1064,1272,17777,130516,148293,09/01/2019 12:00:00 AM,119,261,228
Central,Richmond County,51159,149,518,667,201,1062,1263,38713,193192,231905,10/01/2020 12:00:00 AM,260,373,348
Central,Richmond County,51159,149,526,675,210,1142,1352,18061,133567,151628,05/01/2019 12:00:00 AM,121,254,225
Central,Richmond County,51159,150,479,629,207,988,1195,17567,117868,135435,01/01/2020 12:00:00 AM,117,246,215
Central,Richmond County,51159,150,510,660,200,1036,1236,38943,188362,227305,12/01/2020 12:00:00 AM,260,369,344
Central,Richmond County,51159,150,522,672,213,1136,1349,19868,133827,153695,04/01/2018 12:00:00 AM,132,256,229
Central,Richmond County,51159,150,534,684,211,1133,1344,17883,136013,153896,07/01/2018 12:00:00 AM,119,255,225
Central,Richmond County,51159,151,497,648,206,1032,1238,37454,176203,213657,03/01/2020 12:00:00 AM,248,355,330
Central,Richmond County,51159,151,538,689,209,1164,1373,19492,136644,156136,12/01/2017 12:00:00 AM,129,254,227
Central,Richmond County,51159,151,542,693,209,1164,1373,18896,139537,158433,01/01/2018 12:00:00 AM,125,257,229
Central,Richmond County,51159,152,484,636,215,1005,1220,18010,124318,142328,12/01/2019 12:00:00 AM,118,257,224
Central,Richmond County,51159,152,527,679,211,1129,1340,18563,135765,154328,06/01/2018 12:00:00 AM,122,258,227
Central,Richmond County,51159,152,529,681,206,1081,1287,37837,186399,224236,09/01/2020 12:00:00 AM,249,352,329
Central,Richmond County,51159,153,491,644,219,1054,1273,18844,132021,150865,10/01/2019 12:00:00 AM,123,269,234
Central,Richmond County,51159,153,529,682,210,1089,1299,38885,188199,227084,06/01/2020 12:00:00 AM,254,356,333
Central,Richmond County,51159,154,521,675,215,1067,1282,39290,184135,223425,08/01/2020 12:00:00 AM,255,353,331
Central,Richmond County,51159,154,522,676,218,1116,1334,20549,134768,155317,05/01/2018 12:00:00 AM,133,258,230
Central,Richmond County,51159,154,531,685,218,1150,1368,20508,138865,159373,03/01/2018 12:00:00 AM,133,262,233
Central,Richmond County,51159,154,537,691,212,1107,1319,38894,192005,230899,07/01/2020 12:00:00 AM,253,358,334
Central,Richmond County,51159,155,534,689,215,1091,1306,38989,188386,227375,05/01/2020 12:00:00 AM,252,353,330
Central,Richmond County,51159,156,522,678,215,1072,1287,39284,186838,226122,04/01/2020 12:00:00 AM,252,358,334
Central,Westmoreland County,51193,189,1162,1351,273,2615,2888,28645,324894,353539,09/01/2017 12:00:00 AM,152,280,262
Central,Westmoreland County,51193,189,1167,1356,245,2604,2849,24309,312255,336564,05/01/2019 12:00:00 AM,129,268,248
Central,Westmoreland County,51193,190,1103,1293,254,2471,2725,25974,299072,325046,02/01/2019 12:00:00 AM,137,271,251
Central,Westmoreland County,51193,190,1167,1357,251,2595,2846,24716,312173,336889,06/01/2019 12:00:00 AM,130,268,248
Central,Westmoreland County,51193,191,1186,1377,280,2681,2961,28779,331885.38,360664.38,05/01/2017 12:00:00 AM,151,280,262
Central,Westmoreland County,51193,192,1185,1377,272,2666,2938,28759,324024,352783,03/01/2018 12:00:00 AM,150,273,256
Central,Westmoreland County,51193,193,1133,1326,272,2497,2769,30000,298212,328212,10/01/2019 12:00:00 AM,155,263,248
Central,Westmoreland County,51193,194,1165,1359,257,2592,2849,25472,308231,333703,04/01/2019 12:00:00 AM,131,265,246
Central,Westmoreland County,51193,194,1339,1533,252,2764,3016,56810,583995,640805,02/01/2021 12:00:00 AM,293,436,418
Central,Westmoreland County,51193,195,1186,1381,266,2634,2900,28703,325393,354096,04/01/2018 12:00:00 AM,147,274,256
Central,Westmoreland County,51193,195,1205,1400,276,2687,2963,27662,329370,357032,02/01/2018 12:00:00 AM,142,273,255
Central,Westmoreland County,51193,196,1162,1358,285,2635,2920,31621,330295,361916,08/01/2017 12:00:00 AM,161,284,267
Central,Westmoreland County,51193,196,1192,1388,284,2719,3003,28288,337177,365465,04/01/2017 12:00:00 AM,144,283,263
Central,Westmoreland County,51193,196,1212,1408,283,2777,3060,28874,338386,367260,03/01/2017 12:00:00 AM,147,279,261
Central,Westmoreland County,51193,196,1226,1422,287,2813,3100,28101,347114,375215,01/01/2017 12:00:00 AM,143,283,264
Central,Westmoreland County,51193,197,1135,1332,269,2592,2861,29667,319033,348700,10/01/2018 12:00:00 AM,151,281,262
Central,Westmoreland County,51193,197,1146,1343,278,2516,2794,29800,307967,337767,12/01/2019 12:00:00 AM,151,269,252
Central,Westmoreland County,51193,197,1272,1469,291,2917,3208,30909,348331,379240,11/01/2014 12:00:00 AM,157,274,258
Central,Westmoreland County,51193,198,1139,1337,280,2520,2800,29949,307856,337805,09/01/2019 12:00:00 AM,151,270,253
Central,Westmoreland County,51193,198,1141,1339,278,2574,2852,30666,311738,342404,09/01/2018 12:00:00 AM,155,273,256
Central,Westmoreland County,51193,198,1141,1339,279,2530,2809,29914,305470,335384,08/01/2019 12:00:00 AM,151,268,250
Central,Westmoreland County,51193,198,1149,1347,272,2562,2834,28612,309559,338171,08/01/2018 12:00:00 AM,145,269,251
Central,Westmoreland County,51193,198,1196,1394,292,2773,3065,29454,336199,365653,12/01/2016 12:00:00 AM,149,281,262
Central,Westmoreland County,51193,198,1213,1411,288,2781,3069,28481,338364,366845,02/01/2017 12:00:00 AM,144,279,260
Central,Westmoreland County,51193,198,1293,1491,285,2943,3228,29314,353658,382972,10/01/2014 12:00:00 AM,148,274,257
Central,Westmoreland County,51193,198,1316,1514,262,2704,2966,57613,560271,617884,03/01/2021 12:00:00 AM,291,426,408
Central,Westmoreland County,51193,198,1365,1563,287,3066,3353,32220,395328,427548,04/01/2012 12:00:00 AM,163,290,274
Central,Westmoreland County,51193,199,1134,1333,270,2572,2842,28940,311586,340526,12/01/2018 12:00:00 AM,145,275,255
Central,Westmoreland County,51193,199,1143,1342,286,2479,2765,30821,296876,327697,01/01/2020 12:00:00 AM,155,260,244
Central,Westmoreland County,51193,199,1144,1343,277,2506,2783,29774,297187,326961,11/01/2019 12:00:00 AM,150,260,243
Central,Westmoreland County,51193,199,1149,1348,272,2560,2832,28568,304980,333548,07/01/2019 12:00:00 AM,144,265,247
Central,Westmoreland County,51193,199,1162,1361,289,2661,2950,29929,331056,360985,07/01/2017 12:00:00 AM,150,285,265
Central,Westmoreland County,51193,199,1166,1365,293,2662,2955,30448,330936,361384,06/01/2017 12:00:00 AM,153,284,265
Central,Westmoreland County,51193,200,1149,1349,291,2477,2768,32432,298840,331272,02/01/2020 12:00:00 AM,162,260,246
Central,Westmoreland County,51193,200,1213,1413,280,2711,2991,27823,334685,362508,01/01/2018 12:00:00 AM,139,276,257
Central,Westmoreland County,51193,201,1150,1351,278,2575,2853,28232,305434,333666,03/01/2019 12:00:00 AM,140,266,247
Central,Westmoreland County,51193,201,1161,1362,275,2584,2859,30118,315279,345397,07/01/2018 12:00:00 AM,150,272,254
Central,Westmoreland County,51193,201,1161,1362,277,2592,2869,29830,317960,347790,06/01/2018 12:00:00 AM,148,274,255
Central,Westmoreland County,51193,201,1178,1379,301,2745,3046,31836,331507,363343,11/01/2016 12:00:00 AM,158,281,263
Central,Westmoreland County,51193,201,1184,1385,282,2680,2962,28886,330110,358996,11/01/2017 12:00:00 AM,144,279,259
Central,Westmoreland County,51193,201,1185,1386,284,2671,2955,29098,332152,361250,10/01/2017 12:00:00 AM,145,280,261
Central,Westmoreland County,51193,201,1189,1390,282,2683,2965,28413,330068,358481,12/01/2017 12:00:00 AM,141,278,258
Central,Westmoreland County,51193,201,1357,1558,296,3029,3325,33225,390408,423633,05/01/2012 12:00:00 AM,165,288,272
Central,Westmoreland County,51193,202,1123,1325,275,2570,2845,29144,311069,340213,11/01/2018 12:00:00 AM,144,277,257
Central,Westmoreland County,51193,202,1170,1372,280,2618,2898,29933,323399,353332,05/01/2018 12:00:00 AM,148,276,258
Central,Westmoreland County,51193,202,1287,1489,271,2627,2898,63406,607467,670873,05/01/2021 12:00:00 AM,314,472,451
Central,Westmoreland County,51193,202,1360,1562,301,3076,3377,34414,395663,430077,03/01/2012 12:00:00 AM,170,291,275
Central,Westmoreland County,51193,203,1182,1385,291,2554,2845,52632,438670,491302,03/01/2020 12:00:00 AM,259,371,355
Central,Westmoreland County,51193,203,1223,1426,303,2834,3137,31994,339986,371980,04/01/2016 12:00:00 AM,158,278,261
Central,Westmoreland County,51193,203,1292,1495,291,2899,3190,28874,337916,366790,08/01/2014 12:00:00 AM,142,262,245
Central,Westmoreland County,51193,203,1360,1563,302,3046,3348,33883,390122,424005,07/01/2012 12:00:00 AM,167,287,271
Central,Westmoreland County,51193,204,1249,1453,291,2852,3143,30620,339206,369826,02/01/2016 12:00:00 AM,150,272,255
Central,Westmoreland County,51193,204,1297,1501,277,2649,2926,66139,605744,671883,04/01/2021 12:00:00 AM,324,467,448
Central,Westmoreland County,51193,204,1312,1516,302,3026,3328,32522,359870,392392,12/01/2014 12:00:00 AM,159,274,259
Central,Westmoreland County,51193,204,1350,1554,302,3001,3303,33489,386902,420391,06/01/2012 12:00:00 AM,164,287,271
Central,Westmoreland County,51193,205,1284,1489,290,2924,3214,28020,338645,366665,09/01/2014 12:00:00 AM,137,264,246
Central,Westmoreland County,51193,205,1345,1550,304,2995,3299,34474,379451,413925,01/01/2012 12:00:00 AM,168,282,267
Central,Westmoreland County,51193,206,1145,1351,285,2584,2869,32334,326771,359105,01/01/2019 12:00:00 AM,157,285,266
Central,Westmoreland County,51193,206,1186,1392,301,2784,3085,31234,333066,364300,09/01/2016 12:00:00 AM,152,281,262
Central,Westmoreland County,51193,206,1249,1455,292,2692,2984,53478,459875,513353,04/01/2020 12:00:00 AM,260,368,353
Central,Westmoreland County,51193,207,1166,1373,314,2711,3025,32413,322970,355383,07/01/2016 12:00:00 AM,157,277,259
Central,Westmoreland County,51193,207,1181,1388,318,2756,3074,32849,329048,361897,06/01/2016 12:00:00 AM,159,279,261
Central,Westmoreland County,51193,207,1291,1498,283,2644,2927,66324,613030,679354,06/01/2021 12:00:00 AM,320,475,454
Central,Westmoreland County,51193,207,1379,1586,311,3037,3348,36061,386957,423018,09/01/2012 12:00:00 AM,174,281,267
Central,Westmoreland County,51193,208,1247,1455,307,2863,3170,32617,341570,374187,03/01/2016 12:00:00 AM,157,274,257
Central,Westmoreland County,51193,208,1336,1544,309,3008,3317,35976,388533,424509,02/01/2012 12:00:00 AM,173,291,275
Central,Westmoreland County,51193,208,1376,1584,302,3063,3365,35151,392469,427620,08/01/2012 12:00:00 AM,169,285,270
Central,Westmoreland County,51193,209,1389,1598,306,3060,3366,34875,390639,425514,10/01/2012 12:00:00 AM,167,281,266
Central,Westmoreland County,51193,210,1232,1442,310,2815,3125,33724,330151,363875,01/01/2016 12:00:00 AM,161,268,252
Central,Westmoreland County,51193,210,1295,1505,309,2880,3189,30540,335442,365982,07/01/2014 12:00:00 AM,145,259,243
Central,Westmoreland County,51193,211,1187,1398,325,2758,3083,34466,333420,367886,10/01/2016 12:00:00 AM,163,281,263
Central,Westmoreland County,51193,211,1188,1399,314,2783,3097,32497,328752,361249,08/01/2016 12:00:00 AM,154,277,258
Central,Westmoreland County,51193,211,1191,1402,330,2781,3111,36118,331334,367452,05/01/2016 12:00:00 AM,171,278,262
Central,Westmoreland County,51193,211,1232,1443,309,2804,3113,33957,332386,366343,12/01/2015 12:00:00 AM,161,270,254
Central,Westmoreland County,51193,211,1415,1626,311,3117,3428,34175,395688,429863,11/01/2012 12:00:00 AM,162,280,264
Central,Westmoreland County,51193,212,1221,1433,320,2825,3145,36065,330503,366568,10/01/2015 12:00:00 AM,170,271,256
Central,Westmoreland County,51193,212,1282,1494,303,2750,3053,54883,474790,529673,05/01/2020 12:00:00 AM,259,370,355
Central,Westmoreland County,51193,213,1232,1445,323,2822,3145,35443,332135,367578,11/01/2015 12:00:00 AM,166,270,254
Central,Westmoreland County,51193,214,1227,1441,327,2805,3132,36708,332839,369547,09/01/2015 12:00:00 AM,172,271,256
Central,Westmoreland County,51193,214,1232,1446,318,2824,3142,34387,336081,370468,08/01/2015 12:00:00 AM,161,273,256
Central,Westmoreland County,51193,214,1367,1581,308,3026,3334,29971,357880,387851,04/01/2014 12:00:00 AM,140,262,245
Central,Westmoreland County,51193,214,1415,1629,319,3077,3396,35649,397965,433614,02/01/2013 12:00:00 AM,167,281,266
Central,Westmoreland County,51193,214,1420,1634,316,3120,3436,35895,402035,437930,12/01/2012 12:00:00 AM,168,283,268
Central,Westmoreland County,51193,215,1302,1517,318,2685,3003,60510,489323,549833,12/01/2020 12:00:00 AM,281,376,362
Central,Westmoreland County,51193,215,1319,1534,316,2914,3230,31037,344970,376007,06/01/2014 12:00:00 AM,144,262,245
Central,Westmoreland County,51193,216,1296,1512,331,3022,3353,35965,358693,394658,02/01/2015 12:00:00 AM,167,277,261
Central,Westmoreland County,51193,216,1299,1515,328,2693,3021,62049,498600,560649,11/01/2020 12:00:00 AM,287,384,370
Central,Westmoreland County,51193,217,1300,1517,340,2993,3333,37535,351717,389252,01/01/2015 12:00:00 AM,173,271,257
Central,Westmoreland County,51193,217,1309,1526,316,2693,3009,68829,558502,627331,01/01/2021 12:00:00 AM,317,427,411
Central,Westmoreland County,51193,217,1313,1530,324,2704,3028,62333,496521,558854,10/01/2020 12:00:00 AM,287,378,365
Central,Westmoreland County,51193,217,1408,1625,324,3071,3395,36632,390194,426826,01/01/2013 12:00:00 AM,169,277,263
Central,Westmoreland County,51193,218,1295,1513,336,2996,3332,37464,356131,393595,03/01/2015 12:00:00 AM,172,275,260
Central,Westmoreland County,51193,218,1298,1516,316,2758,3074,58014,474654,532668,06/01/2020 12:00:00 AM,266,366,351
Central,Westmoreland County,51193,218,1331,1549,323,2774,3097,58686,476174,534860,09/01/2020 12:00:00 AM,269,358,345
Central,Westmoreland County,51193,218,1417,1635,314,3121,3435,33667,404262,437929,04/01/2013 12:00:00 AM,154,285,268
Central,Westmoreland County,51193,219,1345,1564,319,2973,3292,32390,353875,386265,05/01/2014 12:00:00 AM,148,263,247
Central,Westmoreland County,51193,219,1396,1615,320,3078,3398,31472,361320,392792,03/01/2014 12:00:00 AM,144,259,243
Central,Westmoreland County,51193,219,1417,1636,321,3097,3418,35581,402498,438079,03/01/2013 12:00:00 AM,162,284,268
Central,Westmoreland County,51193,220,1258,1478,337,2860,3197,37616,338363,375979,07/01/2015 12:00:00 AM,171,269,254
Central,Westmoreland County,51193,220,1316,1536,328,2759,3087,59765,480592.5,540357.5,08/01/2020 12:00:00 AM,272,365,352
Central,Westmoreland County,51193,220,1375,1595,315,2981,3296,34213,372759,406972,10/01/2013 12:00:00 AM,156,271,255
Central,Westmoreland County,51193,220,1380,1600,319,3006,3325,35475,387787,423262,07/01/2013 12:00:00 AM,161,281,265
Central,Westmoreland County,51193,220,1390,1610,318,3040,3358,30550,355173,385723,02/01/2014 12:00:00 AM,139,256,240
Central,Westmoreland County,51193,221,1384,1605,318,3019,3337,35589,386899,422488,08/01/2013 12:00:00 AM,161,280,263
Central,Westmoreland County,51193,222,1268,1490,336,2913,3249,38131,343993,382124,06/01/2015 12:00:00 AM,172,271,256
Central,Westmoreland County,51193,222,1366,1588,319,2985,3304,35114,378995,414109,09/01/2013 12:00:00 AM,158,277,261
Central,Westmoreland County,51193,222,1383,1605,328,3023,3351,31647,347753,379400,01/01/2014 12:00:00 AM,143,251,236
Central,Westmoreland County,51193,224,1325,1549,337,2807,3144,60540,483705,544245,07/01/2020 12:00:00 AM,270,365,351
Central,Westmoreland County,51193,224,1392,1616,337,3029,3366,38089,389817,427906,06/01/2013 12:00:00 AM,170,280,265
Central,Westmoreland County,51193,225,1396,1621,337,3047,3384,38177,394970,433147,05/01/2013 12:00:00 AM,170,283,267
Central,Westmoreland County,51193,226,1278,1504,342,2946,3288,38140,349723,387863,04/01/2015 12:00:00 AM,169,274,258
Central,Westmoreland County,51193,226,1367,1593,329,2980,3309,33086,345579,378665,11/01/2013 12:00:00 AM,146,253,238
Central,Westmoreland County,51193,226,1373,1599,329,3003,3332,32421,349414,381835,12/01/2013 12:00:00 AM,143,254,239
Central,Westmoreland County,51193,231,1266,1497,349,2895,3244,39312,344073,383385,05/01/2015 12:00:00 AM,170,272,256
Eastern,Accomack County,51001,432,1887,2319,592,4372,4964,58202,512516,570718,06/01/2018 12:00:00 AM,135,272,246
Eastern,Accomack County,51001,432,1890,2322,587,4330,4917,59484,515998,575482,02/01/2018 12:00:00 AM,138,273,248
Eastern,Accomack County,51001,435,1881,2316,596,4345,4941,58782,509810,568592,07/01/2018 12:00:00 AM,135,271,246
Eastern,Accomack County,51001,435,1897,2332,591,4380,4971,56549,516065,572614,04/01/2018 12:00:00 AM,130,272,246
Eastern,Accomack County,51001,438,1832,2270,582,4177,4759,54389,498870,553259,10/01/2018 12:00:00 AM,124,272,244
Eastern,Accomack County,51001,438,1872,2310,599,4332,4931,57828,514006,571834,05/01/2018 12:00:00 AM,132,275,248
Eastern,Accomack County,51001,439,1839,2278,596,4249,4845,58363,496541,554904,08/01/2018 12:00:00 AM,133,270,244
Eastern,Accomack County,51001,440,1825,2265,585,4195,4780,54753,508249,563002,09/01/2018 12:00:00 AM,124,278,249
Eastern,Accomack County,51001,441,1762,2203,610,3972,4582,54655,466485.85,521140.85,02/01/2020 12:00:00 AM,124,265,237
Eastern,Accomack County,51001,441,1835,2276,576,4215,4791,55774,505272,561046,12/01/2018 12:00:00 AM,126,275,247
Eastern,Accomack County,51001,441,1889,2330,595,4334,4929,60128,519070,579198,12/01/2017 12:00:00 AM,136,275,249
Eastern,Accomack County,51001,441,1897,2338,610,4341,4951,59114,519546,578660,01/01/2018 12:00:00 AM,134,274,248
Eastern,Accomack County,51001,442,1817,2259,610,4072,4682,111626,695159,806785,03/01/2020 12:00:00 AM,253,383,357
Eastern,Accomack County,51001,442,1911,2353,599,4357,4956,57628,515234,572862,03/01/2018 12:00:00 AM,130,270,243
Eastern,Accomack County,51001,444,1776,2220,586,4035,4621,51925,475744,527669,08/01/2019 12:00:00 AM,117,268,238
Eastern,Accomack County,51001,444,1793,2237,591,4069,4660,52891,490440.97,543331.97,07/01/2019 12:00:00 AM,119,274,243
Eastern,Accomack County,51001,444,1841,2285,594,4220,4814,59963,495006,554969,11/01/2018 12:00:00 AM,135,269,243
Eastern,Accomack County,51001,445,1808,2253,587,4140,4727,54447,504440,558887,01/01/2019 12:00:00 AM,122,279,248
Eastern,Accomack County,51001,446,1774,2220,610,3972,4582,53544,467572,521116,01/01/2020 12:00:00 AM,120,264,235
Eastern,Accomack County,51001,447,1873,2320,599,4301,4900,58737,510017,568754,08/01/2017 12:00:00 AM,131,272,245
Eastern,Accomack County,51001,447,1921,2368,597,4395,4992,59121,525438,584559,06/01/2017 12:00:00 AM,132,274,247
Eastern,Accomack County,51001,447,2004,2451,591,4566,5157,57847,548360,606207,03/01/2017 12:00:00 AM,129,274,247
Eastern,Accomack County,51001,448,1781,2229,598,4093,4691,55557,474574,530131,02/01/2019 12:00:00 AM,124,266,238
Eastern,Accomack County,51001,448,1866,2314,604,4323,4927,60920,513270,574190,09/01/2017 12:00:00 AM,136,275,248
Eastern,Accomack County,51001,448,1934,2382,603,4402,5005,61586,524732,586318,05/01/2017 12:00:00 AM,137,271,246
Eastern,Accomack County,51001,449,1793,2242,600,4100,4700,53945,490150,544095,06/01/2019 12:00:00 AM,120,273,243
Eastern,Accomack County,51001,450,1943,2393,605,4432,5037,58022,528945,586967,04/01/2017 12:00:00 AM,129,272,245
Eastern,Accomack County,51001,451,1851,2302,614,4245,4859,61053,507679,568732,07/01/2017 12:00:00 AM,135,274,247
Eastern,Accomack County,51001,452,1750,2202,600,3957,4557,53484,474464,527948,10/01/2019 12:00:00 AM,118,271,240
Eastern,Accomack County,51001,452,2049,2501,629,4693,5322,61347,544366,605713,01/01/2017 12:00:00 AM,136,266,242
Eastern,Accomack County,51001,453,2048,2501,604,4723,5327,58206,552629,610835,02/01/2017 12:00:00 AM,128,270,244
Eastern,Accomack County,51001,454,1850,2304,617,4323,4940,63668,511401,575069,10/01/2017 12:00:00 AM,140,276,250
Eastern,Accomack County,51001,455,1725,2180,617,3897,4514,54976,453947,508923,11/01/2019 12:00:00 AM,121,263,233
Eastern,Accomack County,51001,455,1744,2199,598,3954,4552,52157,469195,521352,09/01/2019 12:00:00 AM,115,269,237
Eastern,Accomack County,51001,455,1853,2308,619,4296,4915,62939,510451,573390,11/01/2017 12:00:00 AM,138,275,248
Eastern,Accomack County,51001,456,1828,2284,607,4195,4802,54199,506848,561047,05/01/2019 12:00:00 AM,119,277,246
Eastern,Accomack County,51001,457,1853,2310,607,4223,4830,54638,495282,549920,03/01/2019 12:00:00 AM,120,267,238
Eastern,Accomack County,51001,457,2018,2475,627,4673,5300,61005,534258,595263,12/01/2016 12:00:00 AM,133,265,241
Eastern,Accomack County,51001,459,1781,2240,625,4012,4637,55425,474810,530235,12/01/2019 12:00:00 AM,121,267,237
Eastern,Accomack County,51001,461,1932,2393,646,4313,4959,117215,743042,860257,04/01/2020 12:00:00 AM,254,385,359
Eastern,Accomack County,51001,462,1970,2432,618,4365,4983,137667,934504,1072171,02/01/2021 12:00:00 AM,298,474,441
Eastern,Accomack County,51001,464,1867,2331,617,4251,4868,56553,506850,563403,04/01/2019 12:00:00 AM,122,271,242
Eastern,Accomack County,51001,464,1957,2421,631,4322,4953,121768,797046,918814,12/01/2020 12:00:00 AM,262,407,380
Eastern,Accomack County,51001,465,1980,2445,650,4387,5037,119511,756751,876262,05/01/2020 12:00:00 AM,257,382,358
Eastern,Accomack County,51001,466,1959,2425,646,4552,5198,61533,516948,578481,10/01/2016 12:00:00 AM,132,264,239
Eastern,Accomack County,51001,466,1988,2454,644,4639,5283,61610,531730,593340,11/01/2016 12:00:00 AM,132,267,242
Eastern,Accomack County,51001,466,1994,2460,639,4604,5243,59976,520811,580787,09/01/2016 12:00:00 AM,129,261,236
Eastern,Accomack County,51001,467,1928,2395,640,4263,4903,143462,898863,1042325,01/01/2021 12:00:00 AM,307,466,435
Eastern,Accomack County,51001,468,1960,2428,652,4329,4981,123165,791360,914525,10/01/2020 12:00:00 AM,263,404,377
Eastern,Accomack County,51001,469,2011,2480,655,4445,5100,119686,768488,888174,06/01/2020 12:00:00 AM,255,382,358
Eastern,Accomack County,51001,470,1937,2407,638,4284,4922,125500,786661,912161,11/01/2020 12:00:00 AM,267,406,379
Eastern,Accomack County,51001,472,2026,2498,669,4476,5145,123570,775895,899465,08/01/2020 12:00:00 AM,262,383,360
Eastern,Accomack County,51001,472,2064,2536,639,4739,5378,58115,541732,599847,07/01/2016 12:00:00 AM,123,262,237
Eastern,Accomack County,51001,474,2080,2554,642,4813,5455,59018,549397,608415,06/01/2016 12:00:00 AM,125,264,238
Eastern,Accomack County,51001,475,2001,2476,665,4429,5094,123329,756808,880137,09/01/2020 12:00:00 AM,260,378,355
Eastern,Accomack County,51001,475,2029,2504,651,4652,5303,60781,533209,593990,08/01/2016 12:00:00 AM,128,263,237
Eastern,Accomack County,51001,476,1954,2430,635,4292,4927,142729,899959,1042688,03/01/2021 12:00:00 AM,300,461,429
Eastern,Accomack County,51001,476,2244,2720,683,5156,5839,66041,592157,658198,08/01/2015 12:00:00 AM,139,264,242
Eastern,Accomack County,51001,477,2056,2533,669,4556,5225,123007,788802,911809,07/01/2020 12:00:00 AM,258,384,360
Eastern,Accomack County,51001,477,2173,2650,645,4982,5627,61430,562772,624202,12/01/2015 12:00:00 AM,129,259,236
Eastern,Accomack County,51001,478,1919,2397,651,4156,4807,152432,952876,1105308,05/01/2021 12:00:00 AM,319,497,461
Eastern,Accomack County,51001,482,1935,2417,652,4218,4870,151010,962445,1113455,04/01/2021 12:00:00 AM,313,497,461
Eastern,Accomack County,51001,482,2149,2631,657,4956,5613,62653,559694,622347,01/01/2016 12:00:00 AM,130,260,237
Eastern,Accomack County,51001,483,2188,2671,679,5020,5699,65255,570651,635906,09/01/2015 12:00:00 AM,135,261,238
Eastern,Accomack County,51001,484,2076,2560,668,4838,5506,62893,557096,619989,05/01/2016 12:00:00 AM,130,268,242
Eastern,Accomack County,51001,484,2163,2647,653,4987,5640,62409,563968,626377,11/01/2015 12:00:00 AM,129,261,237
Eastern,Accomack County,51001,486,2148,2634,671,4945,5616,66191,565427,631618,02/01/2016 12:00:00 AM,136,263,240
Eastern,Accomack County,51001,486,2384,2870,697,5470,6167,68122,637708,705830,04/01/2015 12:00:00 AM,140,267,246
Eastern,Accomack County,51001,488,1908,2396,668,4145,4813,156369,960589,1116958,06/01/2021 12:00:00 AM,320,503,466
Eastern,Accomack County,51001,488,2282,2770,716,5244,5960,69155,607067,676222,07/01/2015 12:00:00 AM,142,266,244
Eastern,Accomack County,51001,488,2341,2829,705,5367,6072,69058,628302,697360,05/01/2015 12:00:00 AM,142,268,247
Eastern,Accomack County,51001,489,2143,2632,672,4968,5640,63612,556644,620256,10/01/2015 12:00:00 AM,130,260,236
Eastern,Accomack County,51001,492,2107,2599,676,4921,5597,65245,561359,626604,04/01/2016 12:00:00 AM,133,266,241
Eastern,Accomack County,51001,493,2319,2812,710,5329,6039,69280,616550,685830,06/01/2015 12:00:00 AM,141,266,244
Eastern,Accomack County,51001,497,2122,2619,706,4900,5606,70156,565046,635202,03/01/2016 12:00:00 AM,141,266,243
Eastern,Accomack County,51001,497,2380,2877,718,5440,6158,67699,634893,702592,02/01/2015 12:00:00 AM,136,267,244
Eastern,Accomack County,51001,497,2428,2925,737,5509,6246,73268,645570,718838,12/01/2014 12:00:00 AM,147,266,246
Eastern,Accomack County,51001,502,2436,2938,736,5517,6253,73709,645890,719599,11/01/2014 12:00:00 AM,147,265,245
Eastern,Accomack County,51001,502,2690,3192,782,6015,6797,84515,760234,844749,05/01/2012 12:00:00 AM,168,283,265
Eastern,Accomack County,51001,503,2372,2875,733,5425,6158,71482,631631,703113,03/01/2015 12:00:00 AM,142,266,245
Eastern,Accomack County,51001,503,2463,2966,736,5579,6315,72514,642936,715450,10/01/2014 12:00:00 AM,144,261,241
Eastern,Accomack County,51001,505,2675,3180,795,5972,6767,85481,753762,839243,04/01/2012 12:00:00 AM,169,282,264
Eastern,Accomack County,51001,506,2424,2930,739,5505,6244,71446,633447,704893,01/01/2015 12:00:00 AM,141,261,241
Eastern,Accomack County,51001,511,2496,3007,738,5654,6392,68133,627567,695700,09/01/2014 12:00:00 AM,133,251,231
Eastern,Accomack County,51001,511,2723,3234,788,6074,6862,85316,770062,855378,06/01/2012 12:00:00 AM,167,283,264
Eastern,Accomack County,51001,514,2688,3202,807,5988,6795,87850,754730,842580,03/01/2012 12:00:00 AM,171,281,263
Eastern,Accomack County,51001,518,2607,3125,755,5866,6621,71660,664369,736029,07/01/2014 12:00:00 AM,138,255,236
Eastern,Accomack County,51001,520,2557,3077,755,5775,6530,72483,648066,720549,08/01/2014 12:00:00 AM,139,253,234
Eastern,Accomack County,51001,522,2661,3183,774,5946,6720,72933,685175,758108,06/01/2014 12:00:00 AM,140,257,238
Eastern,Accomack County,51001,526,2677,3203,805,5995,6800,88675,743111,831786,01/01/2012 12:00:00 AM,169,278,260
Eastern,Accomack County,51001,526,2696,3222,815,6035,6850,89181,756444,845625,02/01/2012 12:00:00 AM,170,281,262
Eastern,Accomack County,51001,526,2731,3257,817,6068,6885,89390,765329,854719,07/01/2012 12:00:00 AM,170,280,262
Eastern,Accomack County,51001,526,2748,3274,816,6105,6921,88055,761540,849595,08/01/2012 12:00:00 AM,167,277,259
Eastern,Accomack County,51001,528,2695,3223,829,6017,6846,88611,752823,841434,09/01/2012 12:00:00 AM,168,279,261
Eastern,Accomack County,51001,529,2735,3264,835,6063,6898,117480,968017,1085497,11/01/2012 12:00:00 AM,222,354,333
Eastern,Accomack County,51001,531,2853,3384,804,6294,7098,87629,785853,873482,06/01/2013 12:00:00 AM,165,275,258
Eastern,Accomack County,51001,532,2841,3373,794,6278,7072,83920,784798,868718,07/01/2013 12:00:00 AM,158,276,258
Eastern,Accomack County,51001,533,2755,3288,803,6116,6919,77649,712117,789766,04/01/2014 12:00:00 AM,146,258,240
Eastern,Accomack County,51001,533,2862,3395,822,6314,7136,89419,795107,884526,04/01/2013 12:00:00 AM,168,278,261
Eastern,Accomack County,51001,535,2863,3398,827,6329,7156,89957,797319,887276,03/01/2013 12:00:00 AM,168,278,261
Eastern,Accomack County,51001,536,2815,3351,834,6251,7085,89321,780637,869958,01/01/2013 12:00:00 AM,167,277,260
Eastern,Accomack County,51001,536,2841,3377,827,6272,7099,89086,789513,878599,05/01/2013 12:00:00 AM,166,278,260
Eastern,Accomack County,51001,537,2757,3294,855,6117,6972,93700,772753,866453,12/01/2012 12:00:00 AM,174,280,263
Eastern,Accomack County,51001,539,2695,3234,854,5967,6821,93160,749865,843025,10/01/2012 12:00:00 AM,173,278,261
Eastern,Accomack County,51001,541,2695,3236,814,6024,6838,79312,697052,776364,05/01/2014 12:00:00 AM,147,259,240
Eastern,Accomack County,51001,541,2836,3377,823,6287,7110,87725,781503,869228,08/01/2013 12:00:00 AM,162,276,257
Eastern,Accomack County,51001,542,2782,3324,805,6143,6948,79657,704141,783798,12/01/2013 12:00:00 AM,147,253,236
Eastern,Accomack County,51001,544,2788,3332,834,6138,6972,79910,702822,782732,01/01/2014 12:00:00 AM,147,252,235
Eastern,Accomack County,51001,546,2838,3384,844,6312,7156,91455,794508,885963,02/01/2013 12:00:00 AM,168,280,262
Eastern,Accomack County,51001,547,2778,3325,834,6110,6944,81116,711417,792533,02/01/2014 12:00:00 AM,148,256,238
Eastern,Accomack County,51001,549,2761,3310,816,6143,6959,80395,700377,780772,11/01/2013 12:00:00 AM,146,254,236
Eastern,Accomack County,51001,550,2770,3320,838,6096,6934,81690,706153,787843,03/01/2014 12:00:00 AM,149,255,237
Eastern,Accomack County,51001,552,2772,3324,837,6170,7007,90134,756637,846771,10/01/2013 12:00:00 AM,163,273,255
Eastern,Accomack County,51001,553,2813,3366,838,6228,7066,89098,763843,852941,09/01/2013 12:00:00 AM,161,272,253
Eastern,Brunswick County,51025,332,1216,1548,423,2289,2712,35254,257391,292645,02/01/2019 12:00:00 AM,106,212,189
Eastern,Brunswick County,51025,333,1311,1644,423,2500,2923,37599,291660,329259,09/01/2019 12:00:00 AM,113,222,200
Eastern,Brunswick County,51025,336,1309,1645,433,2464,2897,36718,285781,322499,06/01/2019 12:00:00 AM,109,218,196
Eastern,Brunswick County,51025,336,1310,1646,427,2453,2880,36909,282895,319804,07/01/2019 12:00:00 AM,110,216,194
Eastern,Brunswick County,51025,336,1333,1669,417,2526,2943,35153,293343,328496,08/01/2019 12:00:00 AM,105,220,197
Eastern,Brunswick County,51025,337,1283,1620,436,2423,2859,38105,272960,311065,03/01/2019 12:00:00 AM,113,213,192
Eastern,Brunswick County,51025,338,1284,1622,434,2422,2856,36189,274290,310479,05/01/2019 12:00:00 AM,107,214,191
Eastern,Brunswick County,51025,340,1290,1630,428,2473,2901,37523,300081,337604,01/01/2019 12:00:00 AM,110,233,207
Eastern,Brunswick County,51025,341,1286,1627,439,2418,2857,37982,277329,315311,04/01/2019 12:00:00 AM,111,216,194
Eastern,Brunswick County,51025,342,1265,1607,429,2436,2865,39188,278774,317962,12/01/2018 12:00:00 AM,115,220,198
Eastern,Brunswick County,51025,342,1305,1647,428,2487,2915,37534,295474,333008,10/01/2019 12:00:00 AM,110,226,202
Eastern,Brunswick County,51025,342,1310,1652,431,2438,2869,96919,522443,619362,02/01/2021 12:00:00 AM,283,399,375
Eastern,Brunswick County,51025,347,1298,1645,442,2480,2922,38709,291914,330623,11/01/2019 12:00:00 AM,112,225,201
Eastern,Brunswick County,51025,350,1265,1615,442,2379,2821,37030,282327,319357,01/01/2020 12:00:00 AM,106,223,198
Eastern,Brunswick County,51025,350,1309,1659,454,2509,2963,41505,288537,330042,09/01/2018 12:00:00 AM,119,220,199
Eastern,Brunswick County,51025,350,1328,1678,443,2493,2936,40463,288868,329331,06/01/2018 12:00:00 AM,116,218,196
Eastern,Brunswick County,51025,351,1277,1628,450,2435,2885,83811,424556,508367,03/01/2020 12:00:00 AM,239,332,312
Eastern,Brunswick County,51025,352,1262,1614,449,2385,2834,39000,280490,319490,02/01/2020 12:00:00 AM,111,222,198
Eastern,Brunswick County,51025,352,1289,1641,459,2476,2935,47819.5,312377.5,360197,10/01/2018 12:00:00 AM,136,242,219
Eastern,Brunswick County,51025,352,1331,1683,453,2539,2992,83103,441636,524739,04/01/2020 12:00:00 AM,236,332,312
Eastern,Brunswick County,51025,353,1279,1632,459,2466,2925,42351,286015,328366,11/01/2018 12:00:00 AM,120,224,201
Eastern,Brunswick County,51025,353,1301,1654,452,2417,2869,103570.96,528484.91,632055.87,03/01/2021 12:00:00 AM,293,406,382
Eastern,Brunswick County,51025,353,1303,1656,457,2479,2936,42004,282196,324200,08/01/2018 12:00:00 AM,119,217,196
Eastern,Brunswick County,51025,355,1311,1666,461,2493,2954,41423,290522,331945,07/01/2018 12:00:00 AM,117,222,199
Eastern,Brunswick County,51025,356,1364,1720,462,2583,3045,85776,449768,535544,05/01/2020 12:00:00 AM,241,330,311
Eastern,Brunswick County,51025,358,1282,1640,455,2457,2912,40011,290125.59,330136.59,12/01/2019 12:00:00 AM,112,226,201
Eastern,Brunswick County,51025,358,1352,1710,457,2590,3047,39947,297980,337927,04/01/2018 12:00:00 AM,112,220,198
Eastern,Brunswick County,51025,358,1391,1749,462,2617,3079,85246,461392,546638,06/01/2020 12:00:00 AM,238,332,313
Eastern,Brunswick County,51025,359,1284,1643,473,2374,2847,110372,557873,668245,04/01/2021 12:00:00 AM,307,434,407
Eastern,Brunswick County,51025,359,1297,1656,480,2408,2888,107817,510034,617851,01/01/2021 12:00:00 AM,300,393,373
Eastern,Brunswick County,51025,362,1275,1637,486,2332,2818,112503,545789,658292,05/01/2021 12:00:00 AM,311,428,402
Eastern,Brunswick County,51025,362,1283,1645,483,2365,2848,112864,552399,665263,06/01/2021 12:00:00 AM,312,431,404
Eastern,Brunswick County,51025,362,1306,1668,481,2429,2910,93199,447434,540633,12/01/2020 12:00:00 AM,257,343,324
Eastern,Brunswick County,51025,363,1319,1682,482,2425,2907,93449,450419,543868,11/01/2020 12:00:00 AM,257,341,323
Eastern,Brunswick County,51025,365,1322,1687,492,2464,2956,95375,455985,551360,10/01/2020 12:00:00 AM,261,345,327
Eastern,Brunswick County,51025,367,1330,1697,469,2521,2990,43644,294607,338251,05/01/2018 12:00:00 AM,119,222,199
Eastern,Brunswick County,51025,367,1363,1730,465,2597,3062,41194,295800,336994,03/01/2018 12:00:00 AM,112,217,195
Eastern,Brunswick County,51025,368,1377,1745,495,2571,3066,90344,448247,538591,09/01/2020 12:00:00 AM,246,326,309
Eastern,Brunswick County,51025,368,1386,1754,496,2582,3078,91122,448261,539383,08/01/2020 12:00:00 AM,248,323,308
Eastern,Brunswick County,51025,370,1402,1772,494,2624,3118,90451,458446,548897,07/01/2020 12:00:00 AM,244,327,310
Eastern,Brunswick County,51025,371,1446,1817,476,2768,3244,43595,316994,360589,05/01/2017 12:00:00 AM,118,219,198
Eastern,Brunswick County,51025,372,1358,1730,478,2603,3081,42340,292815,335155,02/01/2018 12:00:00 AM,114,216,194
Eastern,Brunswick County,51025,373,1439,1812,480,2770,3250,42925,318377,361302,04/01/2017 12:00:00 AM,115,221,199
Eastern,Brunswick County,51025,374,1454,1828,470,2797,3267,42560,316353,358913,03/01/2017 12:00:00 AM,114,218,196
Eastern,Brunswick County,51025,379,1449,1828,493,2739,3232,45404,310927,356331,06/01/2017 12:00:00 AM,120,215,195
Eastern,Brunswick County,51025,380,1379,1759,486,2651,3137,43794,298935,342729,12/01/2017 12:00:00 AM,115,217,195
Eastern,Brunswick County,51025,380,1381,1761,491,2645,3136,42977,298612,341589,01/01/2018 12:00:00 AM,113,216,194
Eastern,Brunswick County,51025,380,1402,1782,482,2706,3188,44348,305272,349620,11/01/2017 12:00:00 AM,117,218,196
Eastern,Brunswick County,51025,385,1454,1839,488,2773,3261,43657,318873,362530,08/01/2017 12:00:00 AM,113,219,197
Eastern,Brunswick County,51025,386,1422,1808,491,2720,3211,44526,307870,352396,10/01/2017 12:00:00 AM,115,217,195
Eastern,Brunswick County,51025,387,1476,1863,495,2863,3358,44431,320818,365249,02/01/2017 12:00:00 AM,115,217,196
Eastern,Brunswick County,51025,388,1463,1851,496,2801,3297,44945,320982,365927,07/01/2017 12:00:00 AM,116,219,198
Eastern,Brunswick County,51025,390,1480,1870,494,2879,3373,43217,324844,368061,01/01/2017 12:00:00 AM,111,219,197
Eastern,Brunswick County,51025,391,1449,1840,492,2768,3260,44505,317096,361601,09/01/2017 12:00:00 AM,114,219,197
Eastern,Brunswick County,51025,392,1520,1912,500,2943,3443,44772,332041,376813,05/01/2016 12:00:00 AM,114,218,197
Eastern,Brunswick County,51025,394,1516,1910,521,2919,3440,47273,327265,374538,04/01/2016 12:00:00 AM,120,216,196
Eastern,Brunswick County,51025,396,1485,1881,506,2893,3399,46096,329016,375112,12/01/2016 12:00:00 AM,116,222,199
Eastern,Brunswick County,51025,396,1524,1920,512,2938,3450,46388,330272,376660,03/01/2016 12:00:00 AM,117,217,196
Eastern,Brunswick County,51025,397,1523,1920,497,2970,3467,44947,333478,378425,06/01/2016 12:00:00 AM,113,219,197
Eastern,Brunswick County,51025,398,1665,2063,562,3313,3875,58752,408261,467013,04/01/2012 12:00:00 AM,148,245,226
Eastern,Brunswick County,51025,399,1514,1913,505,2960,3465,46873,335220,382093,09/01/2016 12:00:00 AM,117,221,200
Eastern,Brunswick County,51025,399,1535,1934,520,2968,3488,47289,334671,381960,02/01/2016 12:00:00 AM,119,218,197
Eastern,Brunswick County,51025,400,1479,1879,507,2881,3388,46385,326705,373090,11/01/2016 12:00:00 AM,116,221,199
Eastern,Brunswick County,51025,400,1659,2059,580,3285,3865,60206,404179,464385,05/01/2012 12:00:00 AM,151,244,226
Eastern,Brunswick County,51025,401,1484,1885,510,2885,3395,46242,324986,371228,10/01/2016 12:00:00 AM,115,219,197
Eastern,Brunswick County,51025,401,1508,1909,507,2950,3457,46409,331931,378340,07/01/2016 12:00:00 AM,116,220,198
Eastern,Brunswick County,51025,401,1675,2076,590,3352,3942,63761,402093,465854,01/01/2012 12:00:00 AM,159,240,224
Eastern,Brunswick County,51025,402,1513,1915,507,2974,3481,46393,336210,382603,08/01/2016 12:00:00 AM,115,222,200
Eastern,Brunswick County,51025,402,1549,1951,547,2998,3545,52357,340185,392542,11/01/2015 12:00:00 AM,130,220,201
Eastern,Brunswick County,51025,403,1672,2075,594,3320,3914,63944,405275,469219,02/01/2012 12:00:00 AM,159,242,226
Eastern,Brunswick County,51025,403,1679,2082,580,3345,3925,61124,415588,476712,07/01/2012 12:00:00 AM,152,248,229
Eastern,Brunswick County,51025,404,1535,1939,538,2983,3521,50374,331832,382206,12/01/2015 12:00:00 AM,125,216,197
Eastern,Brunswick County,51025,404,1567,1971,571,3047,3618,55706,348125,403831,06/01/2015 12:00:00 AM,138,222,205
Eastern,Brunswick County,51025,404,1661,2065,589,3305,3894,61169,408578,469747,06/01/2012 12:00:00 AM,151,246,227
Eastern,Brunswick County,51025,404,1667,2071,579,3326,3905,62052,406839,468891,03/01/2012 12:00:00 AM,154,244,226
Eastern,Brunswick County,51025,405,1515,1920,529,2939,3468,48531,330855,379386,01/01/2016 12:00:00 AM,120,218,198
Eastern,Brunswick County,51025,405,1571,1976,562,3033,3595,54551,343974,398525,09/01/2015 12:00:00 AM,135,219,202
Eastern,Brunswick County,51025,406,1560,1966,551,3033,3584,52550,342762,395312,10/01/2015 12:00:00 AM,129,220,201
Eastern,Brunswick County,51025,406,1582,1988,576,3050,3626,56120,347223,403343,07/01/2015 12:00:00 AM,138,219,203
Eastern,Brunswick County,51025,408,1561,1969,584,3044,3628,57511,348348,405859,05/01/2015 12:00:00 AM,141,223,206
Eastern,Brunswick County,51025,409,1569,1978,593,3083,3676,57320,350782,408102,12/01/2014 12:00:00 AM,140,224,206
Eastern,Brunswick County,51025,413,1554,1967,617,3022,3639,60712,338519,399231,02/01/2015 12:00:00 AM,147,218,203
Eastern,Brunswick County,51025,413,1566,1979,608,3039,3647,61026,340220,401246,03/01/2015 12:00:00 AM,148,217,203
Eastern,Brunswick County,51025,413,1578,1991,579,3036,3615,56368,344706,401074,08/01/2015 12:00:00 AM,136,218,201
Eastern,Brunswick County,51025,414,1565,1979,599,3090,3689,59343,350465,409808,11/01/2014 12:00:00 AM,143,224,207
Eastern,Brunswick County,51025,415,1557,1972,608,3028,3636,61014,343693,404707,04/01/2015 12:00:00 AM,147,221,205
Eastern,Brunswick County,51025,415,1671,2086,603,3344,3947,64554,412585,477139,08/01/2012 12:00:00 AM,156,247,229
Eastern,Brunswick County,51025,416,1572,1988,599,3143,3742,59462,358106,417568,10/01/2014 12:00:00 AM,143,228,210
Eastern,Brunswick County,51025,417,1565,1982,614,3050,3664,59730,339392,399122,01/01/2015 12:00:00 AM,143,217,201
Eastern,Brunswick County,51025,417,1682,2099,574,3289,3863,52719,370928,423647,03/01/2014 12:00:00 AM,126,221,202
Eastern,Brunswick County,51025,418,1683,2101,575,3325,3900,53237,367844,421081,01/01/2014 12:00:00 AM,127,219,200
Eastern,Brunswick County,51025,421,1574,1995,597,3155,3752,55980,345283,401263,08/01/2014 12:00:00 AM,133,219,201
Eastern,Brunswick County,51025,421,1584,2005,582,3180,3762,52929,353449,406378,07/01/2014 12:00:00 AM,126,223,203
Eastern,Brunswick County,51025,421,1645,2066,582,3235,3817,53145,365616,418761,05/01/2014 12:00:00 AM,126,222,203
Eastern,Brunswick County,51025,421,1681,2102,582,3282,3864,53357,370893,424250,04/01/2014 12:00:00 AM,127,221,202
Eastern,Brunswick County,51025,423,1567,1990,617,3137,3754,57960,341928,399888,09/01/2014 12:00:00 AM,137,218,201
Eastern,Brunswick County,51025,423,1681,2104,580,3305,3885,53986,374235,428221,02/01/2014 12:00:00 AM,128,223,204
Eastern,Brunswick County,51025,425,1630,2055,592,3231,3823,54242,363700,417942,06/01/2014 12:00:00 AM,128,223,203
Eastern,Brunswick County,51025,425,1661,2086,618,3318,3936,66504,406669,473173,09/01/2012 12:00:00 AM,156,245,227
Eastern,Brunswick County,51025,425,1666,2091,605,3276,3881,64061,399178,463239,10/01/2013 12:00:00 AM,151,240,222
Eastern,Brunswick County,51025,428,1670,2098,615,3269,3884,59764,368944,428708,12/01/2013 12:00:00 AM,140,221,204
Eastern,Brunswick County,51025,430,1684,2114,614,3289,3903,59419,370575,429994,11/01/2013 12:00:00 AM,138,220,203
Eastern,Brunswick County,51025,435,1663,2098,630,3332,3962,67424,406624,474048,10/01/2012 12:00:00 AM,155,245,226
Eastern,Brunswick County,51025,435,1666,2101,629,3281,3910,67977,401983,469960,09/01/2013 12:00:00 AM,156,241,224
Eastern,Brunswick County,51025,437,1680,2117,651,3267,3918,67387,402339,469726,02/01/2013 12:00:00 AM,154,239,222
Eastern,Brunswick County,51025,437,1681,2118,660,3272,3932,69378,402097,471475,04/01/2013 12:00:00 AM,159,239,223
Eastern,Brunswick County,51025,438,1677,2115,660,3269,3929,69608,394606,464214,01/01/2013 12:00:00 AM,159,235,219
Eastern,Brunswick County,51025,438,1680,2118,653,3271,3924,67713,400117,467830,03/01/2013 12:00:00 AM,155,238,221
Eastern,Brunswick County,51025,438,1692,2130,638,3320,3958,68698,410047,478745,08/01/2013 12:00:00 AM,157,242,225
Eastern,Brunswick County,51025,439,1657,2096,664,3258,3922,73631,397174,470805,12/01/2012 12:00:00 AM,168,240,225
Eastern,Brunswick County,51025,439,1696,2135,644,3308,3952,67876,408918,476794,07/01/2013 12:00:00 AM,155,241,223
Eastern,Brunswick County,51025,440,1680,2120,646,3320,3966,70017,403264,473281,11/01/2012 12:00:00 AM,159,240,223
Eastern,Brunswick County,51025,441,1693,2134,651,3316,3967,67668,409820,477488,06/01/2013 12:00:00 AM,153,242,224
Eastern,Brunswick County,51025,445,1675,2120,668,3272,3940,70452,404615,475067,05/01/2013 12:00:00 AM,158,242,224
Eastern,Chesapeake City,51550,1485,7003,8488,2120,16920,19040,233981.5,2166361,2400342.5,07/01/2017 12:00:00 AM,158,309,283
Eastern,Chesapeake City,51550,1490,7078,8568,2135,17117,19252,236675,2200563,2437238,06/01/2017 12:00:00 AM,159,311,284
Eastern,Chesapeake City,51550,1503,7102,8605,2166,17102,19268,242371,2217811,2460182,08/01/2017 12:00:00 AM,161,312,286
Eastern,Chesapeake City,51550,1504,7171,8675,2169,17217,19386,243189,2206758,2449947,04/01/2017 12:00:00 AM,162,308,282
Eastern,Chesapeake City,51550,1515,7110,8625,2178,17109,19287,243731,2193437,2437168,05/01/2017 12:00:00 AM,161,309,283
Eastern,Chesapeake City,51550,1515,7377,8892,2196,17645,19841,240511,2257550,2498061,03/01/2017 12:00:00 AM,159,306,281
Eastern,Chesapeake City,51550,1528,7119,8647,2215,17041,19256,246489,2186191,2432680,09/01/2017 12:00:00 AM,161,307,281
Eastern,Chesapeake City,51550,1559,7483,9042,2302,17995,20297,251976,2256317,2508293,01/01/2017 12:00:00 AM,162,302,277
Eastern,Chesapeake City,51550,1564,7152,8716,2283,17117,19400,256622,2161959,2418581,10/01/2017 12:00:00 AM,164,302,277
Eastern,Chesapeake City,51550,1567,7644,9211,2376,18419,20795,269684,2314811,2584495,11/01/2016 12:00:00 AM,172,303,281
Eastern,Chesapeake City,51550,1569,7565,9134,2373,18139,20512,264849,2280316,2545165,12/01/2016 12:00:00 AM,169,301,279
Eastern,Chesapeake City,51550,1573,7092,8665,2318,16984,19302,258287,2146081,2404368,11/01/2017 12:00:00 AM,164,303,277
Eastern,Chesapeake City,51550,1573,7564,9137,2302,18179,20481,251752,2287611,2539363,02/01/2017 12:00:00 AM,160,302,278
Eastern,Chesapeake City,51550,1578,6617,8195,2145,15309,17454,222736,1937658,2160394,01/01/2020 12:00:00 AM,141,293,264
Eastern,Chesapeake City,51550,1581,6857,8438,2322,16250,18572,255832,2056050,2311882,02/01/2018 12:00:00 AM,162,300,274
Eastern,Chesapeake City,51550,1582,6907,8489,2344,16400,18744,254217,2064028,2318245,01/01/2018 12:00:00 AM,161,299,273
Eastern,Chesapeake City,51550,1584,7051,8635,2351,16834,19185,266490,2131942,2398432,12/01/2017 12:00:00 AM,168,302,278
Eastern,Chesapeake City,51550,1586,6862,8448,2332,16216,18548,257074,2050313,2307387,03/01/2018 12:00:00 AM,162,299,273
Eastern,Chesapeake City,51550,1588,6815,8403,2156,15816,17972,225147,2000042,2225189,11/01/2019 12:00:00 AM,142,293,265
Eastern,Chesapeake City,51550,1590,6832,8422,2310,16154,18464,250541,2045493,2296034,09/01/2018 12:00:00 AM,158,299,273
Eastern,Chesapeake City,51550,1591,6527,8118,2163,15104,17267,226693,1916028,2142721,02/01/2020 12:00:00 AM,142,294,264
Eastern,Chesapeake City,51550,1591,6897,8488,2324,16306,18630,254418,2060378,2314796,08/01/2018 12:00:00 AM,160,299,273
Eastern,Chesapeake City,51550,1594,6587,8181,2257,15176,17433,240366,1923731,2164097,02/01/2019 12:00:00 AM,151,292,265
Eastern,Chesapeake City,51550,1594,7846,9440,2417,18763,21180,270644,2315571,2586215,05/01/2016 12:00:00 AM,170,295,274
Eastern,Chesapeake City,51550,1596,7692,9288,2458,18475,20933,283804,2350062,2633866,10/01/2016 12:00:00 AM,178,306,284
Eastern,Chesapeake City,51550,1598,6844,8442,2346,16157,18503,257298,2047458,2304756,05/01/2018 12:00:00 AM,161,299,273
Eastern,Chesapeake City,51550,1598,6854,8452,2212,15885,18097,231821,2026879,2258700,09/01/2019 12:00:00 AM,145,296,267
Eastern,Chesapeake City,51550,1598,6971,8569,2301,16228,18529,258299,2146289,2404588,01/01/2019 12:00:00 AM,162,308,281
Eastern,Chesapeake City,51550,1600,6898,8498,2210,16040,18250,231544,2027252,2258796,08/01/2019 12:00:00 AM,145,294,266
Eastern,Chesapeake City,51550,1600,7876,9476,2029,17354,19383,463087,3691323,4154410,02/01/2021 12:00:00 AM,289,469,438
Eastern,Chesapeake City,51550,1600,8139,9739,2466,19520,21986,278610,2440963,2719573,10/01/2015 12:00:00 AM,174,300,279
Eastern,Chesapeake City,51550,1602,6794,8396,2191,15736,17927,234522,2009923.51,2244445.51,12/01/2019 12:00:00 AM,146,296,267
Eastern,Chesapeake City,51550,1602,6868,8470,2310,16072,18382,257653,2045480,2303133,12/01/2018 12:00:00 AM,161,298,272
Eastern,Chesapeake City,51550,1602,6871,8473,2367,16271,18638,262377,2039601,2301978,07/01/2018 12:00:00 AM,164,297,272
Eastern,Chesapeake City,51550,1602,7822,9424,2455,18696,21151,276691,2311530,2588221,06/01/2016 12:00:00 AM,173,296,275
Eastern,Chesapeake City,51550,1602,8170,9772,2517,19558,22075,286061,2440265,2726326,09/01/2015 12:00:00 AM,179,299,279
Eastern,Chesapeake City,51550,1605,6845,8450,2183,15849,18032,231218,2030919,2262137,10/01/2019 12:00:00 AM,144,297,268
Eastern,Chesapeake City,51550,1605,7949,9554,2464,18900,21364,279658,2334311,2613969,04/01/2016 12:00:00 AM,174,294,274
Eastern,Chesapeake City,51550,1606,6837,8443,2350,16179,18529,256975,2050548,2307523,04/01/2018 12:00:00 AM,160,300,273
Eastern,Chesapeake City,51550,1606,7738,9344,2501,18523,21024,283967,2311120,2595087,09/01/2016 12:00:00 AM,177,299,278
Eastern,Chesapeake City,51550,1607,6916,8523,2310,15952,18262,240932,2026395,2267327,03/01/2019 12:00:00 AM,150,293,266
Eastern,Chesapeake City,51550,1607,8238,9845,2544,19657,22201,289595,2466653,2756248,08/01/2015 12:00:00 AM,180,299,280
Eastern,Chesapeake City,51550,1609,6850,8459,2369,16205,18574,260920,2041980,2302900,06/01/2018 12:00:00 AM,162,298,272
Eastern,Chesapeake City,51550,1609,6886,8495,2271,15953,18224,237601,2025650,2263251,05/01/2019 12:00:00 AM,148,294,266
Eastern,Chesapeake City,51550,1610,7798,9408,2498,18628,21126,283361,2321351,2604712,08/01/2016 12:00:00 AM,176,298,277
Eastern,Chesapeake City,51550,1611,6600,8211,2197,15315,17512,400258,2632058,3032316,03/01/2020 12:00:00 AM,248,399,369
Eastern,Chesapeake City,51550,1611,8228,9839,2577,19606,22183,293455,2468709,2762164,07/01/2015 12:00:00 AM,182,300,281
Eastern,Chesapeake City,51550,1613,6888,8501,2247,15892,18139,231995,2019601,2251596,06/01/2019 12:00:00 AM,144,293,265
Eastern,Chesapeake City,51550,1614,6897,8511,2354,16185,18539,268850,2067311,2336161,11/01/2018 12:00:00 AM,167,300,274
Eastern,Chesapeake City,51550,1614,7963,9577,2458,18895,21353,278913,2337954,2616867,03/01/2016 12:00:00 AM,173,294,273
Eastern,Chesapeake City,51550,1614,8126,9740,2505,19474,21979,284354,2429093,2713447,11/01/2015 12:00:00 AM,176,299,279
Eastern,Chesapeake City,51550,1620,7700,9320,2119,16827,18946,506959,3856047,4363006,04/01/2021 12:00:00 AM,313,501,468
Eastern,Chesapeake City,51550,1621,6868,8489,2276,15899,18175,235976,2014112,2250088,07/01/2019 12:00:00 AM,146,293,265
Eastern,Chesapeake City,51550,1621,7758,9379,2113,17030,19143,469377,3589683,4059060,03/01/2021 12:00:00 AM,290,463,433
Eastern,Chesapeake City,51550,1622,6835,8457,2284,15790,18074,237255,1991797,2229052,04/01/2019 12:00:00 AM,146,291,264
Eastern,Chesapeake City,51550,1622,7816,9438,2518,18668,21186,285103,2318685,2603788,07/01/2016 12:00:00 AM,176,297,276
Eastern,Chesapeake City,51550,1623,8281,9904,2612,19645,22257,298537,2459964,2758501,06/01/2015 12:00:00 AM,184,297,279
Eastern,Chesapeake City,51550,1624,6857,8481,2369,16112,18481,270688,2070259,2340947,10/01/2018 12:00:00 AM,167,302,276
Eastern,Chesapeake City,51550,1625,7665,9290,2132,16738,18870,507981,3873075,4381056,05/01/2021 12:00:00 AM,313,505,472
Eastern,Chesapeake City,51550,1626,8091,9717,2524,19328,21852,284767,2405443,2690210,12/01/2015 12:00:00 AM,175,297,277
Eastern,Chesapeake City,51550,1628,7972,9600,2488,18982,21470,281459,2357329,2638788,02/01/2016 12:00:00 AM,173,296,275
Eastern,Chesapeake City,51550,1628,8008,9636,2512,19020,21532,281775,2340673,2622448,01/01/2016 12:00:00 AM,173,292,272
Eastern,Chesapeake City,51550,1628,8269,9897,2612,19692,22304,302769,2464536,2767305,05/01/2015 12:00:00 AM,186,298,280
Eastern,Chesapeake City,51550,1628,8308,9936,2620,19678,22298,299687,2474233,2773920,04/01/2015 12:00:00 AM,184,298,279
Eastern,Chesapeake City,51550,1628,9369,10997,2761,20949,23710,308059,2578538,2886597,04/01/2014 12:00:00 AM,189,275,262
Eastern,Chesapeake City,51550,1639,7674,9313,2170,16771,18941,513620,3844052,4357672,06/01/2021 12:00:00 AM,313,501,468
Eastern,Chesapeake City,51550,1645,9431,11076,2816,21019,23835,314923,2586982,2901905,03/01/2014 12:00:00 AM,191,274,262
Eastern,Chesapeake City,51550,1646,9332,10978,2799,20911,23710,310495,2577264,2887759,05/01/2014 12:00:00 AM,189,276,263
Eastern,Chesapeake City,51550,1647,7680,9327,2227,17068,19295,498294,3576674,4074968,01/01/2021 12:00:00 AM,303,466,437
Eastern,Chesapeake City,51550,1647,9479,11126,2850,21110,23960,317434,2602535,2919969,02/01/2014 12:00:00 AM,193,275,262
Eastern,Chesapeake City,51550,1648,9649,11297,2838,21584,24422,320961,2663921,2984882,12/01/2013 12:00:00 AM,195,276,264
Eastern,Chesapeake City,51550,1650,9499,11149,2856,21260,24116,316876,2596642,2913518,01/01/2014 12:00:00 AM,192,273,261
Eastern,Chesapeake City,51550,1651,8303,9954,2717,19586,22303,310138,2453664,2763802,03/01/2015 12:00:00 AM,188,296,278
Eastern,Chesapeake City,51550,1653,9786,11439,2914,21885,24799,359964,2911881,3271845,10/01/2013 12:00:00 AM,218,298,286
Eastern,Chesapeake City,51550,1656,7391,9047,2266,16747,19013,415611,2907656,3323267,04/01/2020 12:00:00 AM,251,393,367
Eastern,Chesapeake City,51550,1657,9781,11438,2911,21959,24870,357400,2921655,3279055,09/01/2013 12:00:00 AM,216,299,287
Eastern,Chesapeake City,51550,1659,9344,11003,2804,21070,23874,312078,2599711,2911789,06/01/2014 12:00:00 AM,188,278,265
Eastern,Chesapeake City,51550,1663,9109,10772,2800,20810,23610,311599,2555354,2866953,08/01/2014 12:00:00 AM,187,281,266
Eastern,Chesapeake City,51550,1664,8408,10072,2774,19756,22530,323758,2482728,2806486,02/01/2015 12:00:00 AM,195,295,279
Eastern,Chesapeake City,51550,1670,9247,10917,2815,20991,23806,309779,2593507,2903286,07/01/2014 12:00:00 AM,185,280,266
Eastern,Chesapeake City,51550,1670,9663,11333,2907,21700,24607,332957,2682240,3015197,11/01/2013 12:00:00 AM,199,278,266
Eastern,Chesapeake City,51550,1672,7726,9398,2271,17317,19588,437796,3163107,3600903,12/01/2020 12:00:00 AM,262,409,383
Eastern,Chesapeake City,51550,1676,7931,9607,2244,17654,19898,411937,3039922,3451859,08/01/2020 12:00:00 AM,246,383,359
Eastern,Chesapeake City,51550,1677,8557,10234,2772,20044,22816,320432,2502516,2822948,01/01/2015 12:00:00 AM,191,292,276
Eastern,Chesapeake City,51550,1679,7668,9347,2259,17206,19465,440352,3184274,3624626,11/01/2020 12:00:00 AM,262,415,388
Eastern,Chesapeake City,51550,1679,9704,11383,2973,21797,24770,367425,2905328,3272753,08/01/2013 12:00:00 AM,219,299,288
Eastern,Chesapeake City,51550,1680,7736,9416,2260,17354,19614,439917,3186399,3626316,10/01/2020 12:00:00 AM,262,412,385
Eastern,Chesapeake City,51550,1682,7893,9575,2253,17696,19949,414803,3044949,3459752,09/01/2020 12:00:00 AM,247,386,361
Eastern,Chesapeake City,51550,1682,9573,11255,3010,21527,24537,374607,2855523,3230130,07/01/2013 12:00:00 AM,223,298,287
Eastern,Chesapeake City,51550,1682,9578,11260,3001,21605,24606,371916,2873378,3245294,06/01/2013 12:00:00 AM,221,300,288
Eastern,Chesapeake City,51550,1686,8873,10559,2826,20469,23295,330830,2614515,2945345,10/01/2014 12:00:00 AM,196,295,279
Eastern,Chesapeake City,51550,1691,7780,9471,2309,17494,19803,423438,3051535,3474973,05/01/2020 12:00:00 AM,250,392,367
Eastern,Chesapeake City,51550,1691,8774,10465,2827,20401,23228,330901,2580530,2911431,12/01/2014 12:00:00 AM,196,294,278
Eastern,Chesapeake City,51550,1692,8037,9729,2270,17960,20230,418512,3097322,3515834,07/01/2020 12:00:00 AM,247,385,361
Eastern,Chesapeake City,51550,1692,8837,10529,2858,20444,23302,333175,2594003,2927178,11/01/2014 12:00:00 AM,197,294,278
Eastern,Chesapeake City,51550,1693,7906,9599,2281,17662,19943,423306,3062563,3485869,06/01/2020 12:00:00 AM,250,387,363
Eastern,Chesapeake City,51550,1695,9531,11226,3031,21509,24540,375724,2869012,3244736,05/01/2013 12:00:00 AM,222,301,289
Eastern,Chesapeake City,51550,1701,8955,10656,2879,20505,23384,321571,2523900,2845471,09/01/2014 12:00:00 AM,189,282,267
Eastern,Chesapeake City,51550,1701,9039,10740,3140,20584,23724,385225,2739782,3125007,07/01/2012 12:00:00 AM,226,303,291
Eastern,Chesapeake City,51550,1702,9216,10918,3087,21080,24167,377728,2799875,3177603,08/01/2012 12:00:00 AM,222,304,291
Eastern,Chesapeake City,51550,1712,9028,10740,3179,20474,23653,388978,2727884,3116862,06/01/2012 12:00:00 AM,227,302,290
Eastern,Chesapeake City,51550,1716,9433,11149,3104,21378,24482,384728,2847356,3232084,04/01/2013 12:00:00 AM,224,302,290
Eastern,Chesapeake City,51550,1719,8979,10698,3222,20354,23576,398302,2706671,3104973,05/01/2012 12:00:00 AM,232,301,290
Eastern,Chesapeake City,51550,1725,9142,10867,3144,20983,24127,390398,2784817,3175215,09/01/2012 12:00:00 AM,226,305,292
Eastern,Chesapeake City,51550,1744,8927,10671,3295,20297,23592,410096,2697723,3107819,04/01/2012 12:00:00 AM,235,302,291
Eastern,Chesapeake City,51550,1751,9411,11162,3226,21334,24560,403372,2836552,3239924,03/01/2013 12:00:00 AM,230,301,290
Eastern,Chesapeake City,51550,1757,9261,11018,3212,21171,24383,405819,2828887,3234706,10/01/2012 12:00:00 AM,231,305,294
Eastern,Chesapeake City,51550,1760,9425,11185,3238,21444,24682,409059,2844711,3253770,02/01/2013 12:00:00 AM,232,302,291
Eastern,Chesapeake City,51550,1763,9424,11187,3264,21451,24715,407169,2829629,3236798,01/01/2013 12:00:00 AM,231,300,289
Eastern,Chesapeake City,51550,1766,8883,10649,3375,20184,23559,415100,2662739,3077839,01/01/2012 12:00:00 AM,235,300,289
Eastern,Chesapeake City,51550,1766,8959,10725,3363,20308,23671,419372,2699000,3118372,03/01/2012 12:00:00 AM,237,301,291
Eastern,Chesapeake City,51550,1768,9392,11160,3297,21445,24742,416760,2854642,3271402,12/01/2012 12:00:00 AM,236,304,293
Eastern,Chesapeake City,51550,1774,8947,10721,3423,20234,23657,422478,2687647,3110125,02/01/2012 12:00:00 AM,238,300,290
Eastern,Chesapeake City,51550,1780,9336,11116,3290,21356,24646,415728,2842854,3258582,11/01/2012 12:00:00 AM,234,305,293
Eastern,Dinwiddie County,51053,287,1513,1800,371,3193,3564,36458,415413,451871,11/01/2019 12:00:00 AM,127,275,251
Eastern,Dinwiddie County,51053,289,1550,1839,362,3342,3704,37138,436849.5,473987.5,07/01/2019 12:00:00 AM,129,282,258
Eastern,Dinwiddie County,51053,291,1527,1818,380,3241,3621,39491,430504,469995,10/01/2019 12:00:00 AM,136,282,259
Eastern,Dinwiddie County,51053,291,1540,1831,365,3308,3673,36713,426097,462810,06/01/2019 12:00:00 AM,126,277,253
Eastern,Dinwiddie County,51053,291,1551,1842,373,3278,3651,37384,430408,467792,12/01/2019 12:00:00 AM,128,278,254
Eastern,Dinwiddie County,51053,292,1558,1850,370,3254,3624,36022,422020,458042,01/01/2020 12:00:00 AM,123,271,248
Eastern,Dinwiddie County,51053,293,1532,1825,370,3267,3637,39053,427780,466833,09/01/2019 12:00:00 AM,133,279,256
Eastern,Dinwiddie County,51053,293,1545,1838,372,3241,3613,37408,417291,454699,02/01/2020 12:00:00 AM,128,270,247
Eastern,Dinwiddie County,51053,293,1566,1859,383,3271,3654,70799,564677,635476,03/01/2020 12:00:00 AM,242,361,342
Eastern,Dinwiddie County,51053,294,1527,1821,368,3281,3649,38465,424823,463288,08/01/2019 12:00:00 AM,131,278,254
Eastern,Dinwiddie County,51053,295,1452,1747,361,3131,3492,34960,406636,441596,02/01/2019 12:00:00 AM,119,280,253
Eastern,Dinwiddie County,51053,296,1680,1976,387,3495,3882,71347,609256,680603,04/01/2020 12:00:00 AM,241,363,344
Eastern,Dinwiddie County,51053,297,1518,1815,371,3265,3636,37194,435930,473124,01/01/2019 12:00:00 AM,125,287,261
Eastern,Dinwiddie County,51053,298,1730,2028,388,3590,3978,71679,622903,694582,05/01/2020 12:00:00 AM,241,360,342
Eastern,Dinwiddie County,51053,299,1487,1786,369,3253,3622,40458,431513,471971,10/01/2018 12:00:00 AM,135,290,264
Eastern,Dinwiddie County,51053,300,1502,1802,375,3302,3677,39811,428926,468737,11/01/2018 12:00:00 AM,133,286,260
Eastern,Dinwiddie County,51053,300,1533,1833,373,3295,3668,37340,427382,464722,05/01/2019 12:00:00 AM,124,279,254
Eastern,Dinwiddie County,51053,300,1722,2022,391,3560,3951,72117,616573,688690,06/01/2020 12:00:00 AM,240,358,341
Eastern,Dinwiddie County,51053,303,1497,1800,379,3281,3660,40863,425684,466547,12/01/2018 12:00:00 AM,135,284,259
Eastern,Dinwiddie County,51053,304,1745,2049,393,3609,4002,73194,623657,696851,07/01/2020 12:00:00 AM,241,357,340
Eastern,Dinwiddie County,51053,305,1464,1769,380,3216,3596,40106,416537,456643,09/01/2018 12:00:00 AM,131,285,258
Eastern,Dinwiddie County,51053,305,1500,1805,372,3218,3590,36703,414327,451030,03/01/2019 12:00:00 AM,120,276,250
Eastern,Dinwiddie County,51053,305,1501,1806,381,3215,3596,37161,419878,457039,04/01/2019 12:00:00 AM,122,280,253
Eastern,Dinwiddie County,51053,308,1725,2033,396,3575,3971,73023,623571,696594,08/01/2020 12:00:00 AM,237,361,343
Eastern,Dinwiddie County,51053,310,1461,1771,385,3229,3614,39058,419541,458599,07/01/2018 12:00:00 AM,126,287,259
Eastern,Dinwiddie County,51053,311,1444,1755,394,3179,3573,41426,404457,445883,08/01/2018 12:00:00 AM,133,280,254
Eastern,Dinwiddie County,51053,312,1681,1993,404,3497,3901,74577,607070,681647,09/01/2020 12:00:00 AM,239,361,342
Eastern,Dinwiddie County,51053,315,1662,1977,408,3436,3844,79584,631433,711017,10/01/2020 12:00:00 AM,253,380,360
Eastern,Dinwiddie County,51053,317,1456,1773,393,3239,3632,40460,419163,459623,06/01/2018 12:00:00 AM,128,288,259
Eastern,Dinwiddie County,51053,319,1664,1983,412,3428,3840,81086,638615,719701,11/01/2020 12:00:00 AM,254,384,363
Eastern,Dinwiddie County,51053,320,1443,1763,400,3214,3614,41722,420229,461951,05/01/2018 12:00:00 AM,130,291,262
Eastern,Dinwiddie County,51053,320,1457,1777,392,3267,3659,40252,426441,466693,04/01/2018 12:00:00 AM,126,293,263
Eastern,Dinwiddie County,51053,321,1661,1982,401,3446,3847,96219,782633,878852,02/01/2021 12:00:00 AM,300,471,443
Eastern,Dinwiddie County,51053,322,1462,1784,406,3258,3664,40784,420568,461352,02/01/2018 12:00:00 AM,127,288,259
Eastern,Dinwiddie County,51053,322,1484,1806,397,3297,3694,40493,430275,470768,03/01/2018 12:00:00 AM,126,290,261
Eastern,Dinwiddie County,51053,323,1668,1991,416,3428,3844,80877,631298,712175,12/01/2020 12:00:00 AM,250,378,358
Eastern,Dinwiddie County,51053,324,1640,1964,416,3405,3821,93177,712367,805544,01/01/2021 12:00:00 AM,288,434,410
Eastern,Dinwiddie County,51053,325,1460,1785,410,3299,3709,41272,424620,465892,01/01/2018 12:00:00 AM,127,291,261
Eastern,Dinwiddie County,51053,326,1464,1790,399,3311,3710,39490,426088,465578,11/01/2017 12:00:00 AM,121,291,260
Eastern,Dinwiddie County,51053,326,1471,1797,409,3348,3757,41204,430954,472158,12/01/2017 12:00:00 AM,126,293,263
Eastern,Dinwiddie County,51053,328,1680,2008,408,3484,3892,92367,745374,837741,03/01/2021 12:00:00 AM,282,444,417
Eastern,Dinwiddie County,51053,329,1460,1789,409,3286,3695,40903,429261,470164,10/01/2017 12:00:00 AM,124,294,263
Eastern,Dinwiddie County,51053,329,1481,1810,404,3315,3719,40590,430888,471478,09/01/2017 12:00:00 AM,123,291,260
Eastern,Dinwiddie County,51053,329,1659,1988,410,3441,3851,99259,806692,905951,04/01/2021 12:00:00 AM,302,486,456
Eastern,Dinwiddie County,51053,333,1501,1834,408,3392,3800,42023,444172,486195,07/01/2017 12:00:00 AM,126,296,265
Eastern,Dinwiddie County,51053,333,1537,1870,408,3469,3877,41668,456622,498290,06/01/2017 12:00:00 AM,125,297,266
Eastern,Dinwiddie County,51053,336,1508,1844,416,3407,3823,43911,448673,492584,08/01/2017 12:00:00 AM,131,298,267
Eastern,Dinwiddie County,51053,337,1564,1901,413,3509,3922,41034,456060,497094,03/01/2017 12:00:00 AM,122,292,261
Eastern,Dinwiddie County,51053,338,1550,1888,417,3501,3918,42639,456995,499634,05/01/2017 12:00:00 AM,126,295,265
Eastern,Dinwiddie County,51053,338,1655,1993,431,3389,3820,102574,798232,900806,06/01/2021 12:00:00 AM,303,482,452
Eastern,Dinwiddie County,51053,338,1889,2227,523,4139,4662,60294,549294,609588,03/01/2012 12:00:00 AM,178,291,274
Eastern,Dinwiddie County,51053,339,1553,1892,421,3531,3952,43305,459321,502626,04/01/2017 12:00:00 AM,128,296,266
Eastern,Dinwiddie County,51053,340,1847,2187,527,4026,4553,62738,536719,599457,04/01/2012 12:00:00 AM,185,291,274
Eastern,Dinwiddie County,51053,341,1642,1983,431,3377,3808,105747,784946,890693,05/01/2021 12:00:00 AM,310,478,449
Eastern,Dinwiddie County,51053,349,1888,2237,561,4133,4694,65179,552741,617920,02/01/2012 12:00:00 AM,187,293,276
Eastern,Dinwiddie County,51053,351,1896,2247,564,4163,4727,66485,552442,618927,01/01/2012 12:00:00 AM,189,291,275
Eastern,Dinwiddie County,51053,351,1927,2278,506,4228,4734,58003,553369,611372,01/01/2013 12:00:00 AM,165,287,268
Eastern,Dinwiddie County,51053,352,1540,1892,446,3473,3919,45535,443662,489197,01/01/2017 12:00:00 AM,129,288,259
Eastern,Dinwiddie County,51053,352,1549,1901,442,3492,3934,45539,453239,498778,02/01/2017 12:00:00 AM,129,293,262
Eastern,Dinwiddie County,51053,352,1594,1946,446,3603,4049,46385,463100,509485,02/01/2016 12:00:00 AM,132,291,262
Eastern,Dinwiddie County,51053,352,1845,2197,541,4011,4552,63903,527599,591502,05/01/2012 12:00:00 AM,182,286,269
Eastern,Dinwiddie County,51053,354,1593,1947,445,3576,4021,45321,458167,503488,03/01/2016 12:00:00 AM,128,288,259
Eastern,Dinwiddie County,51053,354,1643,1997,444,3715,4159,46083,474144,520227,10/01/2015 12:00:00 AM,130,289,261
Eastern,Dinwiddie County,51053,354,1882,2236,530,4074,4604,60692,542631,603323,08/01/2012 12:00:00 AM,171,288,270
Eastern,Dinwiddie County,51053,354,1921,2275,526,4231,4757,60958,557884,618842,02/01/2013 12:00:00 AM,172,290,272
Eastern,Dinwiddie County,51053,355,1578,1933,456,3555,4011,47844,451767,499611,04/01/2016 12:00:00 AM,135,286,258
Eastern,Dinwiddie County,51053,355,1629,1984,451,3708,4159,47039,473235,520274,11/01/2015 12:00:00 AM,133,291,262
Eastern,Dinwiddie County,51053,355,1885,2240,526,4086,4612,61273,544086,605359,09/01/2012 12:00:00 AM,173,289,270
Eastern,Dinwiddie County,51053,356,1615,1971,459,3651,4110,48233,461283,509516,12/01/2015 12:00:00 AM,135,286,259
Eastern,Dinwiddie County,51053,357,1538,1895,452,3501,3953,46368,446777,493145,12/01/2016 12:00:00 AM,130,290,260
Eastern,Dinwiddie County,51053,357,1909,2266,515,4183,4698,59810,555118,614928,12/01/2012 12:00:00 AM,168,291,271
Eastern,Dinwiddie County,51053,358,1722,2080,512,3854,4366,58354,488246,546600,11/01/2014 12:00:00 AM,163,284,263
Eastern,Dinwiddie County,51053,358,1894,2252,517,4202,4719,55721,518888,574609,12/01/2013 12:00:00 AM,156,274,255
Eastern,Dinwiddie County,51053,359,1580,1939,464,3588,4052,48789,455556,504345,01/01/2016 12:00:00 AM,136,288,260
Eastern,Dinwiddie County,51053,359,1861,2220,546,4037,4583,63918,537700,601618,07/01/2012 12:00:00 AM,178,289,271
Eastern,Dinwiddie County,51053,360,1559,1919,465,3552,4017,48614,452118,500732,05/01/2016 12:00:00 AM,135,290,261
Eastern,Dinwiddie County,51053,360,1667,2027,466,3788,4254,48148,483302,531450,09/01/2015 12:00:00 AM,134,290,262
Eastern,Dinwiddie County,51053,360,1859,2219,547,4059,4606,63550,537967,601517,06/01/2012 12:00:00 AM,177,289,271
Eastern,Dinwiddie County,51053,360,1899,2259,544,4106,4650,65526,547224,612750,10/01/2012 12:00:00 AM,182,288,271
Eastern,Dinwiddie County,51053,362,1569,1931,468,3551,4019,49354,453541,502895,06/01/2016 12:00:00 AM,136,289,260
Eastern,Dinwiddie County,51053,362,1862,2224,518,4109,4627,54465,508142,562607,04/01/2014 12:00:00 AM,150,273,253
Eastern,Dinwiddie County,51053,362,1872,2234,522,4126,4648,54478,510500,564978,03/01/2014 12:00:00 AM,150,273,253
Eastern,Dinwiddie County,51053,362,1928,2290,531,4237,4768,60272,558188,618460,03/01/2013 12:00:00 AM,166,290,270
Eastern,Dinwiddie County,51053,363,1802,2165,488,4017,4505,50984,494419,545403,07/01/2014 12:00:00 AM,140,274,252
Eastern,Dinwiddie County,51053,363,1897,2260,534,4167,4701,56248,512338,568586,02/01/2014 12:00:00 AM,155,270,252
Eastern,Dinwiddie County,51053,363,1910,2273,527,4239,4766,56698,524582,581280,11/01/2013 12:00:00 AM,156,275,256
Eastern,Dinwiddie County,51053,364,1716,2080,509,3873,4382,56844,493930,550774,12/01/2014 12:00:00 AM,156,288,265
Eastern,Dinwiddie County,51053,364,1747,2111,519,3889,4408,58699,493507,552206,10/01/2014 12:00:00 AM,161,282,262
Eastern,Dinwiddie County,51053,365,1547,1912,474,3507,3981,50650,450110,500760,11/01/2016 12:00:00 AM,139,291,262
Eastern,Dinwiddie County,51053,365,1552,1917,475,3512,3987,50470,450206,500676,07/01/2016 12:00:00 AM,138,290,261
Eastern,Dinwiddie County,51053,365,1683,2048,497,3850,4347,52914,490678,543592,06/01/2015 12:00:00 AM,145,292,265
Eastern,Dinwiddie County,51053,365,1910,2275,554,4162,4716,64785,551796,616581,11/01/2012 12:00:00 AM,177,289,271
Eastern,Dinwiddie County,51053,366,1682,2048,491,3822,4313,52306,485827,538133,07/01/2015 12:00:00 AM,143,289,263
Eastern,Dinwiddie County,51053,366,1906,2272,552,4223,4775,65129,564289,629418,10/01/2013 12:00:00 AM,178,296,277
Eastern,Dinwiddie County,51053,367,1660,2027,517,3794,4311,55514,478322,533836,03/01/2015 12:00:00 AM,151,288,263
Eastern,Dinwiddie County,51053,367,1668,2035,492,3832,4324,52099,485606,537705,05/01/2015 12:00:00 AM,142,291,264
Eastern,Dinwiddie County,51053,367,1756,2123,511,3922,4433,53633,477638,531271,09/01/2014 12:00:00 AM,146,272,250
Eastern,Dinwiddie County,51053,368,1554,1922,493,3518,4011,53705,451617,505322,08/01/2016 12:00:00 AM,146,291,263
Eastern,Dinwiddie County,51053,368,1697,2065,486,3821,4307,50860,489828,540688,08/01/2015 12:00:00 AM,138,289,262
Eastern,Dinwiddie County,51053,368,1812,2180,519,4006,4525,53798,495911,549709,06/01/2014 12:00:00 AM,146,274,252
Eastern,Dinwiddie County,51053,368,1872,2240,544,4126,4670,58027,504406,562433,01/01/2014 12:00:00 AM,158,269,251
Eastern,Dinwiddie County,51053,369,1649,2018,510,3784,4294,53936,479018,532954,04/01/2015 12:00:00 AM,146,290,264
Eastern,Dinwiddie County,51053,369,1681,2050,515,3846,4361,55626,483939,539565,02/01/2015 12:00:00 AM,151,288,263
Eastern,Dinwiddie County,51053,369,1703,2072,516,3865,4381,56172,487100,543272,01/01/2015 12:00:00 AM,152,286,262
Eastern,Dinwiddie County,51053,369,1890,2259,545,4198,4743,64355,557271,621626,08/01/2013 12:00:00 AM,174,295,275
Eastern,Dinwiddie County,51053,369,1914,2283,549,4255,4804,63108,561519,624627,09/01/2013 12:00:00 AM,171,293,274
Eastern,Dinwiddie County,51053,370,1854,2224,525,4093,4618,53962,507531,561493,05/01/2014 12:00:00 AM,146,274,252
Eastern,Dinwiddie County,51053,370,1896,2266,548,4192,4740,63827,554569,618396,05/01/2013 12:00:00 AM,173,292,273
Eastern,Dinwiddie County,51053,371,1566,1937,489,3547,4036,52114,453482,505596,10/01/2016 12:00:00 AM,140,290,261
Eastern,Dinwiddie County,51053,371,1905,2276,549,4211,4760,63890,553177,617067,04/01/2013 12:00:00 AM,172,290,271
Eastern,Dinwiddie County,51053,371,1912,2283,551,4200,4751,65626,563503,629129,06/01/2013 12:00:00 AM,177,295,276
Eastern,Dinwiddie County,51053,372,1762,2134,511,3935,4446,54562,485386,539948,08/01/2014 12:00:00 AM,147,275,253
Eastern,Dinwiddie County,51053,374,1562,1936,498,3531,4029,53533,449052,502585,09/01/2016 12:00:00 AM,143,287,260
Eastern,Dinwiddie County,51053,377,1897,2274,555,4196,4751,64337,556895,621232,07/01/2013 12:00:00 AM,171,294,273
Eastern,Emporia City,51595,181,650,831,236,1450,1686,23022,182776,205798,05/01/2018 12:00:00 AM,127,281,248
Eastern,Emporia City,51595,184,662,846,243,1464,1707,23606,189795,213401,04/01/2018 12:00:00 AM,128,287,252
Eastern,Emporia City,51595,184,691,875,292,1471,1763,28820,188850,217670,10/01/2019 12:00:00 AM,157,273,249
Eastern,Emporia City,51595,185,632,817,284,1401,1685,27210,178054,205264,02/01/2019 12:00:00 AM,147,282,251
Eastern,Emporia City,51595,185,658,843,254,1456,1710,25410,183929,209339,06/01/2018 12:00:00 AM,137,280,248
Eastern,Emporia City,51595,186,634,820,271,1386,1657,27614,175782,203396,09/01/2018 12:00:00 AM,148,277,248
Eastern,Emporia City,51595,186,662,848,253,1463,1716,24898,190417,215315,07/01/2018 12:00:00 AM,134,288,254
Eastern,Emporia City,51595,187,683,870,296,1456,1752,30025,183475,213500,01/01/2020 12:00:00 AM,161,269,245
Eastern,Emporia City,51595,188,641,829,258,1421,1679,25517,184402,209919,08/01/2018 12:00:00 AM,136,288,253
Eastern,Emporia City,51595,188,679,867,304,1451,1755,32894,187500,220394,06/01/2019 12:00:00 AM,175,276,254
Eastern,Emporia City,51595,188,687,875,308,1456,1764,54856,252513,307369,03/01/2020 12:00:00 AM,292,368,351
Eastern,Emporia City,51595,188,699,887,295,1488,1783,29939,192771,222710,09/01/2019 12:00:00 AM,159,276,251
Eastern,Emporia City,51595,188,706,894,311,1471,1782,54869,254750,309619,04/01/2020 12:00:00 AM,292,361,346
Eastern,Emporia City,51595,189,653,842,254,1445,1699,24549,183189,207738,03/01/2018 12:00:00 AM,130,281,247
Eastern,Emporia City,51595,189,676,865,307,1438,1745,31223,180008,211231,02/01/2020 12:00:00 AM,165,266,244
Eastern,Emporia City,51595,189,683,872,300,1474,1774,30292,185739,216031,12/01/2019 12:00:00 AM,160,272,248
Eastern,Emporia City,51595,189,711,900,318,1487,1805,59554,279526,339080,11/01/2020 12:00:00 AM,315,393,377
Eastern,Emporia City,51595,190,668,858,301,1431,1732,29480,186404,215884,04/01/2019 12:00:00 AM,155,279,252
Eastern,Emporia City,51595,190,668,858,311,1383,1694,69260,318258,387518,06/01/2021 12:00:00 AM,365,476,452
Eastern,Emporia City,51595,190,730,920,306,1527,1833,54652,262388,317040,06/01/2020 12:00:00 AM,288,359,345
Eastern,Emporia City,51595,191,633,824,285,1392,1677,29845,175346,205191,12/01/2018 12:00:00 AM,156,277,249
Eastern,Emporia City,51595,191,648,839,300,1406,1706,29597,177778,207375,03/01/2019 12:00:00 AM,155,274,247
Eastern,Emporia City,51595,191,667,858,304,1427,1731,31660,185471,217131,05/01/2019 12:00:00 AM,166,278,253
Eastern,Emporia City,51595,191,694,885,309,1487,1796,31914,186447,218361,11/01/2019 12:00:00 AM,167,269,247
Eastern,Emporia City,51595,192,738,930,308,1541,1849,54645,265742,320387,07/01/2020 12:00:00 AM,285,360,345
Eastern,Emporia City,51595,193,638,831,285,1400,1685,29484,179806.6,209290.6,10/01/2018 12:00:00 AM,153,282,252
Eastern,Emporia City,51595,193,643,836,293,1410,1703,29636,179731,209367,01/01/2019 12:00:00 AM,154,280,250
Eastern,Emporia City,51595,193,666,859,317,1393,1710,70586,321649,392235,05/01/2021 12:00:00 AM,366,483,457
Eastern,Emporia City,51595,193,668,861,320,1383,1703,72025,322968,394993,04/01/2021 12:00:00 AM,373,483,459
Eastern,Emporia City,51595,193,692,885,314,1427,1741,68337,303182,371519,02/01/2021 12:00:00 AM,354,438,420
Eastern,Emporia City,51595,193,705,898,328,1448,1776,61756,262868,324624,12/01/2020 12:00:00 AM,320,373,361
Eastern,Emporia City,51595,193,716,909,320,1491,1811,61141,270332,331473,10/01/2020 12:00:00 AM,317,378,365
Eastern,Emporia City,51595,193,718,911,312,1513,1825,55594,262110,317704,05/01/2020 12:00:00 AM,288,365,349
Eastern,Emporia City,51595,194,646,840,266,1450,1716,25606,185374,210980,02/01/2018 12:00:00 AM,132,287,251
Eastern,Emporia City,51595,194,689,883,332,1407,1739,68011,291602,359613,01/01/2021 12:00:00 AM,351,423,407
Eastern,Emporia City,51595,194,728,922,262,1595,1857,29205,205559,234764,03/01/2017 12:00:00 AM,151,282,255
Eastern,Emporia City,51595,195,633,828,295,1402,1697,30925,176912,207837,11/01/2018 12:00:00 AM,159,279,251
Eastern,Emporia City,51595,195,698,893,309,1488,1797,32149,190867,223016,08/01/2019 12:00:00 AM,165,273,250
Eastern,Emporia City,51595,195,703,898,267,1559,1826,27272,200315,227587,06/01/2017 12:00:00 AM,140,285,253
Eastern,Emporia City,51595,195,720,915,323,1492,1815,56748,262282,319030,09/01/2020 12:00:00 AM,291,364,349
Eastern,Emporia City,51595,195,731,926,323,1525,1848,56833,262633,319466,08/01/2020 12:00:00 AM,291,359,345
Eastern,Emporia City,51595,195,760,955,273,1689,1962,28733,212646,241379,07/01/2016 12:00:00 AM,147,280,253
Eastern,Emporia City,51595,196,653,849,276,1446,1722,26693,184577,211270,01/01/2018 12:00:00 AM,136,283,249
Eastern,Emporia City,51595,196,687,883,316,1461,1777,32450,185540,217990,07/01/2019 12:00:00 AM,166,270,247
Eastern,Emporia City,51595,197,660,857,272,1448,1720,27301,185720,213021,12/01/2017 12:00:00 AM,139,281,249
Eastern,Emporia City,51595,197,761,958,259,1689,1948,26738,212675,239413,10/01/2016 12:00:00 AM,136,279,250
Eastern,Emporia City,51595,197,762,959,268,1718,1986,27464,214640,242104,09/01/2016 12:00:00 AM,139,282,252
Eastern,Emporia City,51595,198,675,873,334,1401,1735,70356,290632,360988,03/01/2021 12:00:00 AM,355,431,414
Eastern,Emporia City,51595,198,684,882,273,1525,1798,25307,195667,220974,07/01/2017 12:00:00 AM,128,286,251
Eastern,Emporia City,51595,198,711,909,280,1556,1836,30566,197163,227729,04/01/2017 12:00:00 AM,154,277,251
Eastern,Emporia City,51595,198,722,920,279,1592,1871,29537,204795,234332,05/01/2017 12:00:00 AM,149,284,255
Eastern,Emporia City,51595,198,764,962,267,1716,1983,27513,213108,240621,08/01/2016 12:00:00 AM,139,279,250
Eastern,Emporia City,51595,199,659,858,271,1447,1718,25981,183081,209062,09/01/2017 12:00:00 AM,131,278,244
Eastern,Emporia City,51595,199,659,858,276,1442,1718,26664,180409,207073,11/01/2017 12:00:00 AM,134,274,241
Eastern,Emporia City,51595,200,677,877,283,1499,1782,27394,195652,223046,08/01/2017 12:00:00 AM,137,289,254
Eastern,Emporia City,51595,201,791,992,278,1762,2040,29368,218369,247737,04/01/2016 12:00:00 AM,146,276,250
Eastern,Emporia City,51595,201,803,1004,288,1784,2072,30910,217751,248661,03/01/2016 12:00:00 AM,154,271,248
Eastern,Emporia City,51595,202,665,867,279,1473,1752,26401,184062,210463,10/01/2017 12:00:00 AM,131,277,243
Eastern,Emporia City,51595,202,739,941,263,1634,1897,27842,206585,234427,01/01/2017 12:00:00 AM,138,280,249
Eastern,Emporia City,51595,202,742,944,277,1649,1926,30354,203313,233667,02/01/2017 12:00:00 AM,150,274,248
Eastern,Emporia City,51595,203,766,969,289,1705,1994,31676,214413,246089,06/01/2016 12:00:00 AM,156,280,254
Eastern,Emporia City,51595,203,824,1027,285,1832,2117,29283,227433,256716,12/01/2015 12:00:00 AM,144,276,250
Eastern,Emporia City,51595,204,779,983,287,1747,2034,30977,216835,247812,05/01/2016 12:00:00 AM,152,278,252
Eastern,Emporia City,51595,206,808,1014,294,1787,2081,30084,220779,250863,02/01/2016 12:00:00 AM,146,273,247
Eastern,Emporia City,51595,206,828,1034,296,1847,2143,30351,229646,259997,11/01/2015 12:00:00 AM,147,277,251
Eastern,Emporia City,51595,207,725,932,285,1616,1901,30488,205332,235820,11/01/2016 12:00:00 AM,147,283,253
Eastern,Emporia City,51595,209,812,1021,298,1817,2115,29184,224163,253347,01/01/2016 12:00:00 AM,140,276,248
Eastern,Emporia City,51595,210,732,942,292,1626,1918,31776,204108,235884,12/01/2016 12:00:00 AM,151,279,250
Eastern,Emporia City,51595,212,827,1039,313,1838,2151,32265,226234,258499,10/01/2015 12:00:00 AM,152,274,249
Eastern,Emporia City,51595,215,832,1047,326,1837,2163,33975,228425,262400,09/01/2015 12:00:00 AM,158,275,251
Eastern,Emporia City,51595,226,841,1067,347,1845,2192,36904,229598,266502,08/01/2015 12:00:00 AM,163,273,250
Eastern,Emporia City,51595,227,829,1056,352,1813,2165,35659,217606,253265,09/01/2014 12:00:00 AM,157,262,240
Eastern,Emporia City,51595,227,841,1068,321,1848,2169,34838,230160,264998,02/01/2015 12:00:00 AM,153,274,248
Eastern,Emporia City,51595,227,843,1070,357,1835,2192,39744,229181,268925,06/01/2015 12:00:00 AM,175,272,251
Eastern,Emporia City,51595,228,841,1069,324,1843,2167,34489,231907,266396,11/01/2014 12:00:00 AM,151,276,249
Eastern,Emporia City,51595,229,836,1065,327,1832,2159,34916,225857,260773,01/01/2015 12:00:00 AM,152,270,245
Eastern,Emporia City,51595,230,848,1078,373,1828,2201,40692,227592,268284,07/01/2015 12:00:00 AM,177,268,249
Eastern,Emporia City,51595,231,830,1061,347,1800,2147,36121,223638,259759,08/01/2014 12:00:00 AM,156,269,245
Eastern,Emporia City,51595,231,835,1066,342,1822,2164,38050,227317,265367,12/01/2014 12:00:00 AM,165,272,249
Eastern,Emporia City,51595,231,854,1085,342,1847,2189,32241,226004,258245,06/01/2014 12:00:00 AM,140,265,238
Eastern,Emporia City,51595,232,830,1062,341,1834,2175,36839,229372,266211,10/01/2014 12:00:00 AM,159,276,251
Eastern,Emporia City,51595,232,849,1081,351,1840,2191,38708,225373,264081,03/01/2015 12:00:00 AM,167,265,244
Eastern,Emporia City,51595,234,838,1072,371,1828,2199,41076,225253,266329,05/01/2015 12:00:00 AM,176,269,248
Eastern,Emporia City,51595,234,840,1074,341,1819,2160,32930,224250,257180,07/01/2014 12:00:00 AM,141,267,239
Eastern,Emporia City,51595,235,847,1082,370,1823,2193,40765,223756,264521,04/01/2015 12:00:00 AM,173,264,244
Eastern,Emporia City,51595,239,875,1114,380,1874,2254,37813,230320,268133,05/01/2014 12:00:00 AM,158,263,241
Eastern,Emporia City,51595,243,879,1122,384,1860,2244,38092,226705,264797,04/01/2014 12:00:00 AM,157,258,236
Eastern,Emporia City,51595,244,889,1133,388,1859,2247,39613,228191,267804,02/01/2014 12:00:00 AM,162,257,236
Eastern,Emporia City,51595,245,884,1129,386,1857,2243,38378,228469,266847,03/01/2014 12:00:00 AM,157,258,236
Eastern,Emporia City,51595,253,775,1028,393,1686,2079,42628,217234,259862,02/01/2012 12:00:00 AM,168,280,253
Eastern,Emporia City,51595,253,786,1039,394,1724,2118,43274,218631,261905,01/01/2012 12:00:00 AM,171,278,252
Eastern,Emporia City,51595,253,901,1154,411,1871,2282,42156,227452,269608,01/01/2014 12:00:00 AM,167,252,234
Eastern,Emporia City,51595,256,786,1042,388,1718,2106,42141,221495,263636,03/01/2012 12:00:00 AM,165,282,253
Eastern,Emporia City,51595,259,784,1043,398,1704,2102,44001,216676,260677,04/01/2012 12:00:00 AM,170,276,250
Eastern,Emporia City,51595,260,841,1101,414,1826,2240,47400,233490,280890,10/01/2012 12:00:00 AM,182,278,255
Eastern,Emporia City,51595,260,900,1160,422,1871,2293,45105,231033,276138,12/01/2013 12:00:00 AM,173,257,238
Eastern,Emporia City,51595,260,900,1160,422,1878,2300,44069,229834,273903,11/01/2013 12:00:00 AM,169,255,236
Eastern,Emporia City,51595,261,847,1108,405,1860,2265,46229,238863,285092,09/01/2012 12:00:00 AM,177,282,257
Eastern,Emporia City,51595,262,765,1027,404,1679,2083,44279,216772,261051,05/01/2012 12:00:00 AM,169,283,254
Eastern,Emporia City,51595,262,847,1109,424,1822,2246,48014,238089,286103,11/01/2012 12:00:00 AM,183,281,258
Eastern,Emporia City,51595,263,784,1047,411,1714,2125,44713,220823,265536,06/01/2012 12:00:00 AM,170,282,254
Eastern,Emporia City,51595,264,819,1083,410,1794,2204,47238,233608,280846,08/01/2012 12:00:00 AM,179,285,259
Eastern,Emporia City,51595,264,846,1110,422,1823,2245,46707,238294,285001,01/01/2013 12:00:00 AM,177,282,257
Eastern,Emporia City,51595,264,880,1144,417,1867,2284,46929,245268,292197,07/01/2013 12:00:00 AM,178,279,255
Eastern,Emporia City,51595,265,793,1058,410,1751,2161,46636,225968,272604,07/01/2012 12:00:00 AM,176,285,258
Eastern,Emporia City,51595,267,842,1109,421,1807,2228,47411,238347,285758,02/01/2013 12:00:00 AM,178,283,258
Eastern,Emporia City,51595,267,844,1111,434,1812,2246,49757,235206,284963,12/01/2012 12:00:00 AM,186,279,256
Eastern,Emporia City,51595,267,857,1124,428,1814,2242,47747,240987,288734,06/01/2013 12:00:00 AM,179,281,257
Eastern,Emporia City,51595,268,856,1124,415,1844,2259,46074,243140,289214,03/01/2013 12:00:00 AM,172,284,257
Eastern,Emporia City,51595,269,868,1137,432,1817,2249,48943,239178,288121,09/01/2013 12:00:00 AM,182,276,253
Eastern,Emporia City,51595,269,875,1144,427,1841,2268,47413,242937,290350,08/01/2013 12:00:00 AM,176,278,254
Eastern,Emporia City,51595,270,888,1158,435,1853,2288,49022,244470,293492,10/01/2013 12:00:00 AM,182,275,253
Eastern,Emporia City,51595,272,835,1107,446,1773,2219,50800,235656,286456,04/01/2013 12:00:00 AM,187,282,259
Eastern,Emporia City,51595,277,848,1125,454,1801,2255,51939,238631,290570,05/01/2013 12:00:00 AM,188,281,258
Eastern,Franklin City,51620,235,959,1194,326,2074,2400,37164,280751,317915,08/01/2017 12:00:00 AM,158,293,266
Eastern,Franklin City,51620,237,939,1176,317,2006,2323,35953,267839,303792,09/01/2017 12:00:00 AM,152,285,258
Eastern,Franklin City,51620,237,963,1200,319,2082,2401,36008,285226,321234,06/01/2017 12:00:00 AM,152,296,268
Eastern,Franklin City,51620,239,947,1186,325,2060,2385,36168,274454,310622,07/01/2017 12:00:00 AM,151,290,262
Eastern,Franklin City,51620,240,939,1179,324,2024,2348,38035,266842,304877,10/01/2017 12:00:00 AM,158,284,259
Eastern,Franklin City,51620,243,958,1201,329,2066,2395,36811,276294,313105,05/01/2017 12:00:00 AM,151,288,261
Eastern,Franklin City,51620,244,963,1207,324,2059,2383,35090,274302,309392,04/01/2017 12:00:00 AM,144,285,256
Eastern,Franklin City,51620,245,938,1183,323,2049,2372,35926,264742,300668,11/01/2017 12:00:00 AM,147,282,254
Eastern,Franklin City,51620,248,979,1227,331,2109,2440,36349,282547,318896,03/01/2017 12:00:00 AM,147,289,260
Eastern,Franklin City,51620,251,1034,1285,340,2159,2499,37537,280308,317845,09/01/2016 12:00:00 AM,150,271,247
Eastern,Franklin City,51620,251,928,1179,320,2017,2337,34796,257659,292455,12/01/2017 12:00:00 AM,139,278,248
Eastern,Franklin City,51620,254,1046,1300,353,2126,2479,38808,276697,315505,03/01/2015 12:00:00 AM,153,265,243
Eastern,Franklin City,51620,254,922,1176,317,2003,2320,33618,253897,287515,01/01/2018 12:00:00 AM,132,275,244
Eastern,Franklin City,51620,254,992,1246,345,2088,2433,38075,270955,309030,02/01/2017 12:00:00 AM,150,273,248
Eastern,Franklin City,51620,255,982,1237,345,2076,2421,37617,267411,305028,12/01/2016 12:00:00 AM,148,272,247
Eastern,Franklin City,51620,255,993,1248,343,2117,2460,36754,272884,309638,01/01/2017 12:00:00 AM,144,275,248
Eastern,Franklin City,51620,257,1013,1270,345,2120,2465,37407,273261,310668,10/01/2016 12:00:00 AM,146,270,245
Eastern,Franklin City,51620,258,1055,1313,360,2220,2580,38289,288387,326676,10/01/2014 12:00:00 AM,148,273,249
Eastern,Franklin City,51620,258,827,1085,333,1799,2132,31751,233235,264986,01/01/2020 12:00:00 AM,123,282,244
Eastern,Franklin City,51620,258,897,1155,322,1977,2299,32380,248177,280557,02/01/2018 12:00:00 AM,126,277,243
Eastern,Franklin City,51620,259,1002,1261,353,2097,2450,38057,274586,312643,11/01/2016 12:00:00 AM,147,274,248
Eastern,Franklin City,51620,259,910,1169,320,1990,2310,32286,254909,287195,03/01/2018 12:00:00 AM,125,280,246
Eastern,Franklin City,51620,260,1033,1293,366,2103,2469,39499,275208,314707,04/01/2016 12:00:00 AM,152,266,243
Eastern,Franklin City,51620,261,1017,1278,360,2115,2475,40263,274127,314390,08/01/2016 12:00:00 AM,154,270,246
Eastern,Franklin City,51620,261,1025,1286,355,2133,2488,38800,274903,313703,07/01/2016 12:00:00 AM,149,268,244
Eastern,Franklin City,51620,261,1041,1302,379,2151,2530,40675,281857,322532,12/01/2014 12:00:00 AM,156,271,248
Eastern,Franklin City,51620,261,1060,1321,387,2206,2593,39201,285249,324450,08/01/2014 12:00:00 AM,150,269,246
Eastern,Franklin City,51620,261,908,1169,321,1971,2292,31952,260760,292712,05/01/2018 12:00:00 AM,122,287,250
Eastern,Franklin City,51620,262,1044,1306,372,2135,2507,39804,277099,316903,01/01/2015 12:00:00 AM,152,265,243
Eastern,Franklin City,51620,262,834,1096,339,1823,2162,32833,238704,271537,06/01/2019 12:00:00 AM,125,286,248
Eastern,Franklin City,51620,262,847,1109,342,1879,2221,33117,244538,277655,11/01/2019 12:00:00 AM,126,289,250
Eastern,Franklin City,51620,262,863,1125,338,1906,2244,33220,253589,286809,12/01/2019 12:00:00 AM,127,294,255
Eastern,Franklin City,51620,263,1077,1340,386,2214,2600,38751,288155,326906,06/01/2014 12:00:00 AM,147,268,244
Eastern,Franklin City,51620,263,893,1156,329,1946,2275,33762,248965,282727,04/01/2018 12:00:00 AM,128,279,245
Eastern,Franklin City,51620,264,1012,1276,369,2076,2445,40170,271001,311171,05/01/2016 12:00:00 AM,152,268,244
Eastern,Franklin City,51620,264,1050,1314,387,2195,2582,40964,287313,328277,11/01/2014 12:00:00 AM,155,274,250
Eastern,Franklin City,51620,264,1054,1318,371,2146,2517,40803,276395,317198,04/01/2015 12:00:00 AM,155,262,241
Eastern,Franklin City,51620,264,837,1101,342,1842,2184,33562,240973,274535,10/01/2019 12:00:00 AM,127,288,249
Eastern,Franklin City,51620,265,1029,1294,371,2088,2459,39880,271120,311000,03/01/2016 12:00:00 AM,150,263,240
Eastern,Franklin City,51620,265,1037,1302,375,2108,2483,40726,274426,315152,02/01/2015 12:00:00 AM,154,265,242
Eastern,Franklin City,51620,265,1051,1316,382,2201,2583,38658,282190,320848,09/01/2014 12:00:00 AM,146,268,244
Eastern,Franklin City,51620,265,831,1096,339,1827,2166,32737,237055,269792,07/01/2019 12:00:00 AM,124,285,246
Eastern,Franklin City,51620,265,831,1096,349,1803,2152,33946,232326,266272,02/01/2020 12:00:00 AM,128,280,243
Eastern,Franklin City,51620,265,846,1111,336,1877,2213,32661,246000,278661,08/01/2019 12:00:00 AM,123,291,251
Eastern,Franklin City,51620,266,836,1102,339,1849,2188,33142,243928,277070,09/01/2019 12:00:00 AM,125,292,251
Eastern,Franklin City,51620,266,892,1158,338,1924,2262,34480,256836,291316,07/01/2018 12:00:00 AM,130,288,252
Eastern,Franklin City,51620,266,897,1163,334,1937,2271,35075,251960,287035,06/01/2018 12:00:00 AM,132,281,247
Eastern,Franklin City,51620,267,1008,1275,380,2082,2462,41706,271328,313034,06/01/2016 12:00:00 AM,156,269,246
Eastern,Franklin City,51620,267,1064,1331,370,2189,2559,38731,284474,323205,05/01/2015 12:00:00 AM,145,267,243
Eastern,Franklin City,51620,267,818,1085,348,1794,2142,35209,233185,268394,05/01/2019 12:00:00 AM,132,285,247
Eastern,Franklin City,51620,267,832,1099,338,1790,2128,34861,231331,266192,03/01/2019 12:00:00 AM,131,278,242
Eastern,Franklin City,51620,268,1007,1275,370,2031,2401,38684,260191,298875,01/01/2016 12:00:00 AM,144,258,234
Eastern,Franklin City,51620,268,1020,1288,375,2070,2445,39736,266266,306002,02/01/2016 12:00:00 AM,148,261,238
Eastern,Franklin City,51620,268,1049,1317,370,2154,2524,38581,279024,317605,06/01/2015 12:00:00 AM,144,266,241
Eastern,Franklin City,51620,268,854,1122,344,1861,2205,64323,322522,386845,03/01/2020 12:00:00 AM,240,378,345
Eastern,Franklin City,51620,268,912,1180,351,1967,2318,66066,336712,402778,04/01/2020 12:00:00 AM,247,369,341
Eastern,Franklin City,51620,268,977,1245,351,2071,2422,66046,359717,425763,09/01/2020 12:00:00 AM,246,368,342
Eastern,Franklin City,51620,269,806,1075,348,1719,2067,36858,225647,262505,02/01/2019 12:00:00 AM,137,280,244
Eastern,Franklin City,51620,269,855,1124,349,1839,2188,37049,241422,278471,12/01/2018 12:00:00 AM,138,282,248
Eastern,Franklin City,51620,269,940,1209,353,2028,2381,65234,352787,418021,05/01/2020 12:00:00 AM,243,375,346
Eastern,Franklin City,51620,271,1010,1281,365,2049,2414,37696,263736,301432,12/01/2015 12:00:00 AM,139,261,235
Eastern,Franklin City,51620,271,1038,1309,381,2128,2509,40661,274336,314997,07/01/2015 12:00:00 AM,150,264,241
Eastern,Franklin City,51620,271,821,1092,355,1781,2136,35850,233352,269202,04/01/2019 12:00:00 AM,132,284,247
Eastern,Franklin City,51620,271,857,1128,348,1837,2185,36559,249464,286023,01/01/2019 12:00:00 AM,135,291,254
Eastern,Franklin City,51620,272,1006,1278,365,2061,2426,38244,265774,304018,11/01/2015 12:00:00 AM,141,264,238
Eastern,Franklin City,51620,272,1035,1307,377,2114,2491,39246,272013,311259,09/01/2015 12:00:00 AM,144,263,238
Eastern,Franklin City,51620,272,1042,1314,379,2141,2520,39511,280732,320243,08/01/2015 12:00:00 AM,145,269,244
Eastern,Franklin City,51620,272,1059,1331,408,2181,2589,41623,279779,321402,07/01/2014 12:00:00 AM,153,264,241
Eastern,Franklin City,51620,272,873,1145,339,1878,2217,34402,248571,282973,09/01/2018 12:00:00 AM,126,285,247
Eastern,Franklin City,51620,272,970,1242,361,2062,2423,65273,358832,424105,08/01/2020 12:00:00 AM,240,370,341
Eastern,Franklin City,51620,272,982,1254,356,2115,2471,66127,365915,432042,07/01/2020 12:00:00 AM,243,373,345
Eastern,Franklin City,51620,273,1085,1358,414,2223,2637,43373,287336,330709,05/01/2014 12:00:00 AM,159,265,244
Eastern,Franklin City,51620,273,886,1159,349,1870,2219,34622,248586,283208,08/01/2018 12:00:00 AM,127,281,244
Eastern,Franklin City,51620,273,961,1234,360,2074,2434,66301,357617,423918,06/01/2020 12:00:00 AM,243,372,344
Eastern,Franklin City,51620,275,878,1153,360,1879,2239,38830,248423,287253,11/01/2018 12:00:00 AM,141,283,249
Eastern,Franklin City,51620,276,879,1155,356,1889,2245,37815,249287,287102,10/01/2018 12:00:00 AM,137,284,249
Eastern,Franklin City,51620,276,935,1211,365,1938,2303,81112,410354,491466,02/01/2021 12:00:00 AM,294,439,406
Eastern,Franklin City,51620,276,951,1227,374,2005,2379,67669,364249,431918,10/01/2020 12:00:00 AM,245,383,352
Eastern,Franklin City,51620,277,1002,1279,381,2037,2418,39292,262428,301720,10/01/2015 12:00:00 AM,142,262,236
Eastern,Franklin City,51620,277,934,1211,377,1963,2340,76132,362048,438180,11/01/2020 12:00:00 AM,275,388,362
Eastern,Franklin City,51620,278,1125,1403,435,2361,2796,48233,321417,369650,09/01/2013 12:00:00 AM,174,286,263
Eastern,Franklin City,51620,278,932,1210,373,1948,2321,82352,410670,493022,01/01/2021 12:00:00 AM,296,441,407
Eastern,Franklin City,51620,278,934,1212,369,1938,2307,82167,418668,500835,03/01/2021 12:00:00 AM,296,448,413
Eastern,Franklin City,51620,280,1131,1411,444,2350,2794,50461,312414,362875,07/01/2013 12:00:00 AM,180,276,257
Eastern,Franklin City,51620,280,925,1205,374,1908,2282,87899,446192,534091,06/01/2021 12:00:00 AM,314,482,443
Eastern,Franklin City,51620,281,1116,1397,441,2331,2772,47282,293377,340659,11/01/2013 12:00:00 AM,168,263,244
Eastern,Franklin City,51620,281,1119,1400,440,2340,2780,48585,316590,365175,08/01/2013 12:00:00 AM,173,283,261
Eastern,Franklin City,51620,281,938,1219,381,1979,2360,73598,358859,432457,12/01/2020 12:00:00 AM,262,383,355
Eastern,Franklin City,51620,282,928,1210,370,1939,2309,86283,444659,530942,04/01/2021 12:00:00 AM,306,479,439
Eastern,Franklin City,51620,284,1085,1369,453,2253,2706,47700,284077,331777,12/01/2013 12:00:00 AM,168,262,242
Eastern,Franklin City,51620,284,1086,1370,441,2230,2671,45725,282546,328271,03/01/2014 12:00:00 AM,161,260,240
Eastern,Franklin City,51620,284,922,1206,377,1946,2323,89293,447042,536335,05/01/2021 12:00:00 AM,314,485,445
Eastern,Franklin City,51620,286,1117,1403,456,2325,2781,53646,315247,368893,10/01/2013 12:00:00 AM,188,282,263
Eastern,Franklin City,51620,287,1086,1373,453,2248,2701,47191,277217,324408,01/01/2014 12:00:00 AM,164,255,236
Eastern,Franklin City,51620,289,1070,1359,475,2311,2786,56212,312170,368382,07/01/2012 12:00:00 AM,195,292,271
Eastern,Franklin City,51620,290,1053,1343,471,2264,2735,54912,301847,356759,05/01/2012 12:00:00 AM,189,287,266
Eastern,Franklin City,51620,290,1074,1364,452,2193,2645,48117,281147,329264,04/01/2014 12:00:00 AM,166,262,241
Eastern,Franklin City,51620,291,1125,1416,477,2319,2796,53918,308509,362427,06/01/2013 12:00:00 AM,185,274,256
Eastern,Franklin City,51620,293,1096,1389,485,2344,2829,58898,312040,370938,10/01/2012 12:00:00 AM,201,285,267
Eastern,Franklin City,51620,295,1052,1347,495,2267,2762,58712,302604,361316,06/01/2012 12:00:00 AM,199,288,268
Eastern,Franklin City,51620,295,1071,1366,485,2191,2676,51268,275864,327132,02/01/2014 12:00:00 AM,174,258,239
Eastern,Franklin City,51620,296,1076,1372,489,2322,2811,59475,311408,370883,09/01/2012 12:00:00 AM,201,289,270
Eastern,Franklin City,51620,298,1087,1385,490,2314,2804,58224,308556,366780,11/01/2012 12:00:00 AM,195,284,265
Eastern,Franklin City,51620,299,1087,1386,498,2311,2809,59065,310546,369611,12/01/2012 12:00:00 AM,198,286,267
Eastern,Franklin City,51620,299,1089,1388,484,2346,2830,57474,314358,371832,08/01/2012 12:00:00 AM,192,289,268
Eastern,Franklin City,51620,299,1130,1429,503,2325,2828,58211,310001,368212,05/01/2013 12:00:00 AM,195,274,258
Eastern,Franklin City,51620,300,1115,1415,507,2317,2824,59208,311242,370450,04/01/2013 12:00:00 AM,197,279,262
Eastern,Franklin City,51620,301,1092,1393,494,2300,2794,56259,303512,359771,01/01/2013 12:00:00 AM,187,278,258
Eastern,Franklin City,51620,302,1035,1337,506,2220,2726,58680,299243,357923,04/01/2012 12:00:00 AM,194,289,268
Eastern,Franklin City,51620,302,1100,1402,496,2288,2784,57324,307509,364833,03/01/2013 12:00:00 AM,190,280,260
Eastern,Franklin City,51620,306,1098,1404,515,2288,2803,59002,305393,364395,02/01/2013 12:00:00 AM,193,278,260
Eastern,Franklin City,51620,308,1039,1347,522,2197,2719,61678,297097,358775,03/01/2012 12:00:00 AM,200,286,266
Eastern,Franklin City,51620,310,1036,1346,521,2207,2728,62331,296729,359060,02/01/2012 12:00:00 AM,201,286,267
Eastern,Franklin City,51620,313,1018,1331,518,2161,2679,62371,288267,350638,01/01/2012 12:00:00 AM,199,283,263
Eastern,Gloucester County,51073,236,1792,2028,358,4047,4405,39977,524776,564753,09/01/2012 12:00:00 AM,169,293,278
Eastern,Gloucester County,51073,237,1809,2046,356,4013,4369,39832,523540,563372,11/01/2012 12:00:00 AM,168,289,275
Eastern,Gloucester County,51073,239,1812,2051,374,4005,4379,40059,521740,561799,08/01/2013 12:00:00 AM,168,288,274
Eastern,Gloucester County,51073,240,1779,2019,374,3996,4370,40912,518707,559619,08/01/2012 12:00:00 AM,170,292,277
Eastern,Gloucester County,51073,240,1784,2024,362,3990,4352,40156,519710,559866,10/01/2012 12:00:00 AM,167,291,277
Eastern,Gloucester County,51073,242,1801,2043,381,4010,4391,41969,519784,561753,07/01/2012 12:00:00 AM,173,289,275
Eastern,Gloucester County,51073,242,1823,2065,372,4043,4415,39506,521755,561261,03/01/2013 12:00:00 AM,163,286,272
Eastern,Gloucester County,51073,242,1834,2076,361,4092,4453,38143,525038,563181,01/01/2013 12:00:00 AM,158,286,271
Eastern,Gloucester County,51073,242,1836,2078,378,4101,4479,40689,525030,565719,05/01/2013 12:00:00 AM,168,286,272
Eastern,Gloucester County,51073,243,1841,2084,378,4134,4512,39370,542553,581923,05/01/2012 12:00:00 AM,162,295,279
Eastern,Gloucester County,51073,244,1850,2094,379,4145,4524,40636,539437,580073,06/01/2012 12:00:00 AM,167,292,277
Eastern,Gloucester County,51073,245,1805,2050,391,4117,4508,43133,530923,574056,01/01/2012 12:00:00 AM,176,294,280
Eastern,Gloucester County,51073,245,1806,2051,377,4022,4399,41935,522763,564698,12/01/2012 12:00:00 AM,171,289,275
Eastern,Gloucester County,51073,245,1843,2088,377,4100,4477,39192,531223,570415,02/01/2013 12:00:00 AM,160,288,273
Eastern,Gloucester County,51073,246,1806,2052,388,4020,4408,42626,521634,564260,09/01/2013 12:00:00 AM,173,289,275
Eastern,Gloucester County,51073,246,1839,2085,395,4066,4461,42598,529172,571770,06/01/2013 12:00:00 AM,173,288,274
Eastern,Gloucester County,51073,246,1851,2097,390,4168,4558,41809,544403,586212,04/01/2012 12:00:00 AM,170,294,280
Eastern,Gloucester County,51073,247,1817,2064,396,4006,4402,42144,519277,561421,07/01/2013 12:00:00 AM,171,286,272
Eastern,Gloucester County,51073,247,1824,2071,383,4054,4437,40416,518453,558869,04/01/2013 12:00:00 AM,164,284,270
Eastern,Gloucester County,51073,247,1839,2086,397,4163,4560,45323,545533,590856,02/01/2012 12:00:00 AM,183,297,283
Eastern,Gloucester County,51073,249,1808,2057,398,4033,4431,43332,519098,562430,10/01/2013 12:00:00 AM,174,287,273
Eastern,Gloucester County,51073,249,1832,2081,391,4134,4525,43774,545524,589298,03/01/2012 12:00:00 AM,176,298,283
Eastern,Gloucester County,51073,259,1725,1984,418,3858,4276,41691,455767,497458,05/01/2014 12:00:00 AM,161,264,251
Eastern,Gloucester County,51073,260,1686,1946,413,3810,4223,42153,449138,491291,06/01/2014 12:00:00 AM,162,266,252
Eastern,Gloucester County,51073,262,1640,1902,429,3747,4176,44638,432829,477467,07/01/2014 12:00:00 AM,170,264,251
Eastern,Gloucester County,51073,262,1806,2068,450,4026,4476,47979,476933,524912,11/01/2013 12:00:00 AM,183,264,254
Eastern,Gloucester County,51073,263,1781,2044,444,3980,4424,45751,468925,514676,03/01/2014 12:00:00 AM,174,263,252
Eastern,Gloucester County,51073,265,1772,2037,460,3958,4418,48499,468842,517341,12/01/2013 12:00:00 AM,183,265,254
Eastern,Gloucester County,51073,266,1761,2027,460,3920,4380,47987,455989,503976,01/01/2014 12:00:00 AM,180,259,249
Eastern,Gloucester County,51073,267,1751,2018,449,3902,4351,45428,459734,505162,04/01/2014 12:00:00 AM,170,263,250
Eastern,Gloucester County,51073,268,1592,1860,427,3676,4103,44166,423867,468033,08/01/2014 12:00:00 AM,165,266,252
Eastern,Gloucester County,51073,269,1766,2035,459,3938,4397,47475,464395,511870,02/01/2014 12:00:00 AM,176,263,252
Eastern,Gloucester County,51073,278,1572,1850,440,3612,4052,44915,413105,458020,09/01/2014 12:00:00 AM,162,263,248
Eastern,Gloucester County,51073,282,1280,1562,393,2913,3306,39722,357222,396944,06/01/2017 12:00:00 AM,141,279,254
Eastern,Gloucester County,51073,283,1316,1599,398,2976,3374,41776,361020,402796,03/01/2017 12:00:00 AM,148,274,252
Eastern,Gloucester County,51073,284,1281,1565,397,2888,3285,40479,353569,394048,05/01/2017 12:00:00 AM,143,276,252
Eastern,Gloucester County,51073,287,1309,1596,396,3039,3435,39992,358186,398178,11/01/2016 12:00:00 AM,139,274,249
Eastern,Gloucester County,51073,288,1238,1526,404,2833,3237,41420,344365,385785,07/01/2017 12:00:00 AM,144,278,253
Eastern,Gloucester County,51073,288,1515,1803,455,3499,3954,51157,410485,461642,10/01/2014 12:00:00 AM,178,271,256
Eastern,Gloucester County,51073,290,1282,1572,406,2900,3306,41428,353088,394516,04/01/2017 12:00:00 AM,143,275,251
Eastern,Gloucester County,51073,291,1312,1603,401,3022,3423,40916,353728,394644,10/01/2016 12:00:00 AM,141,270,246
Eastern,Gloucester County,51073,294,1200,1494,389,2617,3006,39909,325174,365083,10/01/2019 12:00:00 AM,136,271,244
Eastern,Gloucester County,51073,294,1225,1519,389,2642,3031,39078,315308,354386,08/01/2019 12:00:00 AM,133,257,233
Eastern,Gloucester County,51073,294,1240,1534,417,2825,3242,43752,350931,394683,08/01/2017 12:00:00 AM,149,283,257
Eastern,Gloucester County,51073,296,1325,1621,414,3045,3459,42406,352555,394961,12/01/2016 12:00:00 AM,143,266,244
Eastern,Gloucester County,51073,297,1324,1621,415,3011,3426,42155,358602,400757,02/01/2017 12:00:00 AM,142,271,247
Eastern,Gloucester County,51073,297,1499,1796,469,3432,3901,52532,407558,460090,11/01/2014 12:00:00 AM,177,272,256
Eastern,Gloucester County,51073,298,1214,1512,423,2753,3176,44632,333850,378482,09/01/2017 12:00:00 AM,150,275,250
Eastern,Gloucester County,51073,299,1303,1602,406,3051,3457,42781,353247,396028,08/01/2016 12:00:00 AM,143,271,247
Eastern,Gloucester County,51073,299,1322,1621,427,3033,3460,42996,359143,402139,01/01/2017 12:00:00 AM,144,272,248
Eastern,Gloucester County,51073,299,1325,1624,417,3089,3506,43663,356301,399964,09/01/2016 12:00:00 AM,146,269,246
Eastern,Gloucester County,51073,300,1215,1515,411,2568,2979,75498,441941,517439,03/01/2020 12:00:00 AM,252,364,342
Eastern,Gloucester County,51073,301,1227,1528,403,2631,3034,41041,317935,358976,07/01/2019 12:00:00 AM,136,259,235
Eastern,Gloucester County,51073,302,1231,1533,403,2657,3060,41154,325849,367003,09/01/2019 12:00:00 AM,136,265,239
Eastern,Gloucester County,51073,303,1407,1710,433,3255,3688,44839,383992,428831,01/01/2016 12:00:00 AM,148,273,251
Eastern,Gloucester County,51073,304,1198,1502,409,2585,2994,40853,316732,357585,11/01/2019 12:00:00 AM,134,264,238
Eastern,Gloucester County,51073,304,1295,1599,418,3066,3484,44344,355865,400209,07/01/2016 12:00:00 AM,146,275,250
Eastern,Gloucester County,51073,304,1379,1683,441,3201,3642,46659,378834,425493,03/01/2016 12:00:00 AM,153,275,253
Eastern,Gloucester County,51073,305,1371,1676,434,3191,3625,45038,378965,424003,04/01/2016 12:00:00 AM,148,276,253
Eastern,Gloucester County,51073,306,1186,1492,407,2551,2958,40180,307877,348057,01/01/2020 12:00:00 AM,131,260,233
Eastern,Gloucester County,51073,306,1203,1509,400,2608,3008,40529,315692,356221,02/01/2019 12:00:00 AM,132,262,236
Eastern,Gloucester County,51073,306,1227,1533,423,2740,3163,44252,329862,374114,10/01/2017 12:00:00 AM,145,269,244
Eastern,Gloucester County,51073,306,1233,1539,414,2674,3088,42090,325700,367790,06/01/2019 12:00:00 AM,138,264,239
Eastern,Gloucester County,51073,307,1198,1505,412,2566,2978,41285,316097,357382,02/01/2020 12:00:00 AM,134,264,237
Eastern,Gloucester County,51073,307,1200,1507,419,2608,3027,42298,321455,363753,12/01/2019 12:00:00 AM,138,268,241
Eastern,Gloucester County,51073,307,1202,1509,399,2689,3088,45664,333335,378999,10/01/2018 12:00:00 AM,149,277,251
Eastern,Gloucester County,51073,307,1235,1542,418,2712,3130,42977,326265,369242,06/01/2018 12:00:00 AM,140,264,239
Eastern,Gloucester County,51073,307,1316,1623,436,3081,3517,46205,361728,407933,06/01/2016 12:00:00 AM,151,275,251
Eastern,Gloucester County,51073,308,1221,1529,414,2698,3112,41116,327175,368291,07/01/2018 12:00:00 AM,133,268,241
Eastern,Gloucester County,51073,308,1387,1695,418,2908,3326,80392,544202,624594,11/01/2020 12:00:00 AM,261,392,368
Eastern,Gloucester County,51073,309,1244,1553,419,2689,3108,42015,327389,369404,05/01/2019 12:00:00 AM,136,263,238
Eastern,Gloucester County,51073,309,1338,1647,442,3136,3578,46484,367940,414424,05/01/2016 12:00:00 AM,150,275,252
Eastern,Gloucester County,51073,309,1350,1659,409,2836,3245,98606,662667,761273,06/01/2021 12:00:00 AM,319,491,459
Eastern,Gloucester County,51073,310,1226,1536,436,2744,3180,46020,330501,376521,04/01/2018 12:00:00 AM,148,270,245
Eastern,Gloucester County,51073,310,1230,1540,429,2719,3148,45809,327552,373361,05/01/2018 12:00:00 AM,148,266,242
Eastern,Gloucester County,51073,310,1394,1704,415,2899,3314,81745,536881,618626,10/01/2020 12:00:00 AM,264,385,363
Eastern,Gloucester County,51073,310,1404,1714,448,3259,3707,47022,385386,432408,02/01/2016 12:00:00 AM,152,274,252
Eastern,Gloucester County,51073,311,1199,1510,421,2725,3146,44966,326515,371481,11/01/2017 12:00:00 AM,145,272,246
Eastern,Gloucester County,51073,311,1208,1519,416,2719,3135,43341,325893,369234,11/01/2018 12:00:00 AM,139,270,243
Eastern,Gloucester County,51073,311,1209,1520,413,2665,3078,41823,317500,359323,09/01/2018 12:00:00 AM,134,263,236
Eastern,Gloucester County,51073,311,1419,1730,421,2949,3370,77011,507682,584693,08/01/2020 12:00:00 AM,248,358,338
Eastern,Gloucester County,51073,311,1517,1828,497,3450,3947,53032,409700,462732,02/01/2015 12:00:00 AM,171,270,253
Eastern,Gloucester County,51073,312,1237,1549,432,2789,3221,45098,331433,376531,03/01/2018 12:00:00 AM,145,268,243
Eastern,Gloucester County,51073,312,1258,1570,415,2732,3147,41511,329260,370771,04/01/2019 12:00:00 AM,133,262,236
Eastern,Gloucester County,51073,312,1355,1667,426,2855,3281,77403,499064,576467,04/01/2020 12:00:00 AM,248,368,346
Eastern,Gloucester County,51073,312,1399,1711,415,2931,3346,93789,627301,721090,02/01/2021 12:00:00 AM,301,448,421
Eastern,Gloucester County,51073,312,1501,1813,483,3426,3909,51309,404806,456115,06/01/2015 12:00:00 AM,164,270,252
Eastern,Gloucester County,51073,313,1213,1526,417,2669,3086,41995,322891,364886,08/01/2018 12:00:00 AM,134,266,239
Eastern,Gloucester County,51073,313,1228,1541,430,2770,3200,45408,330717,376125,02/01/2018 12:00:00 AM,145,269,244
Eastern,Gloucester County,51073,313,1369,1682,426,2891,3317,82921.59,534232,617153.59,12/01/2020 12:00:00 AM,265,390,367
Eastern,Gloucester County,51073,314,1425,1739,464,3276,3740,49627,388166,437793,10/01/2015 12:00:00 AM,158,272,252
Eastern,Gloucester County,51073,314,1437,1751,485,3270,3755,51697,386114,437811,07/01/2015 12:00:00 AM,165,269,250
Eastern,Gloucester County,51073,315,1247,1562,427,2718,3145,43611,327473,371084,03/01/2019 12:00:00 AM,138,263,238
Eastern,Gloucester County,51073,315,1377,1692,425,2888,3313,95214,604015,699229,01/01/2021 12:00:00 AM,302,439,413
Eastern,Gloucester County,51073,315,1418,1733,425,2957,3382,79888,517672,597560,09/01/2020 12:00:00 AM,254,365,345
Eastern,Gloucester County,51073,315,1526,1841,511,3461,3972,58132,410952,469084,12/01/2014 12:00:00 AM,185,269,255
Eastern,Gloucester County,51073,316,1219,1535,421,2739,3160,45014,328104,373118,12/01/2018 12:00:00 AM,142,269,243
Eastern,Gloucester County,51073,316,1224,1540,440,2759,3199,46062,330123,376185,01/01/2018 12:00:00 AM,146,270,244
Eastern,Gloucester County,51073,316,1358,1674,421,2861,3282,98735,663330,762065,05/01/2021 12:00:00 AM,312,488,455
Eastern,Gloucester County,51073,316,1421,1737,480,3267,3747,51083,388884,439967,08/01/2015 12:00:00 AM,162,274,253
Eastern,Gloucester County,51073,316,1528,1844,508,3451,3959,55162,405549,460711,01/01/2015 12:00:00 AM,175,265,250
Eastern,Gloucester County,51073,317,1386,1703,426,2903,3329,94843,612174,707017,03/01/2021 12:00:00 AM,299,442,415
Eastern,Gloucester County,51073,317,1517,1834,501,3472,3973,52749,409220,461969,03/01/2015 12:00:00 AM,166,270,252
Eastern,Gloucester County,51073,318,1217,1535,443,2785,3228,47771,336434,384205,12/01/2017 12:00:00 AM,150,276,250
Eastern,Gloucester County,51073,318,1352,1670,428,2822,3250,101656,648084,749740,04/01/2021 12:00:00 AM,320,479,449
Eastern,Gloucester County,51073,318,1390,1708,432,2887,3319,79931,502333,582264,05/01/2020 12:00:00 AM,251,361,341
Eastern,Gloucester County,51073,318,1408,1726,429,2902,3331,78577,506024,584601,06/01/2020 12:00:00 AM,247,359,339
Eastern,Gloucester County,51073,318,1529,1847,492,3489,3981,53088,415783,468871,05/01/2015 12:00:00 AM,167,272,254
Eastern,Gloucester County,51073,319,1396,1715,463,3230,3693,48306,376039,424345,12/01/2015 12:00:00 AM,151,269,247
Eastern,Gloucester County,51073,319,1419,1738,492,3260,3752,53775,386439,440214,09/01/2015 12:00:00 AM,169,272,253
Eastern,Gloucester County,51073,319,1431,1750,432,2962,3394,80010,519803,599813,07/01/2020 12:00:00 AM,251,363,343
Eastern,Gloucester County,51073,319,1536,1855,501,3498,3999,53188,417810,470998,04/01/2015 12:00:00 AM,167,272,254
Eastern,Gloucester County,51073,320,1254,1574,433,2777,3210,46922,344357,391279,01/01/2019 12:00:00 AM,147,275,249
Eastern,Gloucester County,51073,320,1406,1726,472,3242,3714,50120,383285,433405,11/01/2015 12:00:00 AM,157,273,251
Eastern,Greensville County,51081,136,656,792,184,1380,1564,18112,174660,192772,03/01/2018 12:00:00 AM,133,266,243
Eastern,Greensville County,51081,137,630,767,183,1308,1491,17714,168461,186175,05/01/2018 12:00:00 AM,129,267,243
Eastern,Greensville County,51081,137,649,786,180,1378,1558,17968,171580,189548,02/01/2018 12:00:00 AM,131,264,241
Eastern,Greensville County,51081,138,648,786,184,1356,1540,18158,174157,192315,04/01/2018 12:00:00 AM,132,269,245
Eastern,Greensville County,51081,139,664,803,184,1403,1587,18232,173693,191925,01/01/2018 12:00:00 AM,131,262,239
Eastern,Greensville County,51081,142,682,824,193,1426,1619,19003,178927,197930,09/01/2017 12:00:00 AM,134,262,240
Eastern,Greensville County,51081,143,662,805,192,1392,1584,19639,179203,198842,12/01/2017 12:00:00 AM,137,271,247
Eastern,Greensville County,51081,143,670,813,195,1401,1596,19820,175936,195756,11/01/2017 12:00:00 AM,139,263,241
Eastern,Greensville County,51081,144,629,773,196,1317,1513,19304,169573,188877,06/01/2018 12:00:00 AM,134,270,244
Eastern,Greensville County,51081,145,600,745,195,1206,1401,20544,155291,175835,02/01/2019 12:00:00 AM,142,259,236
Eastern,Greensville County,51081,145,625,770,193,1302,1495,18721,168278,186999,07/01/2018 12:00:00 AM,129,269,243
Eastern,Greensville County,51081,146,631,777,198,1276,1474,20232,169282,189514,12/01/2018 12:00:00 AM,139,268,244
Eastern,Greensville County,51081,147,636,783,221,1290,1511,22929,164901,187830,08/01/2019 12:00:00 AM,156,259,240
Eastern,Greensville County,51081,147,674,821,204,1414,1618,20080,179112,199192,10/01/2017 12:00:00 AM,137,266,243
Eastern,Greensville County,51081,147,688,835,202,1437,1639,20146,183388,203534,06/01/2017 12:00:00 AM,137,267,244
Eastern,Greensville County,51081,148,626,774,205,1260,1465,20803,162378,183181,11/01/2018 12:00:00 AM,141,259,237
Eastern,Greensville County,51081,148,631,779,220,1266,1486,22743,159221,181964,07/01/2019 12:00:00 AM,154,252,234
Eastern,Greensville County,51081,148,632,780,204,1259,1463,21486,169167,190653,01/01/2019 12:00:00 AM,145,268,244
Eastern,Greensville County,51081,150,630,780,221,1273,1494,22308,159516,181824,06/01/2019 12:00:00 AM,149,253,233
Eastern,Greensville County,51081,150,693,843,207,1477,1684,20454,187332,207786,04/01/2017 12:00:00 AM,136,270,246
Eastern,Greensville County,51081,151,624,775,221,1268,1489,22017,159023,181040,09/01/2019 12:00:00 AM,146,255,234
Eastern,Greensville County,51081,151,686,837,209,1458,1667,22542,182218,204760,08/01/2017 12:00:00 AM,149,266,245
Eastern,Greensville County,51081,152,620,772,224,1272,1496,22975,162032,185007,05/01/2019 12:00:00 AM,151,261,240
Eastern,Greensville County,51081,152,724,876,207,1543,1750,19310,188805,208115,02/01/2017 12:00:00 AM,127,261,238
Eastern,Greensville County,51081,153,611,764,217,1238,1455,23029,156806,179835,03/01/2019 12:00:00 AM,151,257,235
Eastern,Greensville County,51081,153,613,766,216,1254,1470,22716,158908,181624,04/01/2019 12:00:00 AM,148,259,237
Eastern,Greensville County,51081,153,674,827,214,1415,1629,21504,179426,200930,07/01/2017 12:00:00 AM,141,266,243
Eastern,Greensville County,51081,154,623,777,218,1277,1495,20323,162951,183274,09/01/2018 12:00:00 AM,132,262,236
Eastern,Greensville County,51081,154,710,864,209,1500,1709,19172,181991,201163,01/01/2017 12:00:00 AM,124,256,233
Eastern,Greensville County,51081,154,711,865,210,1502,1712,20501,180488,200989,12/01/2016 12:00:00 AM,133,254,232
Eastern,Greensville County,51081,154,726,880,213,1535,1748,20520,184575,205095,11/01/2016 12:00:00 AM,133,254,233
Eastern,Greensville County,51081,154,774,928,219,1617,1836,21067,201135,222202,10/01/2015 12:00:00 AM,137,260,239
Eastern,Greensville County,51081,155,617,772,227,1270,1497,22806,163443,186249,08/01/2018 12:00:00 AM,147,265,241
Eastern,Greensville County,51081,155,629,784,229,1270,1499,23789,160366,184155,10/01/2019 12:00:00 AM,153,255,235
Eastern,Greensville County,51081,155,631,786,219,1283,1502,22281,167830,190111,10/01/2018 12:00:00 AM,144,266,242
Eastern,Greensville County,51081,155,679,834,209,1433,1642,20705,182554,203259,05/01/2017 12:00:00 AM,134,269,244
Eastern,Greensville County,51081,156,614,770,225,1245,1470,23273,154203,177476,11/01/2019 12:00:00 AM,149,251,230
Eastern,Greensville County,51081,156,725,881,207,1544,1751,20695,185742,206437,10/01/2016 12:00:00 AM,133,256,234
Eastern,Greensville County,51081,156,762,918,212,1555,1767,20228,195138,215366,05/01/2016 12:00:00 AM,130,256,235
Eastern,Greensville County,51081,157,624,781,224,1250,1474,22488,158739,181227,12/01/2019 12:00:00 AM,143,254,232
Eastern,Greensville County,51081,157,701,858,216,1485,1701,21517,185712,207229,03/01/2017 12:00:00 AM,137,265,242
Eastern,Greensville County,51081,157,753,910,212,1577,1789,20754,192413,213167,08/01/2016 12:00:00 AM,132,256,234
Eastern,Greensville County,51081,157,767,924,232,1616,1848,22360,204127,226487,09/01/2015 12:00:00 AM,142,266,245
Eastern,Greensville County,51081,157,768,925,215,1583,1798,20208,198931,219139,06/01/2016 12:00:00 AM,129,259,237
Eastern,Greensville County,51081,157,781,938,227,1621,1848,22376,200199,222575,11/01/2015 12:00:00 AM,143,256,237
Eastern,Greensville County,51081,158,618,776,227,1233,1460,21529,154070,175599,01/01/2020 12:00:00 AM,136,249,226
Eastern,Greensville County,51081,159,620,779,224,1229,1453,22816,153195,176011,02/01/2020 12:00:00 AM,143,247,226
Eastern,Greensville County,51081,159,627,786,223,1251,1474,40416,219181,259597,03/01/2020 12:00:00 AM,254,350,330
Eastern,Greensville County,51081,159,777,936,223,1645,1868,22017,205520,227537,08/01/2015 12:00:00 AM,138,265,243
Eastern,Greensville County,51081,160,681,841,237,1334,1571,51468,277378,328846,01/01/2021 12:00:00 AM,322,407,391
Eastern,Greensville County,51081,160,747,907,220,1553,1773,21518,190954,212472,07/01/2016 12:00:00 AM,134,256,234
Eastern,Greensville County,51081,160,775,935,234,1586,1820,22908,197668,220576,03/01/2016 12:00:00 AM,143,255,236
Eastern,Greensville County,51081,161,774,935,227,1591,1818,22708,199712,222420,04/01/2016 12:00:00 AM,141,258,238
Eastern,Greensville County,51081,162,746,908,220,1580,1800,22693,190667,213360,09/01/2016 12:00:00 AM,140,256,235
Eastern,Greensville County,51081,163,692,855,238,1349,1587,54897,310222,365119,05/01/2021 12:00:00 AM,337,448,427
Eastern,Greensville County,51081,163,696,859,243,1353,1596,55631,317892,373523,04/01/2021 12:00:00 AM,341,457,435
Eastern,Greensville County,51081,163,706,869,240,1381,1621,52662,298948,351610,02/01/2021 12:00:00 AM,323,423,405
Eastern,Greensville County,51081,163,707,870,242,1372,1614,53983,324957,378940,06/01/2021 12:00:00 AM,331,460,436
Eastern,Greensville County,51081,163,794,957,243,1641,1884,24791,206884,231675,07/01/2012 12:00:00 AM,152,261,242
Eastern,Greensville County,51081,164,681,845,246,1333,1579,45648,248468,294116,10/01/2020 12:00:00 AM,278,365,348
Eastern,Greensville County,51081,164,712,876,241,1386,1627,53092,286982,340074,03/01/2021 12:00:00 AM,324,403,388
Eastern,Greensville County,51081,164,765,929,240,1608,1848,23241,200488,223729,07/01/2015 12:00:00 AM,142,262,241
Eastern,Greensville County,51081,165,671,836,252,1306,1558,47977,243117,291094,12/01/2020 12:00:00 AM,291,362,348
Eastern,Greensville County,51081,165,698,863,243,1386,1629,45331,244534,289865,05/01/2020 12:00:00 AM,275,350,336
Eastern,Greensville County,51081,165,771,936,245,1582,1827,24756,195914,220670,02/01/2016 12:00:00 AM,150,254,236
Eastern,Greensville County,51081,165,774,939,249,1603,1852,25120,195239,220359,01/01/2016 12:00:00 AM,152,252,235
Eastern,Greensville County,51081,165,795,960,252,1649,1901,25145,208065,233210,05/01/2012 12:00:00 AM,152,262,243
Eastern,Greensville County,51081,166,681,847,244,1354,1598,43529,235484,279013,04/01/2020 12:00:00 AM,262,346,329
Eastern,Greensville County,51081,166,785,951,251,1644,1895,25216,200692,225908,12/01/2015 12:00:00 AM,152,256,238
Eastern,Greensville County,51081,167,796,963,256,1638,1894,25405,207362,232767,06/01/2012 12:00:00 AM,152,261,242
Eastern,Greensville County,51081,167,802,969,240,1654,1894,23813,211348,235161,08/01/2012 12:00:00 AM,143,264,243
Eastern,Greensville County,51081,170,670,840,261,1298,1559,51350,243575,294925,11/01/2020 12:00:00 AM,302,364,351
Eastern,Greensville County,51081,170,699,869,256,1366,1622,46124,242348,288472,09/01/2020 12:00:00 AM,271,347,332
Eastern,Greensville County,51081,170,708,878,253,1389,1642,45918,245433,291351,06/01/2020 12:00:00 AM,270,347,332
Eastern,Greensville County,51081,170,708,878,255,1389,1644,45446,239942,285388,08/01/2020 12:00:00 AM,267,339,325
Eastern,Greensville County,51081,170,842,1012,251,1721,1972,25298,221911,247209,10/01/2012 12:00:00 AM,149,264,244
Eastern,Greensville County,51081,170,855,1025,248,1727,1975,26311,223355,249666,11/01/2012 12:00:00 AM,155,261,244
Eastern,Greensville County,51081,171,767,938,246,1632,1878,24634,204666,229300,06/01/2015 12:00:00 AM,144,267,244
Eastern,Greensville County,51081,171,813,984,246,1664,1910,24567,212192,236759,09/01/2012 12:00:00 AM,144,261,241
Eastern,Greensville County,51081,172,852,1024,257,1730,1987,27511,223138,250649,02/01/2013 12:00:00 AM,160,262,245
Eastern,Greensville County,51081,173,857,1030,259,1732,1991,28340,223577,251917,12/01/2012 12:00:00 AM,164,261,245
Eastern,Greensville County,51081,174,717,891,257,1413,1670,46628,244167,290795,07/01/2020 12:00:00 AM,268,341,326
Eastern,Greensville County,51081,174,794,968,267,1637,1904,28323,208057,236380,04/01/2012 12:00:00 AM,163,262,244
Eastern,Greensville County,51081,174,811,985,255,1709,1964,27076,217266,244342,11/01/2014 12:00:00 AM,156,268,248
Eastern,Greensville County,51081,174,841,1015,258,1699,1957,27760,219356,247116,03/01/2013 12:00:00 AM,160,261,243
Eastern,Greensville County,51081,174,846,1020,250,1715,1965,26136,223357,249493,04/01/2013 12:00:00 AM,150,264,245
Eastern,Greensville County,51081,174,859,1033,260,1722,1982,28374,219954,248328,01/01/2013 12:00:00 AM,163,256,240
Eastern,Greensville County,51081,175,818,993,232,1758,1990,23146,211819,234965,09/01/2014 12:00:00 AM,132,259,237
Eastern,Greensville County,51081,176,769,945,261,1628,1889,26935,203999,230934,05/01/2015 12:00:00 AM,153,265,244
Eastern,Greensville County,51081,177,829,1006,260,1689,1949,27045,220953,247998,07/01/2013 12:00:00 AM,153,267,247
Eastern,Greensville County,51081,177,831,1008,255,1694,1949,26831,223777,250608,08/01/2013 12:00:00 AM,152,269,249
Eastern,Greensville County,51081,177,841,1018,262,1713,1975,26543,224437,250980,06/01/2013 12:00:00 AM,150,267,247
Eastern,Greensville County,51081,178,806,984,283,1641,1924,29540,209744,239284,03/01/2012 12:00:00 AM,166,260,243
Eastern,Greensville County,51081,178,807,985,247,1723,1970,26578,218890,245468,10/01/2014 12:00:00 AM,149,271,249
Eastern,Greensville County,51081,178,808,986,279,1654,1933,27905,209424,237329,02/01/2012 12:00:00 AM,157,259,241
Eastern,Greensville County,51081,178,830,1008,261,1696,1957,25745,221454,247199,05/01/2013 12:00:00 AM,145,267,245
Eastern,Greensville County,51081,179,790,969,260,1656,1916,26995,207866,234861,03/01/2015 12:00:00 AM,151,263,242
Eastern,Greensville County,51081,179,806,985,285,1646,1931,29415,206597,236012,01/01/2012 12:00:00 AM,164,256,240
Eastern,Greensville County,51081,180,787,967,267,1664,1931,27775,206378,234153,04/01/2015 12:00:00 AM,154,262,242
Eastern,Greensville County,51081,181,807,988,258,1708,1966,26671,215084,241755,02/01/2015 12:00:00 AM,147,267,245
Eastern,Greensville County,51081,181,813,994,252,1751,2003,26105,215722,241827,08/01/2014 12:00:00 AM,144,265,243
Eastern,Greensville County,51081,181,833,1014,268,1696,1964,28866,222775,251641,09/01/2013 12:00:00 AM,159,267,248
Eastern,Greensville County,51081,182,836,1018,264,1724,1988,26284,210145,236429,01/01/2014 12:00:00 AM,144,251,232
Eastern,Greensville County,51081,182,843,1025,269,1693,1962,28983,223429,252412,10/01/2013 12:00:00 AM,159,265,246
Eastern,Greensville County,51081,183,842,1025,272,1716,1988,27155,206955,234110,11/01/2013 12:00:00 AM,148,246,228
Eastern,Greensville County,51081,184,822,1006,266,1724,1990,26874,211051,237925,05/01/2014 12:00:00 AM,146,257,237
Eastern,Greensville County,51081,184,833,1017,267,1713,1980,27861,207909,235770,12/01/2013 12:00:00 AM,151,250,232
Eastern,Greensville County,51081,185,814,999,261,1741,2002,26021,212689,238710,07/01/2014 12:00:00 AM,141,261,239
Eastern,Greensville County,51081,185,814,999,277,1712,1989,28992,208181,237173,06/01/2014 12:00:00 AM,157,256,237
Eastern,Greensville County,51081,185,843,1028,266,1726,1992,26098,212601,238699,02/01/2014 12:00:00 AM,141,252,232
Eastern,Greensville County,51081,186,823,1009,268,1705,1973,26686,209924,236610,04/01/2014 12:00:00 AM,143,255,234
Eastern,Greensville County,51081,187,810,997,270,1700,1970,28078,212164,240242,01/01/2015 12:00:00 AM,150,262,241
Eastern,Greensville County,51081,188,819,1007,274,1714,1988,29379,214976,244355,12/01/2014 12:00:00 AM,156,262,243
Eastern,Greensville County,51081,190,827,1017,275,1710,1985,27421,215482,242903,03/01/2014 12:00:00 AM,144,261,239
Eastern,Hampton City,51650,1656,7289,8945,2622,16744,19366,282978,2151961,2434939,07/01/2017 12:00:00 AM,171,295,272
Eastern,Hampton City,51650,1666,7346,9012,2592,16697,19289,275223,2136525.82,2411748.82,05/01/2017 12:00:00 AM,165,291,268
Eastern,Hampton City,51650,1674,7312,8986,2653,16726,19379,286719,2146019,2432738,06/01/2017 12:00:00 AM,171,293,271
Eastern,Hampton City,51650,1679,7330,9009,2627,16736,19363,277205,2121328,2398533,03/01/2017 12:00:00 AM,165,289,266
Eastern,Hampton City,51650,1680,7350,9030,2661,16813,19474,287826,2151370,2439196,08/01/2017 12:00:00 AM,171,293,270
Eastern,Hampton City,51650,1682,7295,8977,2624,16592,19216,281367,2112318,2393685,04/01/2017 12:00:00 AM,167,290,267
Eastern,Hampton City,51650,1684,7373,9057,2667,16869,19536,289183,2155532,2444715,09/01/2017 12:00:00 AM,172,292,270
Eastern,Hampton City,51650,1687,7334,9021,2589,15938,18527,268543,2032816,2301359,10/01/2019 12:00:00 AM,159,277,255
Eastern,Hampton City,51650,1692,7231,8923,2582,15568,18150,261697,1960767,2222464,01/01/2020 12:00:00 AM,155,271,249
Eastern,Hampton City,51650,1695,7216,8911,2586,15558,18144,263359,1972721,2236080,02/01/2020 12:00:00 AM,155,273,251
Eastern,Hampton City,51650,1697,7396,9093,2672,16892,19564,289899,2143325,2433224,10/01/2017 12:00:00 AM,171,290,268
Eastern,Hampton City,51650,1702,7316,9018,2594,15785,18379,267149,2010287,2277436,12/01/2019 12:00:00 AM,157,275,253
Eastern,Hampton City,51650,1704,7286,8990,2596,15904,18500,275348,2012502,2287850,09/01/2019 12:00:00 AM,162,276,254
Eastern,Hampton City,51650,1705,6784,8489,2591,14962,17553,271419,1886328,2157747,02/01/2019 12:00:00 AM,159,278,254
Eastern,Hampton City,51650,1705,7282,8987,2629,15766,18395,471325,2713226,3184551,03/01/2020 12:00:00 AM,276,373,354
Eastern,Hampton City,51650,1710,7362,9072,2690,16792,19482,294952,2120420,2415372,11/01/2017 12:00:00 AM,172,288,266
Eastern,Hampton City,51650,1711,7306,9017,2710,16573,19283,302022,2084458,2386480,12/01/2017 12:00:00 AM,177,285,265
Eastern,Hampton City,51650,1716,7238,8954,2612,15868,18480,275110,2002922,2278032,08/01/2019 12:00:00 AM,160,277,254
Eastern,Hampton City,51650,1720,8336,10056,2469,17621,20090,552045,3761380,4313425,02/01/2021 12:00:00 AM,321,451,429
Eastern,Hampton City,51650,1722,7076,8798,2683,15909,18592,281784,1998836,2280620,04/01/2018 12:00:00 AM,164,282,259
Eastern,Hampton City,51650,1722,7320,9042,2641,15877,18518,274630,2003929,2278559,11/01/2019 12:00:00 AM,159,274,252
Eastern,Hampton City,51650,1723,7118,8841,2664,15782,18446,287582,1982078,2269660,12/01/2018 12:00:00 AM,167,278,257
Eastern,Hampton City,51650,1725,7048,8773,2705,15839,18544,281231,1975541.8,2256772.8,05/01/2018 12:00:00 AM,163,280,257
Eastern,Hampton City,51650,1727,7193,8920,2631,15790,18421,276062,1973502,2249564,06/01/2019 12:00:00 AM,160,274,252
Eastern,Hampton City,51650,1727,7544,9271,2730,17300,20030,284365,2150719,2435084,02/01/2017 12:00:00 AM,165,285,263
Eastern,Hampton City,51650,1729,7134,8863,2646,15630,18276,272423,1955792,2228215,04/01/2019 12:00:00 AM,158,274,251
Eastern,Hampton City,51650,1734,7165,8899,2659,15752,18411,288428,2069309,2357737,01/01/2019 12:00:00 AM,166,289,265
Eastern,Hampton City,51650,1735,7238,8973,2645,15817,18462,277065,1981252,2258317,07/01/2019 12:00:00 AM,160,274,252
Eastern,Hampton City,51650,1737,7105,8842,2670,15540,18210,278664,1935190,2213854,03/01/2019 12:00:00 AM,160,272,250
Eastern,Hampton City,51650,1739,7067,8806,2719,15804,18523,289678,1980775,2270453,11/01/2018 12:00:00 AM,167,280,258
Eastern,Hampton City,51650,1740,7119,8859,2652,15578,18230,275162,1945516,2220678,05/01/2019 12:00:00 AM,158,273,251
Eastern,Hampton City,51650,1743,7020,8763,2713,15699,18412,291274,1996645.72,2287919.72,10/01/2018 12:00:00 AM,167,284,261
Eastern,Hampton City,51650,1744,7101,8845,2755,16003,18758,291826,2007934,2299760,03/01/2018 12:00:00 AM,167,283,260
Eastern,Hampton City,51650,1745,7467,9212,2806,17145,19951,294558,2122432,2416990,01/01/2017 12:00:00 AM,169,284,262
Eastern,Hampton City,51650,1754,7241,8995,2765,16394,19159,296034,2051159,2347193,01/01/2018 12:00:00 AM,169,283,261
Eastern,Hampton City,51650,1757,7060,8817,2748,15931,18679,289053,1988500,2277553,06/01/2018 12:00:00 AM,165,282,258
Eastern,Hampton City,51650,1760,6951,8711,2764,15607,18371,293912,1958120,2252032,09/01/2018 12:00:00 AM,167,282,259
Eastern,Hampton City,51650,1761,7040,8801,2761,15871,18632,289000,1984552,2273552,07/01/2018 12:00:00 AM,164,282,258
Eastern,Hampton City,51650,1765,7127,8892,2803,16104,18907,299827,2016583,2316410,02/01/2018 12:00:00 AM,170,283,261
Eastern,Hampton City,51650,1765,8230,9995,2730,17512,20242,490255,3062136,3552391,04/01/2020 12:00:00 AM,278,372,355
Eastern,Hampton City,51650,1770,8322,10092,2596,17430,20026,574271,3685255,4259526,03/01/2021 12:00:00 AM,324,443,422
Eastern,Hampton City,51650,1777,7039,8816,2789,15820,18609,293806,1974859,2268665,08/01/2018 12:00:00 AM,165,281,257
Eastern,Hampton City,51650,1780,8199,9979,2681,17368,20049,520031,3211996,3732027,11/01/2020 12:00:00 AM,292,392,374
Eastern,Hampton City,51650,1785,7470,9255,2895,17198,20093,307998,2138069,2446067,12/01/2016 12:00:00 AM,173,286,264
Eastern,Hampton City,51650,1790,8191,9981,2664,17053,19717,616058,3944989,4561047,04/01/2021 12:00:00 AM,344,482,457
Eastern,Hampton City,51650,1791,8195,9986,2695,17359,20054,519828,3188553,3708381,12/01/2020 12:00:00 AM,290,389,371
Eastern,Hampton City,51650,1796,8337,10133,2725,17588,20313,512272,3229658,3741930,10/01/2020 12:00:00 AM,285,387,369
Eastern,Hampton City,51650,1800,8129,9929,2676,16914,19590,621746,3917985,4539731,05/01/2021 12:00:00 AM,345,482,457
Eastern,Hampton City,51650,1806,8123,9929,2732,17160,19892,589956,3599439,4189395,01/01/2021 12:00:00 AM,327,443,422
Eastern,Hampton City,51650,1807,8124,9931,2693,16962,19655,617650,3957562,4575212,06/01/2021 12:00:00 AM,342,487,461
Eastern,Hampton City,51650,1808,7465,9273,2998,17199,20197,328545,2133006,2461551,11/01/2016 12:00:00 AM,182,286,265
Eastern,Hampton City,51650,1810,8506,10316,2769,17929,20698,500958,3136214,3637172,09/01/2020 12:00:00 AM,277,369,353
Eastern,Hampton City,51650,1811,8441,10252,2823,17901,20724,509623,3123363,3632986,05/01/2020 12:00:00 AM,281,370,354
Eastern,Hampton City,51650,1820,8580,10400,2797,18062,20859,499574,3114956.53,3614530.53,08/01/2020 12:00:00 AM,274,363,348
Eastern,Hampton City,51650,1827,7540,9367,3040,17337,20377,328876,2169644,2498520,10/01/2016 12:00:00 AM,180,288,267
Eastern,Hampton City,51650,1830,7512,9342,3035,17331,20366,330208,2123745,2453953,09/01/2016 12:00:00 AM,180,283,263
Eastern,Hampton City,51650,1831,8533,10364,2850,18029,20879,515684,3137248,3652932,06/01/2020 12:00:00 AM,282,368,352
Eastern,Hampton City,51650,1842,8621,10463,2862,18144,21006,521430,3142846,3664276,07/01/2020 12:00:00 AM,283,365,350
Eastern,Hampton City,51650,1856,7390,9246,3177,17428,20605,341327,2165971,2507298,08/01/2015 12:00:00 AM,184,293,271
Eastern,Hampton City,51650,1862,7427,9289,3125,17268,20393,340314,2127407,2467721,08/01/2016 12:00:00 AM,183,286,266
Eastern,Hampton City,51650,1871,7324,9195,3157,17077,20234,347365,2097104,2444469,07/01/2016 12:00:00 AM,186,286,266
Eastern,Hampton City,51650,1877,7359,9236,3194,17103,20297,351062,2087964,2439026,06/01/2016 12:00:00 AM,187,284,264
Eastern,Hampton City,51650,1878,7371,9249,3277,17341,20618,364610,2147423,2512033,11/01/2015 12:00:00 AM,194,291,272
Eastern,Hampton City,51650,1880,7263,9143,3218,17056,20274,357226,2111745,2468971,02/01/2016 12:00:00 AM,190,291,270
Eastern,Hampton City,51650,1880,7376,9256,3262,17337,20599,366293,2152529,2518822,10/01/2015 12:00:00 AM,195,292,272
Eastern,Hampton City,51650,1881,7266,9147,3181,17009,20190,346927,2097661,2444588,04/01/2016 12:00:00 AM,184,289,267
Eastern,Hampton City,51650,1882,7487,9369,3261,17652,20913,352148,2189679,2541827,05/01/2015 12:00:00 AM,187,292,271
Eastern,Hampton City,51650,1885,7482,9367,3260,17612,20872,352429,2179602,2532031,06/01/2015 12:00:00 AM,187,291,270
Eastern,Hampton City,51650,1887,7370,9257,3261,17418,20679,349892,2155994,2505886,07/01/2015 12:00:00 AM,185,293,271
Eastern,Hampton City,51650,1891,7349,9240,3284,17321,20605,360891,2141166,2502057,09/01/2015 12:00:00 AM,191,291,271
Eastern,Hampton City,51650,1891,7351,9242,3282,17287,20569,365635,2138833,2504468,12/01/2015 12:00:00 AM,193,291,271
Eastern,Hampton City,51650,1894,7300,9194,3252,17047,20299,359175,2099958,2459133,05/01/2016 12:00:00 AM,190,288,267
Eastern,Hampton City,51650,1895,7266,9161,3243,17003,20246,355547,2090878,2446425,03/01/2016 12:00:00 AM,188,288,267
Eastern,Hampton City,51650,1904,7267,9171,3316,17065,20381,366294,2093198,2459492,01/01/2016 12:00:00 AM,192,288,268
Eastern,Hampton City,51650,1917,7509,9426,3339,17600,20939,367285,2176302,2543587,04/01/2015 12:00:00 AM,192,290,270
Eastern,Hampton City,51650,1931,7498,9429,3348,17520,20868,372294,2164134,2536428,03/01/2015 12:00:00 AM,193,289,269
Eastern,Hampton City,51650,1946,8004,9950,3403,18414,21817,379880,2317418,2697298,12/01/2014 12:00:00 AM,195,290,271
Eastern,Hampton City,51650,1952,7518,9470,3449,17556,21005,382548,2181697,2564245,02/01/2015 12:00:00 AM,196,290,271
Eastern,Hampton City,51650,1953,8163,10116,3413,18636,22049,381244,2372011,2753255,10/01/2014 12:00:00 AM,195,291,272
Eastern,Hampton City,51650,1957,8036,9993,3399,18353,21752,380909,2311413,2692322,11/01/2014 12:00:00 AM,195,288,269
Eastern,Hampton City,51650,1959,8246,10205,3439,18677,22116,364676,2286779,2651455,09/01/2014 12:00:00 AM,186,277,260
Eastern,Hampton City,51650,1965,7780,9745,3455,18025,21480,382579,2233017,2615596,01/01/2015 12:00:00 AM,195,287,268
Eastern,Hampton City,51650,1975,8345,10320,3487,18826,22313,372206,2312499,2684705,08/01/2014 12:00:00 AM,188,277,260
Eastern,Hampton City,51650,1989,8512,10501,3515,19021,22536,376588,2332600,2709188,07/01/2014 12:00:00 AM,189,274,258
Eastern,Hampton City,51650,2031,8665,10696,3651,19155,22806,394676,2372973,2767649,06/01/2014 12:00:00 AM,194,274,259
Eastern,Hampton City,51650,2039,8782,10821,3733,19165,22898,403294,2376177,2779471,05/01/2014 12:00:00 AM,198,271,257
Eastern,Hampton City,51650,2045,9214,11259,3809,19839,23648,418824,2468161,2886985,11/01/2013 12:00:00 AM,205,268,256
Eastern,Hampton City,51650,2047,8845,10892,3754,19165,22919,404417,2387801,2792218,04/01/2014 12:00:00 AM,198,270,256
Eastern,Hampton City,51650,2058,8783,10841,3930,19026,22956,473562,2532146,3005708,08/01/2012 12:00:00 AM,230,288,277
Eastern,Hampton City,51650,2064,8647,10711,3951,18800,22751,473010,2502279,2975289,07/01/2012 12:00:00 AM,229,289,278
Eastern,Hampton City,51650,2069,9190,11259,3897,19717,23614,467465,2639931,3107396,10/01/2013 12:00:00 AM,226,287,276
Eastern,Hampton City,51650,2071,8496,10567,4005,18403,22408,480585,2463344,2943929,04/01/2012 12:00:00 AM,232,290,279
Eastern,Hampton City,51650,2072,8909,10981,3875,19194,23069,424348,2375676,2800024,03/01/2014 12:00:00 AM,205,267,255
Eastern,Hampton City,51650,2073,9185,11258,3861,19822,23683,425266,2454238,2879504,12/01/2013 12:00:00 AM,205,267,256
Eastern,Hampton City,51650,2076,8545,10621,4017,18509,22526,483658,2461053,2944711,03/01/2012 12:00:00 AM,233,288,277
Eastern,Hampton City,51650,2077,8671,10748,3983,18773,22756,476038,2493625,2969663,06/01/2012 12:00:00 AM,229,288,276
Eastern,Hampton City,51650,2081,9168,11249,3880,19693,23573,460192,2630004,3090196,08/01/2013 12:00:00 AM,221,287,275
Eastern,Hampton City,51650,2082,9198,11280,3913,19653,23566,463269,2626138,3089407,09/01/2013 12:00:00 AM,223,286,274
Eastern,Hampton City,51650,2083,9000,11083,3943,19361,23304,473491,2581403,3054894,11/01/2012 12:00:00 AM,227,287,276
Eastern,Hampton City,51650,2085,8919,11004,3934,19194,23128,473345,2568936,3042281,10/01/2012 12:00:00 AM,227,288,276
Eastern,Hampton City,51650,2087,8463,10550,4087,18385,22472,496028,2438612,2934640,02/01/2012 12:00:00 AM,238,288,278
Eastern,Hampton City,51650,2087,9034,11121,3920,19237,23157,463292,2578687,3041979,04/01/2013 12:00:00 AM,222,285,274
Eastern,Hampton City,51650,2087,9148,11235,3889,19586,23475,457617,2608036,3065653,07/01/2013 12:00:00 AM,219,285,273
Eastern,Hampton City,51650,2089,8434,10523,4065,18382,22447,488652,2416987,2905639,01/01/2012 12:00:00 AM,234,287,276
Eastern,Hampton City,51650,2091,9012,11103,3917,19364,23281,429254,2398503,2827757,02/01/2014 12:00:00 AM,205,266,255
Eastern,Hampton City,51650,2091,9054,11145,3938,19232,23170,467765,2574563,3042328,03/01/2013 12:00:00 AM,224,284,273
Eastern,Hampton City,51650,2091,9122,11213,3951,19401,23352,470047,2588038,3058085,05/01/2013 12:00:00 AM,225,284,273
Eastern,Hampton City,51650,2092,8605,10697,4036,18591,22627,484635,2480438,2965073,05/01/2012 12:00:00 AM,232,288,277
Eastern,Hampton City,51650,2092,8716,10808,3982,18857,22839,482486,2510264,2992750,09/01/2012 12:00:00 AM,231,288,277
Eastern,Hampton City,51650,2092,9135,11227,3938,19457,23395,469341,2596882,3066223,06/01/2013 12:00:00 AM,224,284,273
Eastern,Hampton City,51650,2095,9084,11179,3955,19310,23265,471657,2579339,3050996,02/01/2013 12:00:00 AM,225,284,273
Eastern,Hampton City,51650,2101,9074,11175,3916,19547,23463,425016,2409376,2834392,01/01/2014 12:00:00 AM,202,266,254
Eastern,Hampton City,51650,2104,9049,11153,3996,19321,23317,477791,2559534,3037325,01/01/2013 12:00:00 AM,227,283,272
Eastern,Hampton City,51650,2124,8968,11092,4063,19257,23320,489901,2573189,3063090,12/01/2012 12:00:00 AM,231,287,276
Eastern,Isle Of Wight County,51093,296,1484,1780,408,3251,3659,39452,385299,424751,12/01/2015 12:00:00 AM,133,260,239
Eastern,Isle Of Wight County,51093,298,1474,1772,408,3228,3636,40227,381630,421857,01/01/2016 12:00:00 AM,135,259,238
Eastern,Isle Of Wight County,51093,301,1471,1772,417,3181,3598,41947,375627,417574,03/01/2016 12:00:00 AM,139,255,236
Eastern,Isle Of Wight County,51093,301,1475,1776,419,3258,3677,41629,388750,430379,11/01/2015 12:00:00 AM,138,264,242
Eastern,Isle Of Wight County,51093,301,1477,1778,419,3192,3611,42297,381843,424140,02/01/2016 12:00:00 AM,141,259,239
Eastern,Isle Of Wight County,51093,303,1433,1736,420,3109,3529,42868,369269,412137,06/01/2016 12:00:00 AM,141,258,237
Eastern,Isle Of Wight County,51093,304,1435,1739,422,3111,3533,43446,371975,415421,05/01/2016 12:00:00 AM,143,259,239
Eastern,Isle Of Wight County,51093,305,1433,1738,425,3132,3557,43802,366964,410766,04/01/2016 12:00:00 AM,144,256,236
Eastern,Isle Of Wight County,51093,305,1482,1787,425,3253,3678,42093,392064,434157,10/01/2015 12:00:00 AM,138,265,243
Eastern,Isle Of Wight County,51093,307,1679,1986,395,3566,3961,35636,420332,455968,08/01/2014 12:00:00 AM,116,250,230
Eastern,Isle Of Wight County,51093,308,1481,1789,429,3268,3697,42466,395203,437669,09/01/2015 12:00:00 AM,138,267,245
Eastern,Isle Of Wight County,51093,308,1664,1972,402,3540,3942,35609,411861,447470,09/01/2014 12:00:00 AM,116,248,227
Eastern,Isle Of Wight County,51093,311,1634,1945,418,3496,3914,42557,418936,461493,11/01/2014 12:00:00 AM,137,256,237
Eastern,Isle Of Wight County,51093,314,1649,1963,418,3542,3960,41828,426112,467940,10/01/2014 12:00:00 AM,133,258,238
Eastern,Isle Of Wight County,51093,315,1692,2007,412,3586,3998,36815,421015,457830,07/01/2014 12:00:00 AM,117,249,228
Eastern,Isle Of Wight County,51093,316,1514,1830,452,3316,3768,45638,402061,447699,08/01/2015 12:00:00 AM,144,266,245
Eastern,Isle Of Wight County,51093,317,1713,2030,422,3578,4000,37660,425291,462951,06/01/2014 12:00:00 AM,119,248,228
Eastern,Isle Of Wight County,51093,321,1522,1843,458,3331,3789,45331,401908,447239,07/01/2015 12:00:00 AM,141,264,243
Eastern,Isle Of Wight County,51093,321,1611,1932,450,3433,3883,45277,412108,457385,12/01/2014 12:00:00 AM,141,256,237
Eastern,Isle Of Wight County,51093,322,1574,1896,460,3397,3857,44732,394800,439532,01/01/2015 12:00:00 AM,139,251,232
Eastern,Isle Of Wight County,51093,323,1530,1853,463,3348,3811,45099,402083,447182,06/01/2015 12:00:00 AM,140,263,241
Eastern,Isle Of Wight County,51093,325,1722,2047,442,3571,4013,39688,422707,462395,05/01/2014 12:00:00 AM,122,245,226
Eastern,Isle Of Wight County,51093,328,1762,2090,461,3628,4089,42210,433740,475950,04/01/2014 12:00:00 AM,129,246,228
Eastern,Isle Of Wight County,51093,329,1529,1858,480,3346,3826,47221,390930,438151,02/01/2015 12:00:00 AM,144,256,236
Eastern,Isle Of Wight County,51093,334,1512,1846,493,3313,3806,50156,396893,447049,05/01/2015 12:00:00 AM,150,262,242
Eastern,Isle Of Wight County,51093,334,1532,1866,494,3345,3839,48781,390146,438927,03/01/2015 12:00:00 AM,146,255,235
Eastern,Isle Of Wight County,51093,336,1529,1865,488,3355,3843,49699,393429,443128,04/01/2015 12:00:00 AM,148,257,238
Eastern,Isle Of Wight County,51093,339,1771,2110,491,3602,4093,46123,432689,478812,03/01/2014 12:00:00 AM,136,244,227
Eastern,Isle Of Wight County,51093,339,1794,2133,483,3676,4159,49673,473710,523383,10/01/2013 12:00:00 AM,147,264,245
Eastern,Isle Of Wight County,51093,340,1787,2127,486,3676,4162,44935,439467,484402,11/01/2013 12:00:00 AM,132,246,228
Eastern,Isle Of Wight County,51093,341,1769,2110,494,3626,4120,45783,437202,482985,02/01/2014 12:00:00 AM,134,247,229
Eastern,Isle Of Wight County,51093,347,1751,2098,518,3598,4116,49296,427513,476809,01/01/2014 12:00:00 AM,142,244,227
Eastern,Isle Of Wight County,51093,347,1775,2122,511,3670,4181,47450,441214,488664,12/01/2013 12:00:00 AM,137,249,230
Eastern,Isle Of Wight County,51093,352,1813,2165,510,3702,4212,52116,477932,530048,09/01/2013 12:00:00 AM,148,264,245
Eastern,Isle Of Wight County,51093,356,1761,2117,519,3708,4227,54655,481763,536418,12/01/2012 12:00:00 AM,154,274,253
Eastern,Isle Of Wight County,51093,356,1783,2139,518,3687,4205,54404,477676,532080,05/01/2013 12:00:00 AM,153,268,249
Eastern,Isle Of Wight County,51093,358,1776,2134,519,3665,4184,53833,474101,527934,06/01/2013 12:00:00 AM,150,267,247
Eastern,Isle Of Wight County,51093,359,1764,2123,544,3577,4121,57783,465273,523056,02/01/2012 12:00:00 AM,161,264,246
Eastern,Isle Of Wight County,51093,360,1779,2139,518,3669,4187,53551,473800,527351,07/01/2013 12:00:00 AM,149,266,247
Eastern,Isle Of Wight County,51093,360,1815,2175,509,3715,4224,52564,477445,530009,08/01/2013 12:00:00 AM,146,263,244
Eastern,Isle Of Wight County,51093,363,1773,2136,537,3660,4197,58612,476697,535309,05/01/2012 12:00:00 AM,161,269,251
Eastern,Isle Of Wight County,51093,363,1776,2139,529,3729,4258,57391,481905,539296,09/01/2012 12:00:00 AM,158,271,252
Eastern,Isle Of Wight County,51093,363,1788,2151,530,3701,4231,58403,484434,542837,06/01/2012 12:00:00 AM,161,271,252
Eastern,Isle Of Wight County,51093,363,1789,2152,529,3754,4283,54917,477642,532559,01/01/2013 12:00:00 AM,151,267,247
Eastern,Isle Of Wight County,51093,363,1799,2162,532,3744,4276,56781,481040,537821,03/01/2013 12:00:00 AM,156,267,249
Eastern,Isle Of Wight County,51093,364,1748,2112,557,3548,4105,59832,456775,516607,01/01/2012 12:00:00 AM,164,261,245
Eastern,Isle Of Wight County,51093,366,1790,2156,534,3766,4300,59188,486290,545478,08/01/2012 12:00:00 AM,162,272,253
Eastern,Isle Of Wight County,51093,367,1774,2141,535,3688,4223,58132,480604,538736,07/01/2012 12:00:00 AM,158,271,252
Eastern,Isle Of Wight County,51093,367,1781,2148,526,3743,4269,56353,486375,542728,10/01/2012 12:00:00 AM,154,273,253
Eastern,Isle Of Wight County,51093,367,1793,2160,542,3704,4246,57819,477772,535591,04/01/2013 12:00:00 AM,158,266,248
Eastern,Isle Of Wight County,51093,370,1787,2157,548,3745,4293,58619,484093,542712,02/01/2013 12:00:00 AM,158,271,252
Eastern,Isle Of Wight County,51093,371,1751,2122,543,3690,4233,56990,477212,534202,11/01/2012 12:00:00 AM,154,273,252
Eastern,Isle Of Wight County,51093,372,1758,2130,563,3595,4158,60655,469115,529770,03/01/2012 12:00:00 AM,163,267,249
Eastern,Isle Of Wight County,51093,372,1758,2130,567,3622,4189,62594,473521,536115,04/01/2012 12:00:00 AM,168,269,252
Eastern,Isle of Wight County,51093,258,1263,1521,312,2558,2870,30463,306221,336684,10/01/2019 12:00:00 AM,118,242,221
Eastern,Isle of Wight County,51093,262,1260,1522,328,2566,2894,31723,301087,332810,09/01/2019 12:00:00 AM,121,239,219
Eastern,Isle of Wight County,51093,264,1252,1516,330,2509,2839,33122,295471,328593,11/01/2019 12:00:00 AM,125,236,217
Eastern,Isle of Wight County,51093,264,1262,1526,328,2571,2899,31966,302828,334794,08/01/2019 12:00:00 AM,121,240,219
Eastern,Isle of Wight County,51093,265,1254,1519,339,2515,2854,34042,293886,327928,01/01/2020 12:00:00 AM,128,234,216
Eastern,Isle of Wight County,51093,268,1255,1523,344,2522,2866,34874,297131,332005,12/01/2019 12:00:00 AM,130,237,218
Eastern,Isle of Wight County,51093,268,1364,1632,337,2756,3093,80331,632400,712731,05/01/2021 12:00:00 AM,300,464,437
Eastern,Isle of Wight County,51093,269,1243,1512,347,2480,2827,33763,287506,321269,02/01/2019 12:00:00 AM,126,231,212
Eastern,Isle of Wight County,51093,269,1256,1525,330,2534,2864,62543,441108,503651,03/01/2020 12:00:00 AM,233,351,330
Eastern,Isle of Wight County,51093,269,1267,1536,348,2540,2888,33294,297215,330509,03/01/2019 12:00:00 AM,124,235,215
Eastern,Isle of Wight County,51093,270,1248,1518,335,2513,2848,32612,294866,327478,02/01/2020 12:00:00 AM,121,236,216
Eastern,Isle of Wight County,51093,270,1261,1531,339,2532,2871,32607,296542,329149,07/01/2019 12:00:00 AM,121,235,215
Eastern,Isle of Wight County,51093,270,1275,1545,346,2551,2897,33352,298076,331428,05/01/2019 12:00:00 AM,124,234,215
Eastern,Isle of Wight County,51093,270,1395,1665,340,2796,3136,81692,640168,721860,04/01/2021 12:00:00 AM,303,459,434
Eastern,Isle of Wight County,51093,271,1273,1544,349,2567,2916,34666,303249,337915,01/01/2019 12:00:00 AM,128,238,219
Eastern,Isle of Wight County,51093,271,1367,1638,342,2773,3115,82702,639015,721717,06/01/2021 12:00:00 AM,305,467,441
Eastern,Isle of Wight County,51093,272,1256,1528,349,2521,2870,34038,292849,326887,04/01/2019 12:00:00 AM,125,233,214
Eastern,Isle of Wight County,51093,272,1266,1538,340,2554,2894,32868,301241,334109,10/01/2018 12:00:00 AM,121,238,217
Eastern,Isle of Wight County,51093,272,1287,1559,344,2581,2925,32529,307680,340209,06/01/2019 12:00:00 AM,120,239,218
Eastern,Isle of Wight County,51093,273,1392,1665,336,2796,3132,76131,601410,677541,02/01/2021 12:00:00 AM,279,432,407
Eastern,Isle of Wight County,51093,274,1288,1562,346,2671,3017,32813,311470,344283,08/01/2018 12:00:00 AM,120,242,220
Eastern,Isle of Wight County,51093,274,1411,1685,339,2842,3181,75948,602761,678709,03/01/2021 12:00:00 AM,277,427,403
Eastern,Isle of Wight County,51093,275,1277,1552,352,2567,2919,35679,302055,337734,11/01/2018 12:00:00 AM,130,237,218
Eastern,Isle of Wight County,51093,275,1301,1576,353,2721,3074,34964,319312,354276,07/01/2018 12:00:00 AM,127,245,225
Eastern,Isle of Wight County,51093,276,1259,1535,354,2547,2901,35348,301066,336414,12/01/2018 12:00:00 AM,128,239,219
Eastern,Isle of Wight County,51093,277,1287,1564,349,2607,2956,33234,309453,342687,09/01/2018 12:00:00 AM,120,240,219
Eastern,Isle of Wight County,51093,277,1315,1592,355,2741,3096,33791,317369,351160,06/01/2018 12:00:00 AM,122,241,221
Eastern,Isle of Wight County,51093,279,1357,1636,367,2862,3229,36006,337297,373303,05/01/2017 12:00:00 AM,129,249,228
Eastern,Isle of Wight County,51093,279,1360,1639,353,2731,3084,77961,577371,655332,01/01/2021 12:00:00 AM,279,425,400
Eastern,Isle of Wight County,51093,280,1358,1638,343,2748,3091,64112,479102,543214,04/01/2020 12:00:00 AM,229,353,332
Eastern,Isle of Wight County,51093,280,1366,1646,356,2878,3234,34806,345849,380655,08/01/2017 12:00:00 AM,124,253,231
Eastern,Isle of Wight County,51093,281,1310,1591,364,2723,3087,34655,316012,350667,05/01/2018 12:00:00 AM,123,241,220
Eastern,Isle of Wight County,51093,282,1379,1661,354,2784,3138,69239,524868,594107,11/01/2020 12:00:00 AM,246,381,358
Eastern,Isle of Wight County,51093,282,1390,1672,377,2939,3316,37473,353146,390619,04/01/2017 12:00:00 AM,133,254,234
Eastern,Isle of Wight County,51093,282,1394,1676,356,2934,3290,35941,353268,389209,10/01/2017 12:00:00 AM,127,253,232
Eastern,Isle of Wight County,51093,282,1432,1714,360,2847,3207,65394,493623,559017,08/01/2020 12:00:00 AM,232,345,326
Eastern,Isle of Wight County,51093,283,1358,1641,367,2866,3233,37204,340498,377702,06/01/2017 12:00:00 AM,131,251,230
Eastern,Isle of Wight County,51093,283,1364,1647,356,2752,3108,71276,507567,578843,12/01/2020 12:00:00 AM,252,372,351
Eastern,Isle of Wight County,51093,283,1384,1667,364,2906,3270,35888,347851,383739,09/01/2017 12:00:00 AM,127,251,230
Eastern,Isle of Wight County,51093,284,1347,1631,369,2861,3230,36783,338434,375217,07/01/2017 12:00:00 AM,130,251,230
Eastern,Isle of Wight County,51093,284,1377,1661,389,2956,3345,37792,344755,382547,11/01/2016 12:00:00 AM,133,250,230
Eastern,Isle of Wight County,51093,284,1398,1682,355,2804,3159,69646,516463,586109,10/01/2020 12:00:00 AM,245,369,348
Eastern,Isle of Wight County,51093,285,1362,1647,370,2809,3179,34541,330189,364730,04/01/2018 12:00:00 AM,121,242,221
Eastern,Isle of Wight County,51093,285,1408,1693,374,2981,3355,36688,353108,389796,03/01/2017 12:00:00 AM,129,251,230
Eastern,Isle of Wight County,51093,286,1406,1692,362,2826,3188,66969,492977,559946,05/01/2020 12:00:00 AM,234,351,331
Eastern,Isle of Wight County,51093,286,1424,1710,389,3080,3469,38636,357676,396312,09/01/2016 12:00:00 AM,135,251,232
Eastern,Isle of Wight County,51093,287,1414,1701,361,2841,3202,67059,498385,565444,06/01/2020 12:00:00 AM,234,352,332
Eastern,Isle of Wight County,51093,288,1393,1681,396,3000,3396,39266,353119,392385,12/01/2016 12:00:00 AM,136,253,233
Eastern,Isle of Wight County,51093,289,1427,1716,368,2863,3231,68996,502664,571660,09/01/2020 12:00:00 AM,239,352,333
Eastern,Isle of Wight County,51093,289,1432,1721,400,3108,3508,40226,365373,405599,08/01/2016 12:00:00 AM,139,255,236
Eastern,Isle of Wight County,51093,291,1341,1632,368,2818,3186,36657,330308,366965,12/01/2017 12:00:00 AM,126,246,225
Eastern,Isle of Wight County,51093,291,1366,1657,367,2878,3245,33985,340585,374570,03/01/2018 12:00:00 AM,117,249,226
Eastern,Isle of Wight County,51093,291,1375,1666,374,2853,3227,37507,347074,384581,11/01/2017 12:00:00 AM,129,252,231
Eastern,Isle of Wight County,51093,291,1431,1722,369,2878,3247,69525,501582,571107,07/01/2020 12:00:00 AM,239,351,332
Eastern,Isle of Wight County,51093,292,1405,1697,403,3039,3442,40082,357937,398019,10/01/2016 12:00:00 AM,137,255,235
Eastern,Isle of Wight County,51093,293,1347,1640,369,2827,3196,35016,331511,366527,02/01/2018 12:00:00 AM,120,246,223
Eastern,Isle of Wight County,51093,293,1349,1642,370,2821,3191,34925,334355,369280,01/01/2018 12:00:00 AM,119,248,225
Eastern,Isle of Wight County,51093,294,1393,1687,397,2995,3392,37594,348254,385848,01/01/2017 12:00:00 AM,128,250,229
Eastern,Isle of Wight County,51093,298,1389,1687,406,2976,3382,39976,343901,383877,02/01/2017 12:00:00 AM,134,248,228
Eastern,Isle of Wight County,51093,299,1411,1710,413,3088,3501,42165,361089,403254,07/01/2016 12:00:00 AM,141,256,236
Eastern,James City County,51095,245,1944,2189,394,4495,4889,43666,537055,580721,06/01/2014 12:00:00 AM,178,276,265
Eastern,James City County,51095,248,1431,1679,373,3483,3856,41026,428187,469213,05/01/2017 12:00:00 AM,165,299,279
Eastern,James City County,51095,249,1910,2159,390,4427,4817,42293,526831,569124,07/01/2014 12:00:00 AM,170,276,264
Eastern,James City County,51095,251,1484,1735,375,3565,3940,42735,436857,479592,03/01/2017 12:00:00 AM,170,294,276
Eastern,James City County,51095,252,1374,1626,377,3181,3558,41558,375177,416735,08/01/2019 12:00:00 AM,165,273,256
Eastern,James City County,51095,252,1387,1639,383,3162,3545,41506,378805,420311,07/01/2019 12:00:00 AM,165,273,256
Eastern,James City County,51095,252,1435,1687,374,3489,3863,40480,431483,471963,06/01/2017 12:00:00 AM,161,301,280
Eastern,James City County,51095,253,1341,1594,365,3104,3469,38583,371605,410188,09/01/2019 12:00:00 AM,153,277,257
Eastern,James City County,51095,253,1444,1697,390,3512,3902,43709,433408,477117,04/01/2017 12:00:00 AM,173,300,281
Eastern,James City County,51095,254,1447,1701,381,3519,3900,44097,438239,482336,08/01/2017 12:00:00 AM,174,303,284
Eastern,James City County,51095,255,1689,1944,342,3742,4084,74148,781289,855437,02/01/2021 12:00:00 AM,291,463,440
Eastern,James City County,51095,256,1349,1605,400,3113,3513,43289,371731,415020,06/01/2019 12:00:00 AM,169,276,259
Eastern,James City County,51095,257,1860,2117,410,4348,4758,47174,512371,559545,08/01/2014 12:00:00 AM,184,275,264
Eastern,James City County,51095,260,1421,1681,385,3445,3830,42906,424967,467873,07/01/2017 12:00:00 AM,165,299,278
Eastern,James City County,51095,260,1516,1776,391,3622,4013,44121,435589,479710,01/01/2017 12:00:00 AM,170,287,270
Eastern,James City County,51095,261,1421,1682,382,3346,3728,42239,402511,444750,05/01/2018 12:00:00 AM,162,283,264
Eastern,James City County,51095,261,1510,1771,386,3662,4048,43694,442463,486157,02/01/2017 12:00:00 AM,167,293,275
Eastern,James City County,51095,261,1580,1841,395,3749,4144,44261,454891,499152,07/01/2016 12:00:00 AM,170,288,271
Eastern,James City County,51095,262,1950,2212,429,4474,4903,46760,530325,577085,03/01/2014 12:00:00 AM,178,272,261
Eastern,James City County,51095,262,1958,2220,434,4497,4931,48187,536992,585179,04/01/2014 12:00:00 AM,184,274,264
Eastern,James City County,51095,263,1577,1840,401,3780,4181,46250,457293,503543,08/01/2016 12:00:00 AM,176,290,274
Eastern,James City County,51095,263,1953,2216,444,4469,4913,50034,535702,585736,05/01/2014 12:00:00 AM,190,274,264
Eastern,James City County,51095,264,1372,1636,400,3128,3528,44369,375182,419551,04/01/2019 12:00:00 AM,168,273,256
Eastern,James City County,51095,265,1368,1633,420,3138,3558,46196,380322,426518,05/01/2019 12:00:00 AM,174,278,261
Eastern,James City County,51095,265,1436,1701,409,3450,3859,45963,429111,475074,09/01/2017 12:00:00 AM,173,299,279
Eastern,James City County,51095,265,1520,1785,411,3647,4058,45607,439832,485439,12/01/2016 12:00:00 AM,172,289,272
Eastern,James City County,51095,265,1581,1846,405,3769,4174,46988,452629,499617,09/01/2016 12:00:00 AM,177,286,271
Eastern,James City County,51095,265,1810,2075,448,4326,4774,51602,531805,583407,10/01/2014 12:00:00 AM,195,294,281
Eastern,James City County,51095,266,1327,1593,392,3077,3469,43577,365869,409446,11/01/2019 12:00:00 AM,164,276,257
Eastern,James City County,51095,266,1335,1601,397,3036,3433,43661,365312,408973,02/01/2019 12:00:00 AM,164,274,255
Eastern,James City County,51095,266,1843,2109,490,4246,4736,60120,549090,609210,03/01/2012 12:00:00 AM,226,298,289
Eastern,James City County,51095,266,1937,2203,444,4472,4916,50059,524572,574631,01/01/2014 12:00:00 AM,188,271,261
Eastern,James City County,51095,267,1436,1703,405,3428,3833,46004,418818,464822,02/01/2018 12:00:00 AM,172,292,273
Eastern,James City County,51095,267,1453,1720,411,3459,3870,45485,425016,470501,10/01/2017 12:00:00 AM,170,293,274
Eastern,James City County,51095,267,1803,2070,445,4261,4706,50529,499822,550351,09/01/2014 12:00:00 AM,189,277,266
Eastern,James City County,51095,268,1429,1697,396,3356,3752,44454,410652,455106,03/01/2018 12:00:00 AM,166,287,268
Eastern,James City County,51095,268,1551,1819,417,3708,4125,48463,446822,495285,10/01/2016 12:00:00 AM,181,288,272
Eastern,James City County,51095,268,1690,1958,373,3730,4103,83154,794814,877968,03/01/2021 12:00:00 AM,310,470,448
Eastern,James City County,51095,268,1803,2071,483,4151,4634,60580,530287,590867,01/01/2012 12:00:00 AM,226,294,285
Eastern,James City County,51095,269,1429,1698,390,3394,3784,43709,415267,458976,04/01/2018 12:00:00 AM,162,291,270
Eastern,James City County,51095,269,1528,1797,427,3662,4089,49694,440054,489748,11/01/2016 12:00:00 AM,185,288,273
Eastern,James City County,51095,269,1817,2086,500,4196,4696,62459,545043,607502,04/01/2012 12:00:00 AM,232,300,291
Eastern,James City County,51095,269,1950,2219,450,4471,4921,51967,526707,578674,12/01/2013 12:00:00 AM,193,270,261
Eastern,James City County,51095,270,1330,1600,404,3070,3474,43003,366010,409013,01/01/2020 12:00:00 AM,159,275,256
Eastern,James City County,51095,270,1416,1686,397,3358,3755,43262,402408.5,445670.5,06/01/2018 12:00:00 AM,160,284,264
Eastern,James City County,51095,270,1444,1714,422,3443,3865,47348,422302,469650,11/01/2017 12:00:00 AM,175,292,274
Eastern,James City County,51095,271,1346,1617,400,3096,3496,44067,378092,422159,10/01/2019 12:00:00 AM,163,281,261
Eastern,James City County,51095,271,1636,1907,391,3563,3954,91763,812513,904276,05/01/2021 12:00:00 AM,339,497,474
Eastern,James City County,51095,271,1810,2081,498,4194,4692,63393,540191,603584,02/01/2012 12:00:00 AM,234,298,290
Eastern,James City County,51095,271,1945,2216,453,4483,4936,51112,529987,581099,02/01/2014 12:00:00 AM,189,272,262
Eastern,James City County,51095,272,1620,1892,437,3811,4248,50222,460038,510260,06/01/2016 12:00:00 AM,185,284,270
Eastern,James City County,51095,272,1824,2096,496,4214,4710,61541,544445,605986,05/01/2012 12:00:00 AM,226,298,289
Eastern,James City County,51095,273,1366,1639,407,3225,3632,43077,379885,422962,09/01/2018 12:00:00 AM,158,278,258
Eastern,James City County,51095,273,1420,1693,418,3338,3756,48141,421761,469902,01/01/2019 12:00:00 AM,176,297,278
Eastern,James City County,51095,273,1656,1929,396,3645,4041,90626,833760,924386,04/01/2021 12:00:00 AM,332,503,479
Eastern,James City County,51095,273,1665,1938,447,4006,4453,52433,472493,524926,07/01/2015 12:00:00 AM,192,284,271
Eastern,James City County,51095,273,1710,1983,453,4034,4487,53053,480649,533702,05/01/2015 12:00:00 AM,194,281,269
Eastern,James City County,51095,273,1735,2008,461,4111,4572,53545,489991,543536,01/01/2015 12:00:00 AM,196,282,271
Eastern,James City County,51095,273,1762,2035,462,4161,4623,54555,504050,558605,12/01/2014 12:00:00 AM,200,286,274
Eastern,James City County,51095,274,1341,1615,403,3114,3517,44319,371541,415860,12/01/2019 12:00:00 AM,162,277,257
Eastern,James City County,51095,274,1371,1645,406,3224,3630,44447,386103,430550,07/01/2018 12:00:00 AM,162,282,262
Eastern,James City County,51095,274,1440,1714,428,3421,3849,49259,422429,471688,01/01/2018 12:00:00 AM,180,293,275
Eastern,James City County,51095,274,1619,1893,398,3518,3916,92815,807519,900334,06/01/2021 12:00:00 AM,339,499,476
Eastern,James City County,51095,275,1654,1929,454,3899,4353,51459,468553,520012,05/01/2016 12:00:00 AM,187,283,270
Eastern,James City County,51095,275,1711,1986,463,4067,4530,53455,486490,539945,02/01/2015 12:00:00 AM,194,284,272
Eastern,James City County,51095,275,1953,2228,463,4488,4951,55370,574371,629741,09/01/2013 12:00:00 AM,201,294,283
Eastern,James City County,51095,276,1396,1672,422,3225,3647,47682,387851,435533,03/01/2019 12:00:00 AM,173,278,260
Eastern,James City County,51095,276,1454,1730,430,3451,3881,48072,420916,468988,12/01/2017 12:00:00 AM,174,289,271
Eastern,James City County,51095,276,1659,1935,448,3993,4441,51693,470807,522500,08/01/2015 12:00:00 AM,187,284,270
Eastern,James City County,51095,276,1951,2227,470,4488,4958,54237,529658,583895,11/01/2013 12:00:00 AM,197,271,262
Eastern,James City County,51095,277,1374,1651,412,3225,3637,45646,381338,426984,08/01/2018 12:00:00 AM,165,278,259
Eastern,James City County,51095,277,1383,1660,425,3242,3667,48611,383384,431995,11/01/2018 12:00:00 AM,175,277,260
Eastern,James City County,51095,277,1751,2028,449,4121,4570,51477,495535,547012,04/01/2015 12:00:00 AM,186,283,270
Eastern,James City County,51095,277,1955,2232,482,4472,4954,57106,569443,626549,08/01/2013 12:00:00 AM,206,291,281
Eastern,James City County,51095,278,1337,1615,436,3077,3513,46245,363607,409852,02/01/2020 12:00:00 AM,166,272,254
Eastern,James City County,51095,278,1360,1638,439,3190,3629,78344,548920,627264,03/01/2020 12:00:00 AM,282,404,383
Eastern,James City County,51095,278,1767,2045,482,4189,4671,55655,511506,567161,11/01/2014 12:00:00 AM,200,289,277
Eastern,James City County,51095,278,1965,2243,490,4506,4996,59139,572279,631418,07/01/2013 12:00:00 AM,213,291,282
Eastern,James City County,51095,279,1665,1944,465,3938,4403,54013,472286,526299,04/01/2016 12:00:00 AM,194,284,271
Eastern,James City County,51095,279,1686,1965,457,4022,4479,52971,471497,524468,12/01/2015 12:00:00 AM,190,280,267
Eastern,James City County,51095,279,1838,2117,520,4242,4762,64990,542859,607849,08/01/2012 12:00:00 AM,233,295,287
Eastern,James City County,51095,279,1949,2228,468,4499,4967,56106,576311,632417,10/01/2013 12:00:00 AM,201,296,284
Eastern,James City County,51095,280,1379,1659,430,3216,3646,50100,383258,433358,12/01/2018 12:00:00 AM,179,278,261
Eastern,James City County,51095,280,1637,1917,428,3652,4080,81070,674051,755121,12/01/2020 12:00:00 AM,290,412,394
Eastern,James City County,51095,280,1671,1951,470,3947,4417,56019,473177,529196,06/01/2015 12:00:00 AM,200,283,271
Eastern,James City County,51095,281,1719,2000,469,4043,4512,53910,482465,536375,03/01/2015 12:00:00 AM,192,281,268
Eastern,James City County,51095,282,1666,1948,473,3979,4452,53879,463644,517523,01/01/2016 12:00:00 AM,191,278,266
Eastern,James City County,51095,282,1869,2151,519,4305,4824,65721,552435,618156,10/01/2012 12:00:00 AM,233,296,287
Eastern,James City County,51095,284,1354,1638,435,3191,3626,50147,397268,447415,10/01/2018 12:00:00 AM,177,293,273
Eastern,James City County,51095,284,1581,1865,431,3552,3983,81778,648550,730328,10/01/2020 12:00:00 AM,288,410,392
Eastern,James City County,51095,284,1673,1957,477,3964,4441,53900,473353,527253,02/01/2016 12:00:00 AM,190,283,269
Eastern,James City County,51095,284,1686,1970,485,4009,4494,55124,474030,529154,03/01/2016 12:00:00 AM,194,281,269
Eastern,James City County,51095,285,1706,1991,472,4070,4542,54792,482280,537072,10/01/2015 12:00:00 AM,192,283,270
Eastern,James City County,51095,285,1812,2097,532,4206,4738,66099,543720,609819,06/01/2012 12:00:00 AM,232,300,291
Eastern,James City County,51095,285,1822,2107,523,4222,4745,65873,543518,609391,07/01/2012 12:00:00 AM,231,298,289
Eastern,James City County,51095,285,1864,2149,521,4285,4806,65578,547601,613179,11/01/2012 12:00:00 AM,230,294,285
Eastern,James City County,51095,286,1701,1987,484,4062,4546,56588,478543,535131,11/01/2015 12:00:00 AM,198,281,269
Eastern,James City County,51095,286,1834,2120,529,4240,4769,66391,541691,608082,09/01/2012 12:00:00 AM,232,295,287
Eastern,James City County,51095,287,1600,1887,435,3625,4060,83591,679830,763421,11/01/2020 12:00:00 AM,291,425,405
Eastern,James City County,51095,287,1877,2164,527,4296,4823,66443,549491,615934,12/01/2012 12:00:00 AM,232,293,285
Eastern,James City County,51095,288,1652,1940,468,3964,4432,53686,467415,521101,09/01/2015 12:00:00 AM,186,283,269
Eastern,James City County,51095,288,1959,2247,514,4472,4986,62278,577551,639829,06/01/2013 12:00:00 AM,216,295,285
Eastern,James City County,51095,289,1555,1844,461,3527,3988,82957,614486,697443,04/01/2020 12:00:00 AM,287,395,378
Eastern,James City County,51095,289,1565,1854,454,3497,3951,81024,596502,677526,08/01/2020 12:00:00 AM,280,381,365
Eastern,James City County,51095,289,1640,1929,455,3641,4096,98489,762438,860927,01/01/2021 12:00:00 AM,341,465,446
Eastern,James City County,51095,291,1889,2180,539,4296,4835,64544,541546,606090,01/01/2013 12:00:00 AM,222,287,278
Eastern,James City County,51095,293,1601,1894,455,3541,3996,81356,624281,705637,09/01/2020 12:00:00 AM,278,390,373
Eastern,James City County,51095,293,1963,2256,523,4470,4993,63262,570372,633634,05/01/2013 12:00:00 AM,216,291,281
Eastern,James City County,51095,294,1962,2256,523,4478,5001,61801,571540,633341,04/01/2013 12:00:00 AM,210,291,281
Eastern,James City County,51095,295,1573,1868,461,3518,3979,82035,613361,695396,05/01/2020 12:00:00 AM,278,390,372
Eastern,James City County,51095,296,1927,2223,552,4367,4919,66265,559623,625888,02/01/2013 12:00:00 AM,224,290,282
Eastern,James City County,51095,299,1946,2245,539,4434,4973,62943,563560,626503,03/01/2013 12:00:00 AM,211,290,279
Eastern,James City County,51095,300,1577,1877,467,3510,3977,83548,599430,682978,07/01/2020 12:00:00 AM,278,380,364
Eastern,James City County,51095,301,1557,1858,474,3462,3936,85437,600848,686285,06/01/2020 12:00:00 AM,284,386,369
Eastern,Mathews County,51115,56,332,388,67,641,708,14650,140428,155078,02/01/2021 12:00:00 AM,262,423,400
Eastern,Mathews County,51115,60,309,369,74,640,714,6020,70581,76601,09/01/2018 12:00:00 AM,100,228,208
Eastern,Mathews County,51115,60,323,383,74,616,690,13432,107469,120901,03/01/2020 12:00:00 AM,224,333,316
Eastern,Mathews County,51115,60,339,399,75,655,730,17072,140152,157224,03/01/2021 12:00:00 AM,285,413,394
Eastern,Mathews County,51115,61,298,359,79,612,691,8487,72373,80860,10/01/2018 12:00:00 AM,139,243,225
Eastern,Mathews County,51115,61,299,360,80,606,686,7572,67621,75193,11/01/2018 12:00:00 AM,124,226,209
Eastern,Mathews County,51115,61,329,390,80,647,727,7421,70470,77891,03/01/2018 12:00:00 AM,122,214,200
Eastern,Mathews County,51115,61,332,393,78,702,780,6927,73968,80895,11/01/2017 12:00:00 AM,114,223,206
Eastern,Mathews County,51115,62,284,346,81,571,652,7253,62514,69767,02/01/2019 12:00:00 AM,117,220,202
Eastern,Mathews County,51115,62,289,351,77,591,668,6758,64889,71647,04/01/2019 12:00:00 AM,109,225,204
Eastern,Mathews County,51115,62,289,351,79,585,664,6685,65388,72073,03/01/2019 12:00:00 AM,108,226,205
Eastern,Mathews County,51115,62,314,376,84,626,710,8182,70107,78289,05/01/2018 12:00:00 AM,132,223,208
Eastern,Mathews County,51115,62,328,390,78,669,747,6876,72716,79592,10/01/2017 12:00:00 AM,111,222,204
Eastern,Mathews County,51115,62,331,393,79,693,772,7000,76226,83226,03/01/2017 12:00:00 AM,113,230,212
Eastern,Mathews County,51115,62,332,394,82,653,735,7988,71843,79831,02/01/2018 12:00:00 AM,129,216,203
Eastern,Mathews County,51115,62,339,401,76,731,807,6695,80433,87128,01/01/2017 12:00:00 AM,108,237,217
Eastern,Mathews County,51115,62,351,413,77,737,814,6803,82315,89118,02/01/2017 12:00:00 AM,110,235,216
Eastern,Mathews County,51115,62,362,424,81,764,845,7539,84148,91687,05/01/2016 12:00:00 AM,122,232,216
Eastern,Mathews County,51115,63,308,371,89,620,709,8494,70516,79010,06/01/2018 12:00:00 AM,135,229,213
Eastern,Mathews County,51115,63,311,374,78,653,731,7442,71757,79199,08/01/2018 12:00:00 AM,118,231,212
Eastern,Mathews County,51115,63,326,389,81,674,755,7453,75681,83134,04/01/2017 12:00:00 AM,118,232,214
Eastern,Mathews County,51115,63,333,396,81,640,721,18186,149892,168078,04/01/2021 12:00:00 AM,289,450,424
Eastern,Mathews County,51115,63,335,398,77,647,724,14844,118417,133261,12/01/2020 12:00:00 AM,236,353,335
Eastern,Mathews County,51115,63,336,399,85,682,767,7844,73785,81629,01/01/2018 12:00:00 AM,125,220,205
Eastern,Mathews County,51115,63,339,402,79,639,718,18364,148246,166610,06/01/2021 12:00:00 AM,291,437,414
Eastern,Mathews County,51115,63,365,428,81,746,827,7791,84246,92037,03/01/2016 12:00:00 AM,124,231,215
Eastern,Mathews County,51115,64,291,355,83,588,671,7771,66069,73840,01/01/2019 12:00:00 AM,121,227,208
Eastern,Mathews County,51115,64,302,366,85,604,689,8361,67589,75950,12/01/2018 12:00:00 AM,131,224,208
Eastern,Mathews County,51115,64,313,377,81,595,676,6503,66478,72981,01/01/2020 12:00:00 AM,102,212,194
Eastern,Mathews County,51115,64,315,379,83,627,710,7736,69395,77131,04/01/2018 12:00:00 AM,121,220,204
Eastern,Mathews County,51115,64,317,381,77,643,720,6753,72026,78779,09/01/2017 12:00:00 AM,106,227,207
Eastern,Mathews County,51115,64,319,383,82,616,698,7211,72836,80047,02/01/2020 12:00:00 AM,113,228,209
Eastern,Mathews County,51115,64,321,385,84,652,736,7582,72330,79912,05/01/2017 12:00:00 AM,118,225,208
Eastern,Mathews County,51115,64,325,389,83,708,791,7991,75814,83805,10/01/2016 12:00:00 AM,125,233,215
Eastern,Mathews County,51115,64,330,394,83,677,760,7635,70626,78261,12/01/2017 12:00:00 AM,119,214,199
Eastern,Mathews County,51115,64,336,400,78,633,711,14989,111386,126375,04/01/2020 12:00:00 AM,234,332,316
Eastern,Mathews County,51115,64,337,401,82,637,719,15191,112552,127743,05/01/2020 12:00:00 AM,237,334,319
Eastern,Mathews County,51115,64,338,402,81,644,725,20512,149955,170467,05/01/2021 12:00:00 AM,321,444,424
Eastern,Mathews County,51115,64,350,414,83,736,819,7842,78989,86831,06/01/2016 12:00:00 AM,123,226,210
Eastern,Mathews County,51115,64,354,418,87,740,827,7948,82935,90883,04/01/2016 12:00:00 AM,124,234,217
Eastern,Mathews County,51115,64,369,433,85,757,842,7983,84565,92548,02/01/2016 12:00:00 AM,125,229,214
Eastern,Mathews County,51115,65,284,349,80,581,661,6764,61949,68713,05/01/2019 12:00:00 AM,104,218,197
Eastern,Mathews County,51115,65,302,367,83,631,714,7738,68826,76564,07/01/2018 12:00:00 AM,119,228,209
Eastern,Mathews County,51115,65,315,380,84,640,724,7799,72729,80528,08/01/2017 12:00:00 AM,120,231,212
Eastern,Mathews County,51115,65,328,393,80,618,698,18146,130667,148813,01/01/2021 12:00:00 AM,279,398,379
Eastern,Mathews County,51115,65,336,401,82,645,727,16074,120358,136432,11/01/2020 12:00:00 AM,247,358,340
Eastern,Mathews County,51115,65,339,404,85,729,814,7847,78407,86254,07/01/2016 12:00:00 AM,121,231,214
Eastern,Mathews County,51115,65,342,407,84,652,736,15382,113788,129170,06/01/2020 12:00:00 AM,237,333,317
Eastern,Mathews County,51115,66,322,388,85,645,730,8053,73622,81675,06/01/2017 12:00:00 AM,122,229,211
Eastern,Mathews County,51115,66,340,406,84,735,819,7920,80158,88078,12/01/2016 12:00:00 AM,120,236,217
Eastern,Mathews County,51115,66,351,417,84,690,774,16166,128718,144884,10/01/2020 12:00:00 AM,245,367,347
Eastern,Mathews County,51115,66,381,447,86,789,875,8250,86677,94927,01/01/2016 12:00:00 AM,125,227,212
Eastern,Mathews County,51115,67,300,367,84,593,677,7480,65519,72999,08/01/2019 12:00:00 AM,112,218,199
Eastern,Mathews County,51115,67,308,375,84,609,693,7178,72532,79710,10/01/2019 12:00:00 AM,107,235,213
Eastern,Mathews County,51115,67,320,387,96,694,790,8886,74689,83575,09/01/2016 12:00:00 AM,133,233,216
Eastern,Mathews County,51115,67,329,396,88,721,809,8436,79824,88260,11/01/2016 12:00:00 AM,126,243,223
Eastern,Mathews County,51115,67,331,398,93,701,794,9151,74863,84014,08/01/2016 12:00:00 AM,137,226,211
Eastern,Mathews County,51115,67,385,452,89,807,896,8431,89158,97589,12/01/2015 12:00:00 AM,126,232,216
Eastern,Mathews County,51115,68,287,355,85,585,670,7525,66247,73772,06/01/2019 12:00:00 AM,111,231,208
Eastern,Mathews County,51115,68,317,385,89,629,718,8161,72723,80884,07/01/2017 12:00:00 AM,120,229,210
Eastern,Mathews County,51115,68,345,413,88,657,745,16609,116625,133234,07/01/2020 12:00:00 AM,244,338,323
Eastern,Mathews County,51115,68,346,414,86,660,746,16140,116097,132237,09/01/2020 12:00:00 AM,237,336,319
Eastern,Mathews County,51115,69,286,355,87,572,659,7469,62248,69717,07/01/2019 12:00:00 AM,108,218,196
Eastern,Mathews County,51115,69,290,359,90,578,668,7806,66201,74007,11/01/2019 12:00:00 AM,113,228,206
Eastern,Mathews County,51115,69,342,411,87,649,736,15827,111157,126984,08/01/2020 12:00:00 AM,229,325,309
Eastern,Mathews County,51115,69,381,450,97,791,888,9296,87774,97070,11/01/2015 12:00:00 AM,135,230,216
Eastern,Mathews County,51115,69,391,460,100,792,892,9012,91134,100146,07/01/2015 12:00:00 AM,131,233,218
Eastern,Mathews County,51115,70,292,362,89,578,667,7926,64281,72207,09/01/2019 12:00:00 AM,113,220,199
Eastern,Mathews County,51115,70,308,378,90,606,696,8240,73700,81940,12/01/2019 12:00:00 AM,118,239,217
Eastern,Mathews County,51115,70,373,443,99,783,882,9473,88106,97579,10/01/2015 12:00:00 AM,135,236,220
Eastern,Mathews County,51115,70,402,472,103,849,952,9083,96419,105502,11/01/2014 12:00:00 AM,130,240,224
Eastern,Mathews County,51115,70,429,499,96,893,989,8314,101936,110250,05/01/2014 12:00:00 AM,119,238,221
Eastern,Mathews County,51115,71,377,448,99,792,891,9026,90581,99607,09/01/2015 12:00:00 AM,127,240,222
Eastern,Mathews County,51115,71,389,460,97,811,908,8984,90990,99974,03/01/2015 12:00:00 AM,127,234,217
Eastern,Mathews County,51115,71,392,463,101,808,909,9762,92832,102594,05/01/2015 12:00:00 AM,137,237,222
Eastern,Mathews County,51115,71,393,464,104,808,912,10121,89533,99654,06/01/2015 12:00:00 AM,143,228,215
Eastern,Mathews County,51115,71,411,482,102,852,954,8830,99486,108316,10/01/2014 12:00:00 AM,124,242,225
Eastern,Mathews County,51115,72,390,462,99,825,924,8723,93562,102285,02/01/2015 12:00:00 AM,121,240,221
Eastern,Mathews County,51115,72,390,462,99,831,930,8707,92223,100930,01/01/2015 12:00:00 AM,121,236,218
Eastern,Mathews County,51115,72,392,464,103,805,908,9811,91828,101639,08/01/2015 12:00:00 AM,136,234,219
Eastern,Mathews County,51115,72,395,467,102,821,923,9722,94321,104043,04/01/2015 12:00:00 AM,135,239,223
Eastern,Mathews County,51115,72,395,467,102,829,931,9225,93762,102987,12/01/2014 12:00:00 AM,128,237,221
Eastern,Mathews County,51115,72,415,487,105,856,961,8815,96941,105756,06/01/2014 12:00:00 AM,122,234,217
Eastern,Mathews County,51115,72,416,488,103,863,966,8188,97862,106050,07/01/2014 12:00:00 AM,114,235,217
Eastern,Mathews County,51115,73,409,482,106,849,955,8660,96094,104754,08/01/2014 12:00:00 AM,119,235,217
Eastern,Mathews County,51115,73,431,504,104,900,1004,9568,103532,113100,04/01/2014 12:00:00 AM,131,240,224
Eastern,Mathews County,51115,74,407,481,110,851,961,9444,94155,103599,09/01/2014 12:00:00 AM,128,231,215
Eastern,Mathews County,51115,75,420,495,109,884,993,10380,111722,122102,10/01/2013 12:00:00 AM,138,266,247
Eastern,Mathews County,51115,75,430,505,110,899,1009,10175,104720,114895,03/01/2014 12:00:00 AM,136,244,228
Eastern,Mathews County,51115,76,426,502,110,887,997,9506,104311,113817,02/01/2014 12:00:00 AM,125,245,227
Eastern,Mathews County,51115,77,421,498,113,901,1014,10194,115416,125610,08/01/2013 12:00:00 AM,132,274,252
Eastern,Mathews County,51115,78,421,499,116,894,1010,10352,105722,116074,11/01/2013 12:00:00 AM,133,251,233
Eastern,Mathews County,51115,79,415,494,113,888,1001,9811,113032,122843,07/01/2013 12:00:00 AM,124,272,249
Eastern,Mathews County,51115,79,431,510,109,894,1003,11338,113413,124751,04/01/2012 12:00:00 AM,144,263,245
Eastern,Mathews County,51115,80,409,489,115,868,983,10314,103119,113433,12/01/2013 12:00:00 AM,129,252,232
Eastern,Mathews County,51115,80,417,497,125,880,1005,11988,112366,124354,09/01/2013 12:00:00 AM,150,269,250
Eastern,Mathews County,51115,80,419,499,117,880,997,10124,103751,113875,01/01/2014 12:00:00 AM,127,248,228
Eastern,Mathews County,51115,81,411,492,115,855,970,12527,104504,117031,01/01/2012 12:00:00 AM,155,254,238
Eastern,Mathews County,51115,81,420,501,109,880,989,11351,111647,122998,02/01/2012 12:00:00 AM,140,266,246
Eastern,Mathews County,51115,81,427,508,113,880,993,11402,114316,125718,08/01/2012 12:00:00 AM,141,268,247
Eastern,Mathews County,51115,83,424,507,119,871,990,13320,110051,123371,03/01/2012 12:00:00 AM,160,260,243
Eastern,Mathews County,51115,83,425,508,109,881,990,11090,113715,124805,10/01/2012 12:00:00 AM,134,268,246
Eastern,Mathews County,51115,84,417,501,115,867,982,11177,113056,124233,07/01/2012 12:00:00 AM,133,271,248
Eastern,Mathews County,51115,85,423,508,117,863,980,12165,113257,125422,09/01/2012 12:00:00 AM,143,268,247
Eastern,Mathews County,51115,87,422,509,116,885,1001,12505,111926,124431,11/01/2012 12:00:00 AM,144,265,244
Eastern,Mathews County,51115,87,423,510,120,877,997,12563,110460,123023,06/01/2012 12:00:00 AM,144,261,241
Eastern,Mathews County,51115,89,423,512,125,875,1000,13797,112767,126564,05/01/2012 12:00:00 AM,155,267,247
Eastern,Mathews County,51115,89,439,528,123,905,1028,13059,110630,123689,01/01/2013 12:00:00 AM,147,252,234
Eastern,Mathews County,51115,91,428,519,123,887,1010,13578,110844,124422,12/01/2012 12:00:00 AM,149,259,240
Eastern,Mathews County,51115,92,436,528,124,916,1040,12986,113483,126469,03/01/2013 12:00:00 AM,141,260,240
Eastern,Mathews County,51115,94,426,520,125,897,1022,12722,112195,124917,06/01/2013 12:00:00 AM,135,263,240
Eastern,Mathews County,51115,96,422,518,129,890,1019,13187,111525,124712,05/01/2013 12:00:00 AM,137,264,241
Eastern,Mathews County,51115,96,426,522,129,907,1036,13491,111585,125076,04/01/2013 12:00:00 AM,141,262,240
Eastern,Mathews County,51115,97,435,532,131,913,1044,13737,113513,127250,02/01/2013 12:00:00 AM,142,261,239
Eastern,Newport News City,51700,2755,10790,13545,4753,24860,29613,524791,3260938,3785729,07/01/2017 12:00:00 AM,190,302,279
Eastern,Newport News City,51700,2782,11337,14119,4595,25826,30421,500774,3374487,3875261,03/01/2017 12:00:00 AM,180,298,274
Eastern,Newport News City,51700,2785,11078,13863,4662,25338,30000,515119,3322752,3837871,05/01/2017 12:00:00 AM,185,300,277
Eastern,Newport News City,51700,2793,11055,13848,4640,25305,29945,509443,3287064,3796507,04/01/2017 12:00:00 AM,182,297,274
Eastern,Newport News City,51700,2796,11002,13798,4743,25229,29972,532652,3321110.86,3853762.86,06/01/2017 12:00:00 AM,191,302,279
Eastern,Newport News City,51700,2808,10875,13683,4834,25017,29851,544574,3286128,3830702,08/01/2017 12:00:00 AM,194,302,280
Eastern,Newport News City,51700,2838,10878,13716,4865,24920,29785,540743,3266239,3806982,09/01/2017 12:00:00 AM,191,300,278
Eastern,Newport News City,51700,2851,11661,14512,4782,26715,31497,513217,3419009,3932226,02/01/2017 12:00:00 AM,180,293,271
Eastern,Newport News City,51700,2886,10832,13718,4909,24775,29684,545864,3193510,3739374,10/01/2017 12:00:00 AM,189,295,273
Eastern,Newport News City,51700,2887,12501,15388,5128,28522,33650,580428,3655354,4235782,04/01/2015 12:00:00 AM,201,292,275
Eastern,Newport News City,51700,2891,11750,14641,4901,26913,31814,537204,3426391,3963595,12/01/2016 12:00:00 AM,186,292,271
Eastern,Newport News City,51700,2895,11598,14493,4890,26543,31433,527843,3374283,3902126,01/01/2017 12:00:00 AM,182,291,269
Eastern,Newport News City,51700,2902,10924,13826,4961,25092,30053,550572,3237022,3787594,11/01/2017 12:00:00 AM,190,296,274
Eastern,Newport News City,51700,2904,12465,15369,5150,28434,33584,583695,3643911,4227606,05/01/2015 12:00:00 AM,201,292,275
Eastern,Newport News City,51700,2908,12546,15454,5057,28719,33776,569386,3667875,4237261,07/01/2015 12:00:00 AM,196,292,274
Eastern,Newport News City,51700,2911,12108,15019,4982,27759,32741,548162,3509815,4057977,06/01/2016 12:00:00 AM,188,290,270
Eastern,Newport News City,51700,2912,12523,15435,5246,28310,33556,599873,3621569,4221442,03/01/2015 12:00:00 AM,206,289,273
Eastern,Newport News City,51700,2918,12113,15031,5028,27547,32575,554745,3490926,4045671,04/01/2016 12:00:00 AM,190,288,269
Eastern,Newport News City,51700,2920,12537,15457,5162,28640,33802,582288,3676958,4259246,06/01/2015 12:00:00 AM,199,293,276
Eastern,Newport News City,51700,2923,10902,13825,4973,24956,29929,548867,3196129,3744996,12/01/2017 12:00:00 AM,188,293,271
Eastern,Newport News City,51700,2923,12100,15023,5005,27631,32636,549974,3500910,4050884,05/01/2016 12:00:00 AM,188,289,270
Eastern,Newport News City,51700,2927,11771,14698,5043,27019,32062,556098,3441908,3998006,11/01/2016 12:00:00 AM,190,292,272
Eastern,Newport News City,51700,2933,12575,15508,5133,28741,33874,576166,3686018,4262184,09/01/2015 12:00:00 AM,196,293,275
Eastern,Newport News City,51700,2933,13778,16711,5291,30202,35493,596018,3811435,4407453,09/01/2014 12:00:00 AM,203,277,264
Eastern,Newport News City,51700,2934,10746,13680,4988,24465,29453,545152,3144958,3690110,03/01/2018 12:00:00 AM,186,293,270
Eastern,Newport News City,51700,2935,12076,15011,5079,27629,32708,556566,3496149,4052715,08/01/2016 12:00:00 AM,190,290,270
Eastern,Newport News City,51700,2935,13312,16247,5263,29699,34962,606795,3849667,4456462,11/01/2014 12:00:00 AM,207,289,274
Eastern,Newport News City,51700,2936,13913,16849,5289,30211,35500,599150,3828575,4427725,08/01/2014 12:00:00 AM,204,275,263
Eastern,Newport News City,51700,2937,10800,13737,4968,24598,29566,530970,3125058,3656028,01/01/2018 12:00:00 AM,181,289,266
Eastern,Newport News City,51700,2937,12541,15478,5124,28752,33876,579484,3676136,4255620,08/01/2015 12:00:00 AM,197,293,275
Eastern,Newport News City,51700,2940,13333,16273,5307,29732,35039,615610,3857217,4472827,10/01/2014 12:00:00 AM,209,289,275
Eastern,Newport News City,51700,2945,11987,14932,5080,27367,32447,575958,3508521,4084479,10/01/2016 12:00:00 AM,196,293,274
Eastern,Newport News City,51700,2948,12010,14958,5082,27562,32644,556071,3475211,4031282,07/01/2016 12:00:00 AM,189,289,270
Eastern,Newport News City,51700,2950,10444,13394,4842,23574,28416,510326,3029905,3540231,02/01/2020 12:00:00 AM,173,290,264
Eastern,Newport News City,51700,2951,10846,13797,5000,24728,29728,543849,3181516,3725365,02/01/2018 12:00:00 AM,184,293,270
Eastern,Newport News City,51700,2952,12023,14975,5093,27505,32598,558900,3469134,4028034,09/01/2016 12:00:00 AM,189,289,269
Eastern,Newport News City,51700,2961,12286,15247,5170,27888,33058,574901,3552638,4127539,02/01/2016 12:00:00 AM,194,289,271
Eastern,Newport News City,51700,2961,13197,16158,5283,29493,34776,605808,3813694,4419502,12/01/2014 12:00:00 AM,205,289,274
Eastern,Newport News City,51700,2962,12467,15429,5208,28440,33648,587187,3632629,4219816,10/01/2015 12:00:00 AM,198,291,273
Eastern,Newport News City,51700,2963,12192,15155,4519,26579,31098,990723,5627596,6618319,02/01/2021 12:00:00 AM,334,462,437
Eastern,Newport News City,51700,2966,12215,15181,5178,27675,32853,575133,3500073,4075206,03/01/2016 12:00:00 AM,194,287,268
Eastern,Newport News City,51700,2966,12537,15503,5341,28343,33684,609750,3638801,4248551,02/01/2015 12:00:00 AM,206,290,274
Eastern,Newport News City,51700,2971,10701,13672,5036,24460,29496,550057,3130307,3680364,04/01/2018 12:00:00 AM,185,293,269
Eastern,Newport News City,51700,2976,12308,15284,5237,28057,33294,584990,3535424,4120414,01/01/2016 12:00:00 AM,197,287,270
Eastern,Newport News City,51700,2980,12846,15826,5367,28841,34208,610025,3670990,4281015,01/01/2015 12:00:00 AM,205,286,271
Eastern,Newport News City,51700,2981,12496,15477,5249,28382,33631,588723,3620332,4209055,11/01/2015 12:00:00 AM,197,290,272
Eastern,Newport News City,51700,2983,12501,15484,5255,28444,33699,590286,3611738,4202024,12/01/2015 12:00:00 AM,198,289,271
Eastern,Newport News City,51700,2985,10488,13473,4931,23751,28682,873107,4063146,4936253,03/01/2020 12:00:00 AM,292,387,366
Eastern,Newport News City,51700,2986,14125,17111,5410,30348,35758,612139,3850356,4462495,07/01/2014 12:00:00 AM,205,273,261
Eastern,Newport News City,51700,2988,14391,17379,5427,30590,36017,612980,3908143,4521123,06/01/2014 12:00:00 AM,205,272,260
Eastern,Newport News City,51700,2994,14636,17630,5484,30856,36340,618525,3953136,4571661,05/01/2014 12:00:00 AM,207,270,259
Eastern,Newport News City,51700,3001,10671,13672,5085,24480,29565,554976,3147477,3702453,05/01/2018 12:00:00 AM,185,295,271
Eastern,Newport News City,51700,3002,14889,17891,5514,31189,36703,621834,4012529,4634363,04/01/2014 12:00:00 AM,207,269,259
Eastern,Newport News City,51700,3003,10503,13506,4963,23638,28601,528103,3050631.78,3578734.78,01/01/2020 12:00:00 AM,176,290,265
Eastern,Newport News City,51700,3006,9904,12910,4992,22458,27450,534258,2865860,3400118,02/01/2019 12:00:00 AM,178,289,263
Eastern,Newport News City,51700,3014,11917,14931,4769,25858,30627,1091944,5961429,7053373,05/01/2021 12:00:00 AM,362,500,472
Eastern,Newport News City,51700,3015,11991,15006,4735,25988,30723,1086902,5994941,7081843,04/01/2021 12:00:00 AM,360,500,472
Eastern,Newport News City,51700,3025,10680,13705,5060,24081,29141,547198,3144694,3691892,12/01/2019 12:00:00 AM,181,294,269
Eastern,Newport News City,51700,3027,10530,13557,5060,23926,28986,533419,3089846,3623265,07/01/2019 12:00:00 AM,176,293,267
Eastern,Newport News City,51700,3027,12229,15256,4689,26630,31319,1012515,5602047,6614562,03/01/2021 12:00:00 AM,334,458,434
Eastern,Newport News City,51700,3028,10633,13661,5070,23952,29022,541905,3096747,3638652,11/01/2019 12:00:00 AM,179,291,266
Eastern,Newport News City,51700,3032,10455,13487,5060,23569,28629,543409,3040259,3583668,05/01/2019 12:00:00 AM,179,291,266
Eastern,Newport News City,51700,3033,14973,18006,5629,31183,36812,633083,4000760,4633843,03/01/2014 12:00:00 AM,209,267,257
Eastern,Newport News City,51700,3041,10614,13655,5188,24424,29612,564053,3119712,3683765,06/01/2018 12:00:00 AM,185,294,270
Eastern,Newport News City,51700,3043,10699,13742,5107,24069,29176,551202,3144319.8,3695521.8,10/01/2019 12:00:00 AM,181,294,269
Eastern,Newport News City,51700,3050,10502,13552,5080,23727,28807,541595,3058147,3599742,06/01/2019 12:00:00 AM,178,291,266
Eastern,Newport News City,51700,3052,10646,13698,5090,24108,29198,541168,3116072,3657240,08/01/2019 12:00:00 AM,177,293,267
Eastern,Newport News City,51700,3052,11855,14907,4844,25723,30567,1111923,5936607,7048530,06/01/2021 12:00:00 AM,364,501,473
Eastern,Newport News City,51700,3053,10438,13491,5195,23984,29179,578200.13,3114401.58,3692601.71,10/01/2018 12:00:00 AM,189,298,274
Eastern,Newport News City,51700,3057,10647,13704,5226,24545,29771,566125,3138091,3704216,07/01/2018 12:00:00 AM,185,295,270
Eastern,Newport News City,51700,3062,10652,13714,5105,24152,29257,546845,3129232,3676077,09/01/2019 12:00:00 AM,179,294,268
Eastern,Newport News City,51700,3063,15138,18201,5684,31567,37251,639575,4048553,4688128,02/01/2014 12:00:00 AM,209,267,258
Eastern,Newport News City,51700,3064,11811,14875,5078,25929,31007,900265,4500752,5401017,04/01/2020 12:00:00 AM,294,381,363
Eastern,Newport News City,51700,3075,10451,13526,5100,23562,28662,543765,3028779,3572544,04/01/2019 12:00:00 AM,177,290,264
Eastern,Newport News City,51700,3092,10514,13606,5275,24269,29544,580511,3115826,3696337,09/01/2018 12:00:00 AM,188,296,272
Eastern,Newport News City,51700,3092,10610,13702,5288,24441,29729,577834,3117724,3695558,08/01/2018 12:00:00 AM,187,294,270
Eastern,Newport News City,51700,3092,15146,18238,5760,31546,37306,646005,4013549,4659554,01/01/2014 12:00:00 AM,209,265,255
Eastern,Newport News City,51700,3094,10407,13501,5185,23593,28778,560856,3016166,3577022,03/01/2019 12:00:00 AM,181,290,265
Eastern,Newport News City,51700,3094,10430,13524,5233,23942,29175,580686,3075007,3655693,11/01/2018 12:00:00 AM,188,295,270
Eastern,Newport News City,51700,3094,15076,18170,5862,31346,37208,722875,4333241,5056116,06/01/2013 12:00:00 AM,234,287,278
Eastern,Newport News City,51700,3096,10384,13480,5228,23546,28774,584151,3157647,3741798,01/01/2019 12:00:00 AM,189,304,278
Eastern,Newport News City,51700,3105,11935,15040,4990,26056,31046,1073618,5446185,6519803,01/01/2021 12:00:00 AM,346,456,433
Eastern,Newport News City,51700,3106,12160,15266,5125,26567,31692,918558,4639022.44,5557580.44,05/01/2020 12:00:00 AM,296,381,364
Eastern,Newport News City,51700,3107,15301,18408,5785,31876,37661,659749,4090088,4749837,12/01/2013 12:00:00 AM,212,267,258
Eastern,Newport News City,51700,3109,15285,18394,5871,31869,37740,725474,4377815,5103289,08/01/2013 12:00:00 AM,233,286,277
Eastern,Newport News City,51700,3110,15125,18235,5873,31514,37387,725713,4336392,5062105,07/01/2013 12:00:00 AM,233,287,278
Eastern,Newport News City,51700,3110,15364,18474,5813,31956,37769,667752,4096379,4764131,11/01/2013 12:00:00 AM,215,267,258
Eastern,Newport News City,51700,3117,12006,15123,5004,26394,31398,947758,4886013,5833771,11/01/2020 12:00:00 AM,304,407,386
Eastern,Newport News City,51700,3119,10424,13543,5298,23808,29106,589161,3085898,3675059,12/01/2018 12:00:00 AM,189,296,271
Eastern,Newport News City,51700,3123,15394,18517,5867,32055,37922,730541,4422003,5152544,10/01/2013 12:00:00 AM,234,287,278
Eastern,Newport News City,51700,3124,12012,15136,5040,26322,31362,945535,4795020,5740555,12/01/2020 12:00:00 AM,303,399,379
Eastern,Newport News City,51700,3125,12084,15209,5034,26565,31599,948712,4855206,5803918,10/01/2020 12:00:00 AM,304,402,382
Eastern,Newport News City,51700,3131,15301,18432,5893,31875,37768,727259,4384312,5111571,09/01/2013 12:00:00 AM,232,287,277
Eastern,Newport News City,51700,3137,12345,15482,5180,26881,32061,927368,4668128.34,5595496.34,06/01/2020 12:00:00 AM,296,378,361
Eastern,Newport News City,51700,3153,15011,18164,6062,31111,37173,757581,4310544,5068125,05/01/2013 12:00:00 AM,240,287,279
Eastern,Newport News City,51700,3159,14315,17474,6197,29778,35975,792520,4095126,4887646,05/01/2012 12:00:00 AM,251,286,280
Eastern,Newport News City,51700,3162,12354,15516,5158,27067,32225,919002,4710278,5629280,09/01/2020 12:00:00 AM,291,381,363
Eastern,Newport News City,51700,3163,14255,17418,6216,29682,35898,793047,4079736,4872783,04/01/2012 12:00:00 AM,251,286,280
Eastern,Newport News City,51700,3166,14222,17388,6229,29673,35902,803048,4076644,4879692,03/01/2012 12:00:00 AM,254,287,281
Eastern,Newport News City,51700,3166,14961,18127,6093,30934,37027,761249,4278758,5040007,04/01/2013 12:00:00 AM,240,286,278
Eastern,Newport News City,51700,3170,14388,17558,6228,29850,36078,793662,4117611,4911273,06/01/2012 12:00:00 AM,250,286,280
Eastern,Newport News City,51700,3171,12479,15650,5215,27159,32374,932698,4679837,5612535,07/01/2020 12:00:00 AM,294,375,359
Eastern,Newport News City,51700,3174,12381,15555,5227,26910,32137,921456,4605940.18,5527396.18,08/01/2020 12:00:00 AM,290,372,355
Eastern,Newport News City,51700,3186,14154,17340,6300,29561,35861,806821,4028654,4835475,01/01/2012 12:00:00 AM,253,285,279
Eastern,Newport News City,51700,3196,14242,17438,6335,29583,35918,819210,4073852,4893062,02/01/2012 12:00:00 AM,256,286,281
Eastern,Newport News City,51700,3218,14877,18095,6237,30839,37076,784388,4252522,5036910,03/01/2013 12:00:00 AM,244,286,278
Eastern,Newport News City,51700,3229,14351,17580,6330,29796,36126,813170,4108823,4921993,07/01/2012 12:00:00 AM,252,286,280
Eastern,Newport News City,51700,3247,14795,18042,6352,30647,36999,804525,4231271,5035796,02/01/2013 12:00:00 AM,248,286,279
Eastern,Newport News City,51700,3254,14718,17972,6368,30466,36834,824380,4223435,5047815,10/01/2012 12:00:00 AM,253,287,281
Eastern,Newport News City,51700,3258,14743,18001,6366,30509,36875,804570,4189912,4994482,01/01/2013 12:00:00 AM,247,284,277
Eastern,Newport News City,51700,3259,14601,17860,6421,30279,36700,824177,4181828,5006005,08/01/2012 12:00:00 AM,253,286,280
Eastern,Newport News City,51700,3280,14698,17978,6444,30456,36900,825379,4205009,5030388,12/01/2012 12:00:00 AM,252,286,280
Eastern,Newport News City,51700,3286,14707,17993,6471,30429,36900,833517,4205338,5038855,11/01/2012 12:00:00 AM,254,286,280
Eastern,Newport News City,51700,3289,14544,17833,6514,30080,36594,841170,4149034,4990204,09/01/2012 12:00:00 AM,256,285,280
Eastern,Norfolk City,51710,3686,15024,18710,5337,33841,39178,575516,4428311,5003827,03/01/2017 12:00:00 AM,156,295,267
Eastern,Norfolk City,51710,3689,14730,18419,5338,33288,38626,580524,4351182,4931706,04/01/2017 12:00:00 AM,157,295,268
Eastern,Norfolk City,51710,3690,15764,19454,4965,32804,37769,1108605,7025826,8134431,02/01/2021 12:00:00 AM,300,446,418
Eastern,Norfolk City,51710,3700,12843,16543,5292,28322,33614,556230,3583372,4139602,02/01/2019 12:00:00 AM,150,279,250
Eastern,Norfolk City,51710,3713,14617,18330,5385,33093,38478,589586,4319547,4909133,05/01/2017 12:00:00 AM,159,296,268
Eastern,Norfolk City,51710,3723,14404,18127,5433,32656,38089,600544,4296046,4896590,09/01/2017 12:00:00 AM,161,298,270
Eastern,Norfolk City,51710,3736,14398,18134,5416,32609,38025,598525,4279252,4877777,07/01/2017 12:00:00 AM,160,297,269
Eastern,Norfolk City,51710,3739,14553,18292,5437,33007,38444,607833,4343096,4950929,08/01/2017 12:00:00 AM,163,298,271
Eastern,Norfolk City,51710,3753,15745,19498,5080,32624,37704,1129847,6893708.4,8023555.4,03/01/2021 12:00:00 AM,301,438,412
Eastern,Norfolk City,51710,3761,14661,18422,5465,33193,38658,604636,4404400,5009036,06/01/2017 12:00:00 AM,161,300,272
Eastern,Norfolk City,51710,3773,15639,19412,5132,32296,37428,1213236,7480334,8693570,04/01/2021 12:00:00 AM,322,478,448
Eastern,Norfolk City,51710,3776,14265,18041,5441,32329,37770,599651,4209226,4808877,10/01/2017 12:00:00 AM,159,295,267
Eastern,Norfolk City,51710,3777,15562,19339,5210,31977,37187,1224973,7472559,8697532,05/01/2021 12:00:00 AM,324,480,450
Eastern,Norfolk City,51710,3780,13161,16941,5418,29053,34471,559732,3666391,4226123,01/01/2020 12:00:00 AM,148,279,249
Eastern,Norfolk City,51710,3782,13653,17435,5434,30645,36079,587216,3904699,4491915,05/01/2018 12:00:00 AM,155,286,258
Eastern,Norfolk City,51710,3784,13111,16895,5396,28934,34330,556517,3668692,4225209,02/01/2020 12:00:00 AM,147,280,250
Eastern,Norfolk City,51710,3786,14109,17895,5480,31945,37425,602520,4078523,4681043,12/01/2017 12:00:00 AM,159,289,262
Eastern,Norfolk City,51710,3790,14220,18010,5469,32280,37749,600800,4178108,4778908,11/01/2017 12:00:00 AM,159,294,265
Eastern,Norfolk City,51710,3802,13648,17450,5536,30409,35945,602156,3872424,4474580,12/01/2018 12:00:00 AM,158,284,256
Eastern,Norfolk City,51710,3802,13862,17664,5508,31372,36880,590078,4018664,4608742,02/01/2018 12:00:00 AM,155,290,261
Eastern,Norfolk City,51710,3802,15524,19326,5619,35257,40876,596820,4475937,5072757,01/01/2017 12:00:00 AM,157,288,262
Eastern,Norfolk City,51710,3808,13677,17485,5574,30442,36016,609657,3923432.14,4533089.14,10/01/2018 12:00:00 AM,160,287,259
Eastern,Norfolk City,51710,3809,15425,19234,5350,32149,37499,1182424,6835621,8018045,01/01/2021 12:00:00 AM,310,443,417
Eastern,Norfolk City,51710,3811,13885,17696,5504,31217,36721,596995,3990251,4587246,03/01/2018 12:00:00 AM,157,287,259
Eastern,Norfolk City,51710,3814,13714,17528,5485,30870,36355,593249,3932214,4525463,04/01/2018 12:00:00 AM,156,287,258
Eastern,Norfolk City,51710,3815,13714,17529,5527,30744,36271,605593,3928759,4534352,06/01/2018 12:00:00 AM,159,286,259
Eastern,Norfolk City,51710,3818,15601,19419,5276,31906,37182,1240372,7428789.48,8669161.48,06/01/2021 12:00:00 AM,325,476,446
Eastern,Norfolk City,51710,3825,13639,17464,5554,30609,36163,599115,3904266,4503381,07/01/2018 12:00:00 AM,157,286,258
Eastern,Norfolk City,51710,3826,13522,17348,5517,29962,35479,574801,3800140,4374941,07/01/2019 12:00:00 AM,150,281,252
Eastern,Norfolk City,51710,3828,13747,17575,5584,30762,36346,608113,3950815,4558928,11/01/2018 12:00:00 AM,159,287,259
Eastern,Norfolk City,51710,3829,13417,17246,5488,29708,35196,579123,3774481,4353604,11/01/2019 12:00:00 AM,151,281,252
Eastern,Norfolk City,51710,3829,13593,17422,5560,30128,35688,584995,3814385,4399380,05/01/2019 12:00:00 AM,153,281,253
Eastern,Norfolk City,51710,3832,14050,17882,5538,31848,37386,588158,4068649,4656807,01/01/2018 12:00:00 AM,153,290,260
Eastern,Norfolk City,51710,3833,13550,17383,5571,29977,35548,585055,3800999,4386054,06/01/2019 12:00:00 AM,153,281,252
Eastern,Norfolk City,51710,3835,13642,17477,5532,30260,35792,571776.77,3822845,4394621.77,08/01/2019 12:00:00 AM,149,280,251
Eastern,Norfolk City,51710,3837,13126,16963,5495,28926,34421,995003,4961253,5956256,03/01/2020 12:00:00 AM,259,378,351
Eastern,Norfolk City,51710,3837,13375,17212,5491,29683,35174,583376,3802408,4385784,12/01/2019 12:00:00 AM,152,284,255
Eastern,Norfolk City,51710,3842,15482,19324,5398,32419,37817,1043374,5961515,7004889,12/01/2020 12:00:00 AM,272,385,362
Eastern,Norfolk City,51710,3844,15613,19457,5586,35409,40995,596860,4546072,5142932,02/01/2017 12:00:00 AM,155,291,264
Eastern,Norfolk City,51710,3849,15676,19525,5806,35686,41492,624886,4554280,5179166,12/01/2016 12:00:00 AM,162,291,265
Eastern,Norfolk City,51710,3855,13794,17649,5588,30607,36195,613419,4129495,4742914,01/01/2019 12:00:00 AM,159,299,269
Eastern,Norfolk City,51710,3858,13672,17530,5669,30638,36307,614899,3921596,4536495,09/01/2018 12:00:00 AM,159,287,259
Eastern,Norfolk City,51710,3858,13797,17655,5662,30928,36590,606834,3938876,4545710,08/01/2018 12:00:00 AM,157,285,257
Eastern,Norfolk City,51710,3861,13561,17422,5530,29919,35449,583992,3849435.5,4433427.5,10/01/2019 12:00:00 AM,151,284,254
Eastern,Norfolk City,51710,3861,15348,19209,5429,32182,37611,1055529,5989403,7044932,11/01/2020 12:00:00 AM,273,390,367
Eastern,Norfolk City,51710,3872,13523,17395,5600,29902,35502,585365,3770100,4355465,04/01/2019 12:00:00 AM,151,279,250
Eastern,Norfolk City,51710,3873,13589,17462,5562,30098,35660,578601,3785181,4363782,03/01/2019 12:00:00 AM,149,279,250
Eastern,Norfolk City,51710,3874,13643,17517,5585,30252,35837,582101.5,3840205,4422306.5,09/01/2019 12:00:00 AM,150,281,252
Eastern,Norfolk City,51710,3880,15807,19687,5873,35981,41854,635321,4600593,5235914,11/01/2016 12:00:00 AM,164,291,266
Eastern,Norfolk City,51710,3907,15940,19847,5921,36332,42253,667155,4753683,5420838,10/01/2016 12:00:00 AM,171,298,273
Eastern,Norfolk City,51710,3938,15550,19488,5569,32678,38247,1077412,5998155,7075567,10/01/2020 12:00:00 AM,274,386,363
Eastern,Norfolk City,51710,3947,16264,20211,6057,36802,42859,657232,4680229,5337461,06/01/2016 12:00:00 AM,167,288,264
Eastern,Norfolk City,51710,3951,14810,18761,5648,31715,37363,1025404,5517115,6542519,04/01/2020 12:00:00 AM,260,373,349
Eastern,Norfolk City,51710,3951,16276,20227,6108,36748,42856,668483,4664228,5332711,05/01/2016 12:00:00 AM,169,287,264
Eastern,Norfolk City,51710,3956,16067,20023,6047,36603,42650,658444,4644043,5302487,09/01/2016 12:00:00 AM,166,289,265
Eastern,Norfolk City,51710,3960,16156,20116,6081,36677,42758,660583,4655746,5316329,07/01/2016 12:00:00 AM,167,288,264
Eastern,Norfolk City,51710,3971,16181,20152,6067,36702,42769,660834,4658759,5319593,08/01/2016 12:00:00 AM,166,288,264
Eastern,Norfolk City,51710,3983,15710,19693,5668,33162,38830,1030764,5748533,6779297,09/01/2020 12:00:00 AM,259,366,344
Eastern,Norfolk City,51710,3993,16546,20539,6161,37293,43454,674545,4728587,5403132,03/01/2016 12:00:00 AM,169,286,263
Eastern,Norfolk City,51710,3998,16428,20426,6153,37045,43198,673421,4706031,5379452,04/01/2016 12:00:00 AM,168,286,263
Eastern,Norfolk City,51710,4017,15442,19459,5749,32746,38495,1054434,5719952,6774386,05/01/2020 12:00:00 AM,262,370,348
Eastern,Norfolk City,51710,4023,16770,20793,6249,37752,44001,691495,4781873,5473368,01/01/2016 12:00:00 AM,172,285,263
Eastern,Norfolk City,51710,4035,16693,20728,6253,37478,43731,692401,4770058,5462459,02/01/2016 12:00:00 AM,172,286,264
Eastern,Norfolk City,51710,4036,15851,19887,5759,33293,39052,1048690,5749865,6798555,08/01/2020 12:00:00 AM,260,363,342
Eastern,Norfolk City,51710,4044,16899,20943,6269,38094,44363,694227,4835244,5529471,12/01/2015 12:00:00 AM,172,286,264
Eastern,Norfolk City,51710,4047,17023,21070,6303,38285,44588,695508,4878618,5574126,11/01/2015 12:00:00 AM,172,287,265
Eastern,Norfolk City,51710,4058,17094,21152,6338,38485,44823,702986,4892931,5595917,10/01/2015 12:00:00 AM,173,286,265
Eastern,Norfolk City,51710,4065,15747,19812,5823,33257,39080,1066851,5812428,6879279,06/01/2020 12:00:00 AM,262,369,347
Eastern,Norfolk City,51710,4065,17142,21207,6364,38399,44763,717579,4896557,5614136,06/01/2015 12:00:00 AM,177,286,265
Eastern,Norfolk City,51710,4070,17160,21230,6413,38448,44861,719498,4895420,5614918,09/01/2015 12:00:00 AM,177,285,264
Eastern,Norfolk City,51710,4073,17140,21213,6390,38379,44769,716413,4896677,5613090,07/01/2015 12:00:00 AM,176,286,265
Eastern,Norfolk City,51710,4074,17205,21279,6377,38623,45000,715512,4920577,5636089,08/01/2015 12:00:00 AM,176,286,265
Eastern,Norfolk City,51710,4092,15928,20020,5858,33655,39513,1068360,5828463,6896823,07/01/2020 12:00:00 AM,261,366,344
Eastern,Norfolk City,51710,4092,17005,21097,6434,38188,44622,721505,4879321,5600826,05/01/2015 12:00:00 AM,176,287,265
Eastern,Norfolk City,51710,4116,17141,21257,6568,38241,44809,741674,4889142,5630816,04/01/2015 12:00:00 AM,180,285,265
Eastern,Norfolk City,51710,4168,17222,21390,6729,38315,45044,766815,4884959,5651774,03/01/2015 12:00:00 AM,184,284,264
Eastern,Norfolk City,51710,4215,17358,21573,6872,38440,45312,783807,4923359,5707166,02/01/2015 12:00:00 AM,186,284,265
Eastern,Norfolk City,51710,4272,18538,22810,6980,40282,47262,801097,5250830,6051927,11/01/2014 12:00:00 AM,188,283,265
Eastern,Norfolk City,51710,4279,18860,23139,7001,40741,47742,796558,5341234,6137792,10/01/2014 12:00:00 AM,186,283,265
Eastern,Norfolk City,51710,4283,19401,23684,7058,41330,48388,766776,5264471,6031247,08/01/2014 12:00:00 AM,179,271,255
Eastern,Norfolk City,51710,4287,18299,22586,6997,39980,46977,808257,5171402,5979659,12/01/2014 12:00:00 AM,189,283,265
Eastern,Norfolk City,51710,4292,17972,22264,6977,39486,46463,788512,5037916,5826428,01/01/2015 12:00:00 AM,184,280,262
Eastern,Norfolk City,51710,4304,19085,23389,7063,41007,48070,761790,5193773,5955563,09/01/2014 12:00:00 AM,177,272,255
Eastern,Norfolk City,51710,4307,19588,23895,7093,41516,48609,762872,5298737,6061609,07/01/2014 12:00:00 AM,177,271,254
Eastern,Norfolk City,51710,4308,19933,24241,7143,41919,49062,768865,5364486,6133351,06/01/2014 12:00:00 AM,178,269,253
Eastern,Norfolk City,51710,4316,20212,24528,7180,42251,49431,777122,5427016,6204138,05/01/2014 12:00:00 AM,180,269,253
Eastern,Norfolk City,51710,4348,20324,24672,7206,42276,49482,785314,5431176,6216490,04/01/2014 12:00:00 AM,181,267,252
Eastern,Norfolk City,51710,4408,20424,24832,7346,42339,49685,803354,5422093,6225447,03/01/2014 12:00:00 AM,182,265,251
Eastern,Norfolk City,51710,4445,20623,25068,7420,42611,50031,808969,5456477,6265446,02/01/2014 12:00:00 AM,182,265,250
Eastern,Norfolk City,51710,4465,20638,25103,7472,42604,50076,813998,5428381,6242379,01/01/2014 12:00:00 AM,182,263,249
Eastern,Norfolk City,51710,4465,20919,25384,7458,43146,50604,819951,5538458,6358409,12/01/2013 12:00:00 AM,184,265,250
Eastern,Norfolk City,51710,4487,21118,25605,7499,43528,51027,822593,5587690,6410283,11/01/2013 12:00:00 AM,183,265,250
Eastern,Norfolk City,51710,4583,21222,25805,7792,43517,51309,932457,6002618,6935075,10/01/2013 12:00:00 AM,203,283,269
Eastern,Norfolk City,51710,4583,21388,25971,7774,43848,51622,935338,6039837,6975175,09/01/2013 12:00:00 AM,204,282,269
Eastern,Norfolk City,51710,4594,21219,25813,7749,43651,51400,927252,6023960,6951212,07/01/2013 12:00:00 AM,202,284,269
Eastern,Norfolk City,51710,4621,21382,26003,7790,44009,51799,938416,6071350,7009766,08/01/2013 12:00:00 AM,203,284,270
Eastern,Norfolk City,51710,4623,21028,25651,7944,43290,51234,954846,5977795,6932641,05/01/2013 12:00:00 AM,207,284,270
Eastern,Norfolk City,51710,4634,21129,25763,7902,43440,51342,952107,6004551,6956658,06/01/2013 12:00:00 AM,205,284,270
Eastern,Norfolk City,51710,4645,20930,25575,8068,43040,51108,965325,5919755,6885080,04/01/2013 12:00:00 AM,208,283,269
Eastern,Norfolk City,51710,4675,19922,24597,8233,41291,49524,992030,5658875,6650905,03/01/2012 12:00:00 AM,212,284,270
Eastern,Norfolk City,51710,4679,20913,25592,8188,42949,51137,980487,5909541,6890028,03/01/2013 12:00:00 AM,210,283,269
Eastern,Norfolk City,51710,4685,19935,24620,8251,41339,49590,1001004,5663863,6664867,04/01/2012 12:00:00 AM,214,284,271
Eastern,Norfolk City,51710,4701,20075,24776,8305,41437,49742,1000146,5694343,6694489,05/01/2012 12:00:00 AM,213,284,270
Eastern,Norfolk City,51710,4707,20832,25539,8226,42951,51177,1003723,5942124,6945847,10/01/2012 12:00:00 AM,213,285,272
Eastern,Norfolk City,51710,4721,20896,25617,8285,42980,51265,998681,5925412,6924093,02/01/2013 12:00:00 AM,212,284,270
Eastern,Norfolk City,51710,4722,20292,25014,8283,41947,50230,999065,5779381,6778446,06/01/2012 12:00:00 AM,212,285,271
Eastern,Norfolk City,51710,4722,20827,25549,8274,42950,51224,1007040,5937627,6944667,12/01/2012 12:00:00 AM,213,285,272
Eastern,Norfolk City,51710,4728,19867,24595,8348,41191,49539,1012140,5660184,6672324,02/01/2012 12:00:00 AM,214,285,271
Eastern,Norfolk City,51710,4738,19819,24557,8444,41086,49530,1025106,5589164,6614270,01/01/2012 12:00:00 AM,216,282,269
Eastern,Norfolk City,51710,4739,20603,25342,8328,42544,50872,1017962,5880085,6898047,09/01/2012 12:00:00 AM,215,285,272
Eastern,Norfolk City,51710,4740,20837,25577,8337,42877,51214,1002646,5858520,6861166,01/01/2013 12:00:00 AM,212,281,268
Eastern,Norfolk City,51710,4746,20836,25582,8341,42911,51252,1021405,5926046,6947451,11/01/2012 12:00:00 AM,215,284,272
Eastern,Norfolk City,51710,4748,20334,25082,8346,42031,50377,1010304,5778373,6788677,07/01/2012 12:00:00 AM,213,284,271
Eastern,Norfolk City,51710,4760,20571,25331,8348,42466,50814,1012928,5852844,6865772,08/01/2012 12:00:00 AM,213,285,271
Eastern,Northampton County,51131,277,841,1118,337,1664,2001,27619,190500,218119,01/01/2020 12:00:00 AM,100,227,195
Eastern,Northampton County,51131,282,835,1117,346,1686,2032,27835,189103,216938,02/01/2020 12:00:00 AM,99,226,194
Eastern,Northampton County,51131,284,858,1142,344,1746,2090,64083,300734,364817,03/01/2020 12:00:00 AM,226,351,319
Eastern,Northampton County,51131,284,919,1203,334,1759,2093,79851,400061,479912,04/01/2021 12:00:00 AM,281,435,399
Eastern,Northampton County,51131,285,886,1171,333,1681,2014,78278,390823,469101,06/01/2021 12:00:00 AM,275,441,401
Eastern,Northampton County,51131,286,836,1122,347,1669,2016,28965,191336,220301,12/01/2019 12:00:00 AM,101,229,196
Eastern,Northampton County,51131,286,901,1187,338,1741,2079,81108,393756,474864,05/01/2021 12:00:00 AM,284,437,400
Eastern,Northampton County,51131,287,932,1219,331,1809,2140,75093,389353,464446,03/01/2021 12:00:00 AM,262,418,381
Eastern,Northampton County,51131,289,840,1129,351,1665,2016,28590,186766,215356,11/01/2019 12:00:00 AM,99,222,191
Eastern,Northampton County,51131,290,825,1115,349,1639,1988,28805,184087,212892,10/01/2019 12:00:00 AM,99,223,191
Eastern,Northampton County,51131,291,920,1211,343,1830,2173,64336,317261,381597,09/01/2020 12:00:00 AM,221,345,315
Eastern,Northampton County,51131,293,947,1240,337,1852,2189,77910,400047,477957,02/01/2021 12:00:00 AM,266,422,385
Eastern,Northampton County,51131,294,835,1129,347,1628,1975,27084,179934,207018,09/01/2019 12:00:00 AM,92,215,183
Eastern,Northampton County,51131,294,867,1161,348,1695,2043,27222,189686,216908,07/01/2019 12:00:00 AM,93,219,187
Eastern,Northampton County,51131,294,879,1173,350,1727,2077,28522,194915,223437,06/01/2019 12:00:00 AM,97,222,190
Eastern,Northampton County,51131,295,926,1221,353,1857,2210,65998,323126,389124,06/01/2020 12:00:00 AM,224,349,319
Eastern,Northampton County,51131,295,942,1237,342,1880,2222,68761,352549,421310,12/01/2020 12:00:00 AM,233,374,341
Eastern,Northampton County,51131,296,908,1204,357,1831,2188,67161,316456,383617,04/01/2020 12:00:00 AM,227,349,319
Eastern,Northampton County,51131,296,925,1221,353,1836,2189,65725,318720,384445,08/01/2020 12:00:00 AM,222,345,315
Eastern,Northampton County,51131,297,851,1148,357,1683,2040,29748,183494,213242,02/01/2019 12:00:00 AM,100,216,186
Eastern,Northampton County,51131,297,922,1219,359,1864,2223,68083,321123,389206,05/01/2020 12:00:00 AM,229,348,319
Eastern,Northampton County,51131,297,923,1220,348,1851,2199,69650,361772,431422,11/01/2020 12:00:00 AM,235,392,354
Eastern,Northampton County,51131,298,877,1175,357,1730,2087,29028,196181,225209,05/01/2019 12:00:00 AM,97,224,192
Eastern,Northampton County,51131,298,930,1228,351,1872,2223,70476,343402,413878,10/01/2020 12:00:00 AM,236,369,337
Eastern,Northampton County,51131,298,932,1230,357,1865,2222,66913,324108,391021,07/01/2020 12:00:00 AM,225,348,318
Eastern,Northampton County,51131,299,888,1187,356,1765,2121,29654,199115,228769,04/01/2019 12:00:00 AM,99,224,193
Eastern,Northampton County,51131,299,925,1224,349,1828,2177,79677,386318,465995,01/01/2021 12:00:00 AM,266,418,381
Eastern,Northampton County,51131,301,858,1159,354,1674,2028,27967,182872,210839,08/01/2019 12:00:00 AM,93,213,182
Eastern,Northampton County,51131,302,883,1185,368,1755,2123,31073,194077,225150,03/01/2019 12:00:00 AM,103,220,190
Eastern,Northampton County,51131,307,838,1145,370,1668,2038,34731,183364,218095,11/01/2018 12:00:00 AM,113,219,190
Eastern,Northampton County,51131,307,865,1172,370,1720,2090,32172,195696,227868,01/01/2019 12:00:00 AM,105,226,194
Eastern,Northampton County,51131,308,813,1121,374,1619,1993,31853,176455,208308,09/01/2018 12:00:00 AM,103,217,186
Eastern,Northampton County,51131,309,810,1119,371,1638,2009,32567,180015,212582,10/01/2018 12:00:00 AM,105,222,190
Eastern,Northampton County,51131,310,847,1157,372,1686,2058,34709,190275,224984,12/01/2018 12:00:00 AM,112,225,194
Eastern,Northampton County,51131,311,823,1134,378,1674,2052,33141,184517,217658,08/01/2018 12:00:00 AM,107,224,192
Eastern,Northampton County,51131,312,857,1169,401,1760,2161,34720,199777,234497,11/01/2017 12:00:00 AM,111,233,201
Eastern,Northampton County,51131,314,850,1164,379,1726,2105,31574,191683,223257,07/01/2018 12:00:00 AM,101,226,192
Eastern,Northampton County,51131,316,879,1195,398,1773,2171,32149,201306,233455,01/01/2018 12:00:00 AM,102,229,195
Eastern,Northampton County,51131,317,862,1179,390,1734,2124,32596,193273,225869,06/01/2018 12:00:00 AM,103,224,192
Eastern,Northampton County,51131,317,875,1192,386,1775,2161,32199,201806,234005,04/01/2018 12:00:00 AM,102,231,196
Eastern,Northampton County,51131,317,881,1198,387,1794,2181,31334,205724,237058,03/01/2018 12:00:00 AM,99,234,198
Eastern,Northampton County,51131,318,882,1200,407,1776,2183,36301,202222,238523,12/01/2017 12:00:00 AM,114,229,199
Eastern,Northampton County,51131,319,865,1184,398,1757,2155,32632,196179,228811,05/01/2018 12:00:00 AM,102,227,193
Eastern,Northampton County,51131,320,886,1206,394,1783,2177,32878,203348,236226,02/01/2018 12:00:00 AM,103,230,196
Eastern,Northampton County,51131,323,863,1186,425,1766,2191,37909,203244,241153,10/01/2017 12:00:00 AM,117,236,203
Eastern,Northampton County,51131,330,848,1178,431,1743,2174,37651,198067,235718,09/01/2017 12:00:00 AM,114,234,200
Eastern,Northampton County,51131,335,866,1201,433,1766,2199,38203,202256,240459,08/01/2017 12:00:00 AM,114,234,200
Eastern,Northampton County,51131,335,898,1233,413,1848,2261,36168,209197,245365,05/01/2017 12:00:00 AM,108,233,199
Eastern,Northampton County,51131,336,936,1272,420,1948,2368,35261,205205,240466,08/01/2016 12:00:00 AM,105,219,189
Eastern,Northampton County,51131,339,896,1235,412,1824,2236,35782,207377,243159,04/01/2017 12:00:00 AM,106,231,197
Eastern,Northampton County,51131,340,920,1260,421,1908,2329,35215,205538,240753,11/01/2016 12:00:00 AM,104,223,191
Eastern,Northampton County,51131,340,923,1263,405,1904,2309,32767,210476,243243,01/01/2017 12:00:00 AM,96,228,193
Eastern,Northampton County,51131,341,913,1254,413,1844,2257,35559,209891,245450,03/01/2017 12:00:00 AM,104,230,196
Eastern,Northampton County,51131,342,947,1289,435,1958,2393,35811,209431,245242,07/01/2016 12:00:00 AM,105,221,190
Eastern,Northampton County,51131,342,995,1337,445,2023,2468,38172,222482,260654,04/01/2016 12:00:00 AM,112,224,195
Eastern,Northampton County,51131,343,915,1258,420,1898,2318,35049,206507,241556,12/01/2016 12:00:00 AM,102,226,192
Eastern,Northampton County,51131,343,928,1271,435,1929,2364,37174,199964,237138,09/01/2016 12:00:00 AM,108,215,187
Eastern,Northampton County,51131,344,1005,1349,452,2032,2484,40233,227941,268174,02/01/2016 12:00:00 AM,117,227,199
Eastern,Northampton County,51131,344,863,1207,443,1785,2228,39906,201211,241117,07/01/2017 12:00:00 AM,116,233,200
Eastern,Northampton County,51131,344,868,1212,435,1799,2234,39318,204259,243577,06/01/2017 12:00:00 AM,114,235,201
Eastern,Northampton County,51131,345,1002,1347,452,2032,2484,39733,225100,264833,03/01/2016 12:00:00 AM,115,225,197
Eastern,Northampton County,51131,345,915,1260,433,1891,2324,36772,202188,238960,10/01/2016 12:00:00 AM,107,221,190
Eastern,Northampton County,51131,345,988,1333,458,2004,2462,40473,223447,263920,01/01/2016 12:00:00 AM,117,226,198
Eastern,Northampton County,51131,346,955,1301,452,1962,2414,39584,212286,251870,05/01/2016 12:00:00 AM,114,222,194
Eastern,Northampton County,51131,346,963,1309,452,1967,2419,37410,211235,248645,06/01/2016 12:00:00 AM,108,219,190
Eastern,Northampton County,51131,347,1004,1351,458,2043,2501,38491,228435,266926,12/01/2015 12:00:00 AM,111,228,198
Eastern,Northampton County,51131,347,970,1317,457,2022,2479,39702,221272,260974,10/01/2015 12:00:00 AM,114,228,198
Eastern,Northampton County,51131,348,982,1330,457,2024,2481,39427,221920,261347,09/01/2015 12:00:00 AM,113,226,197
Eastern,Northampton County,51131,348,983,1331,463,2026,2489,39288,222016,261304,11/01/2015 12:00:00 AM,113,226,196
Eastern,Northampton County,51131,348,991,1339,453,2049,2502,38800,226188,264988,08/01/2015 12:00:00 AM,111,228,198
Eastern,Northampton County,51131,353,940,1293,430,1950,2380,36566,217008,253574,02/01/2017 12:00:00 AM,104,231,196
Eastern,Northampton County,51131,355,1015,1370,478,2100,2578,41340,232484,273824,07/01/2015 12:00:00 AM,116,229,200
Eastern,Northampton County,51131,356,1051,1407,488,2191,2679,43574,248870,292444,05/01/2015 12:00:00 AM,122,237,208
Eastern,Northampton County,51131,360,1135,1495,464,2327,2791,36733,262179,298912,07/01/2014 12:00:00 AM,102,231,200
Eastern,Northampton County,51131,361,1033,1394,499,2122,2621,45382,239189,284571,06/01/2015 12:00:00 AM,126,232,204
Eastern,Northampton County,51131,361,1086,1447,483,2272,2755,42739,259083,301822,03/01/2015 12:00:00 AM,118,239,209
Eastern,Northampton County,51131,362,1076,1438,474,2233,2707,42500,254506,297006,11/01/2014 12:00:00 AM,117,237,207
Eastern,Northampton County,51131,362,1086,1448,478,2274,2752,41912,261228,303140,02/01/2015 12:00:00 AM,116,241,209
Eastern,Northampton County,51131,362,1089,1451,469,2245,2714,37804,245060,282864,09/01/2014 12:00:00 AM,104,225,195
Eastern,Northampton County,51131,364,1104,1468,472,2291,2763,39234,253496,292730,08/01/2014 12:00:00 AM,108,230,199
Eastern,Northampton County,51131,365,1063,1428,498,2217,2715,44591,253932,298523,04/01/2015 12:00:00 AM,122,239,209
Eastern,Northampton County,51131,368,1074,1442,476,2248,2724,42815,255947,298762,10/01/2014 12:00:00 AM,116,238,207
Eastern,Northampton County,51131,368,1084,1452,480,2250,2730,43221,258179,301400,12/01/2014 12:00:00 AM,117,238,208
Eastern,Northampton County,51131,368,1089,1457,494,2260,2754,43447,255453,298900,01/01/2015 12:00:00 AM,118,235,205
Eastern,Northampton County,51131,372,1171,1543,486,2392,2878,39195,280415,319610,05/01/2014 12:00:00 AM,105,239,207
Eastern,Northampton County,51131,373,1159,1532,495,2369,2864,39943,272788,312731,06/01/2014 12:00:00 AM,107,235,204
Eastern,Northampton County,51131,373,1174,1547,489,2406,2895,44165,295419,339584,10/01/2013 12:00:00 AM,118,252,220
Eastern,Northampton County,51131,373,1187,1560,499,2394,2893,41926,277899,319825,04/01/2014 12:00:00 AM,112,234,205
Eastern,Northampton County,51131,376,1195,1571,498,2406,2904,40407,279853,320260,03/01/2014 12:00:00 AM,107,234,204
Eastern,Northampton County,51131,378,1169,1547,514,2367,2881,47923,290559,338482,09/01/2013 12:00:00 AM,127,249,219
Eastern,Northampton County,51131,380,1161,1541,515,2358,2873,47818,288865,336683,08/01/2013 12:00:00 AM,126,249,218
Eastern,Northampton County,51131,382,1196,1578,524,2412,2936,49221,297553,346774,05/01/2013 12:00:00 AM,129,249,220
Eastern,Northampton County,51131,383,1150,1533,543,2348,2891,50817,286632,337449,07/01/2012 12:00:00 AM,133,249,220
Eastern,Northampton County,51131,383,1182,1565,515,2403,2918,47943,293779,341722,07/01/2013 12:00:00 AM,125,249,218
Eastern,Northampton County,51131,383,1203,1586,514,2417,2931,47463,297887,345350,03/01/2013 12:00:00 AM,124,248,218
Eastern,Northampton County,51131,384,1190,1574,548,2423,2971,51872,303063,354935,04/01/2012 12:00:00 AM,135,255,225
Eastern,Northampton County,51131,384,1204,1588,513,2416,2929,47105,299548,346653,04/01/2013 12:00:00 AM,123,249,218
Eastern,Northampton County,51131,385,1130,1515,543,2293,2836,50126,275239,325365,08/01/2012 12:00:00 AM,130,244,215
Eastern,Northampton County,51131,385,1144,1529,540,2294,2834,49007,273400,322407,09/01/2012 12:00:00 AM,127,239,211
Eastern,Northampton County,51131,385,1162,1547,527,2338,2865,46418,263448,309866,11/01/2013 12:00:00 AM,121,227,200
Eastern,Northampton County,51131,387,1185,1572,529,2404,2933,50272,298551,348823,06/01/2013 12:00:00 AM,130,252,222
Eastern,Northampton County,51131,388,1156,1544,555,2341,2896,52219,288887,341106,06/01/2012 12:00:00 AM,135,250,221
Eastern,Northampton County,51131,388,1197,1585,536,2402,2938,50914,296239,347153,02/01/2013 12:00:00 AM,131,247,219
Eastern,Northampton County,51131,389,1177,1566,540,2376,2916,48445,272803,321248,12/01/2013 12:00:00 AM,125,232,205
Eastern,Northampton County,51131,389,1189,1578,530,2407,2937,44594,276805,321399,02/01/2014 12:00:00 AM,115,233,204
Eastern,Northampton County,51131,390,1162,1552,565,2352,2917,54637,290588,345225,05/01/2012 12:00:00 AM,140,250,222
Eastern,Northampton County,51131,392,1178,1570,544,2386,2930,46371,269125,315496,01/01/2014 12:00:00 AM,118,228,201
Eastern,Northampton County,51131,394,1141,1535,545,2300,2845,49891,275510,325401,10/01/2012 12:00:00 AM,127,241,212
Eastern,Northampton County,51131,395,1161,1556,541,2332,2873,50201,281136,331337,11/01/2012 12:00:00 AM,127,242,213
Eastern,Northampton County,51131,395,1175,1570,541,2362,2903,52905,286301,339206,12/01/2012 12:00:00 AM,134,244,216
Eastern,Northampton County,51131,396,1212,1608,568,2455,3023,56018,306797,362815,03/01/2012 12:00:00 AM,141,253,226
Eastern,Northampton County,51131,398,1193,1591,546,2390,2936,52825,291362,344187,01/01/2013 12:00:00 AM,133,244,216
Eastern,Northampton County,51131,399,1217,1616,582,2467,3049,57287,310695,367982,02/01/2012 12:00:00 AM,144,255,228
Eastern,Northampton County,51131,402,1207,1609,585,2443,3028,57311,303383,360694,01/01/2012 12:00:00 AM,143,251,224
Eastern,Poquoson City,51735,14,126,140,20,296,316,3645,51142,54787,03/01/2020 12:00:00 AM,260,406,391
Eastern,Poquoson City,51735,15,143,158,19,329,348,3560,56904,60464,04/01/2020 12:00:00 AM,237,398,383
Eastern,Poquoson City,51735,16,116,132,22,281,303,2095,35158,37253,01/01/2020 12:00:00 AM,131,303,282
Eastern,Poquoson City,51735,16,118,134,23,285,308,2242,36226,38468,12/01/2019 12:00:00 AM,140,307,287
Eastern,Poquoson City,51735,16,122,138,22,293,315,2345,37225,39570,02/01/2020 12:00:00 AM,147,305,287
Eastern,Poquoson City,51735,16,145,161,20,331,351,3572,58046,61618,05/01/2020 12:00:00 AM,223,400,383
Eastern,Poquoson City,51735,16,150,166,20,336,356,3812,58922,62734,06/01/2020 12:00:00 AM,238,393,378
Eastern,Poquoson City,51735,17,115,132,22,276,298,2945,35364,38309,11/01/2019 12:00:00 AM,173,308,290
Eastern,Poquoson City,51735,17,152,169,21,351,372,4477,64714,69191,11/01/2020 12:00:00 AM,263,426,409
Eastern,Poquoson City,51735,17,153,170,21,355,376,3951,62732,66683,10/01/2020 12:00:00 AM,232,410,392
Eastern,Poquoson City,51735,17,155,172,21,340,361,3761,58905,62666,08/01/2020 12:00:00 AM,221,380,364
Eastern,Poquoson City,51735,17,158,175,21,352,373,3773,60305,64078,07/01/2020 12:00:00 AM,222,382,366
Eastern,Poquoson City,51735,18,113,131,21,271,292,2344,35519,37863,05/01/2019 12:00:00 AM,130,314,289
Eastern,Poquoson City,51735,18,117,135,21,280,301,2294,35232,37526,06/01/2019 12:00:00 AM,127,301,278
Eastern,Poquoson City,51735,18,154,172,21,347,368,4098,60481,64579,09/01/2020 12:00:00 AM,228,393,375
Eastern,Poquoson City,51735,18,174,192,32,412,444,3888,52538,56426,01/01/2012 12:00:00 AM,216,302,294
Eastern,Poquoson City,51735,19,105,124,23,250,273,2524,33189,35713,02/01/2019 12:00:00 AM,133,316,288
Eastern,Poquoson City,51735,19,112,131,25,272,297,2570,36460,39030,09/01/2019 12:00:00 AM,135,326,298
Eastern,Poquoson City,51735,19,113,132,24,274,298,2362,36115,38477,08/01/2019 12:00:00 AM,124,320,291
Eastern,Poquoson City,51735,19,113,132,25,273,298,2747,36752,39499,10/01/2019 12:00:00 AM,145,325,299
Eastern,Poquoson City,51735,19,116,135,22,282,304,2477,37204,39681,07/01/2019 12:00:00 AM,130,321,294
Eastern,Poquoson City,51735,19,154,173,23,344,367,5461,77201,82662,04/01/2021 12:00:00 AM,287,501,478
Eastern,Poquoson City,51735,19,157,176,23,346,369,5695,81132,86827,05/01/2021 12:00:00 AM,300,517,493
Eastern,Poquoson City,51735,20,114,134,23,276,299,2435,33888,36323,04/01/2019 12:00:00 AM,122,297,271
Eastern,Poquoson City,51735,20,149,169,24,332,356,5554,70560,76114,01/01/2021 12:00:00 AM,278,474,450
Eastern,Poquoson City,51735,20,149,169,24,342,366,4761,61648,66409,12/01/2020 12:00:00 AM,238,414,393
Eastern,Poquoson City,51735,20,152,172,24,342,366,5237,73768,79005,02/01/2021 12:00:00 AM,262,485,459
Eastern,Poquoson City,51735,20,156,176,24,351,375,5613,72990,78603,03/01/2021 12:00:00 AM,281,468,447
Eastern,Poquoson City,51735,20,167,187,24,362,386,5741,83048,88789,06/01/2021 12:00:00 AM,287,497,475
Eastern,Poquoson City,51735,21,121,142,26,285,311,2940,37098,40038,03/01/2019 12:00:00 AM,140,307,282
Eastern,Poquoson City,51735,21,170,191,39,391,430,4655,50877,55532,02/01/2012 12:00:00 AM,222,299,291
Eastern,Poquoson City,51735,21,198,219,40,440,480,4456,50245,54701,12/01/2013 12:00:00 AM,212,254,250
Eastern,Poquoson City,51735,22,170,192,38,378,416,4645,44806,49451,09/01/2014 12:00:00 AM,211,264,258
Eastern,Poquoson City,51735,22,197,219,43,412,455,4722,46862,51584,01/01/2014 12:00:00 AM,215,238,236
Eastern,Poquoson City,51735,23,109,132,27,271,298,3084,33974,37058,12/01/2018 12:00:00 AM,134,312,281
Eastern,Poquoson City,51735,23,164,187,41,368,409,5091,45194,50285,10/01/2014 12:00:00 AM,221,276,269
Eastern,Poquoson City,51735,23,167,190,42,389,431,4183,49999,54182,03/01/2012 12:00:00 AM,182,299,285
Eastern,Poquoson City,51735,23,188,211,40,414,454,4598,54231,58829,08/01/2013 12:00:00 AM,200,288,279
Eastern,Poquoson City,51735,24,110,134,29,277,306,3368,35642,39010,10/01/2018 12:00:00 AM,140,324,291
Eastern,Poquoson City,51735,24,120,144,29,289,318,3444,38603,42047,01/01/2019 12:00:00 AM,144,322,292
Eastern,Poquoson City,51735,24,139,163,37,373,410,4503,43542,48045,01/01/2017 12:00:00 AM,188,313,295
Eastern,Poquoson City,51735,24,140,164,42,365,407,5270,43145,48415,11/01/2016 12:00:00 AM,220,308,295
Eastern,Poquoson City,51735,24,150,174,39,371,410,4308,43252,47560,05/01/2016 12:00:00 AM,180,288,273
Eastern,Poquoson City,51735,24,165,189,43,376,419,4715,49426,54141,05/01/2012 12:00:00 AM,196,300,286
Eastern,Poquoson City,51735,24,166,190,42,368,410,4745,46862,51607,12/01/2014 12:00:00 AM,198,282,272
Eastern,Poquoson City,51735,24,168,192,42,376,418,4994,47381,52375,11/01/2014 12:00:00 AM,208,282,273
Eastern,Poquoson City,51735,24,189,213,49,418,467,6975,54991,61966,10/01/2013 12:00:00 AM,291,291,291
Eastern,Poquoson City,51735,24,191,215,43,416,459,5005,55546,60551,07/01/2013 12:00:00 AM,209,291,282
Eastern,Poquoson City,51735,24,195,219,44,426,470,6046,55680,61726,09/01/2013 12:00:00 AM,252,286,282
Eastern,Poquoson City,51735,24,195,219,45,434,479,5281,52236,57517,11/01/2013 12:00:00 AM,220,268,263
Eastern,Poquoson City,51735,25,106,131,29,272,301,3118,33200,36318,07/01/2018 12:00:00 AM,125,313,277
Eastern,Poquoson City,51735,25,108,133,30,280,310,3143,36794,39937,09/01/2018 12:00:00 AM,126,341,300
Eastern,Poquoson City,51735,25,110,135,32,274,306,3764,35375,39139,11/01/2018 12:00:00 AM,151,322,290
Eastern,Poquoson City,51735,25,140,165,40,374,414,5030,44172,49202,12/01/2016 12:00:00 AM,201,316,298
Eastern,Poquoson City,51735,25,143,168,40,377,417,4935,44023,48958,02/01/2017 12:00:00 AM,197,308,291
Eastern,Poquoson City,51735,25,144,169,45,357,402,4794,42265,47059,07/01/2016 12:00:00 AM,192,294,278
Eastern,Poquoson City,51735,25,146,171,47,367,414,6192,43067,49259,10/01/2016 12:00:00 AM,248,295,288
Eastern,Poquoson City,51735,25,146,171,48,356,404,5536,42485,48021,08/01/2016 12:00:00 AM,221,291,281
Eastern,Poquoson City,51735,25,159,184,48,368,416,5212,47444,52656,04/01/2012 12:00:00 AM,208,298,286
Eastern,Poquoson City,51735,25,164,189,47,371,418,5309,47492,52801,02/01/2015 12:00:00 AM,212,290,279
Eastern,Poquoson City,51735,25,170,195,46,384,430,5726,46221,51947,08/01/2014 12:00:00 AM,229,272,266
Eastern,Poquoson City,51735,25,176,201,49,387,436,5670,45524,51194,07/01/2014 12:00:00 AM,227,259,255
Eastern,Poquoson City,51735,25,181,206,49,397,446,5945,47600,53545,06/01/2014 12:00:00 AM,238,263,260
Eastern,Poquoson City,51735,25,183,208,47,379,426,4970,43458,48428,02/01/2014 12:00:00 AM,199,237,233
Eastern,Poquoson City,51735,25,207,232,39,455,494,4014,59958,63972,02/01/2013 12:00:00 AM,161,290,276
Eastern,Poquoson City,51735,25,208,233,40,461,501,4356,61939,66295,03/01/2013 12:00:00 AM,174,298,285
Eastern,Poquoson City,51735,26,146,172,43,360,403,4412,42390,46802,06/01/2016 12:00:00 AM,170,290,272
Eastern,Poquoson City,51735,26,148,174,42,363,405,4679,43222,47901,04/01/2016 12:00:00 AM,180,292,275
Eastern,Poquoson City,51735,26,150,176,51,367,418,6373,42616,48989,09/01/2016 12:00:00 AM,245,284,278
Eastern,Poquoson City,51735,26,161,187,45,368,413,4868,44746,49614,04/01/2015 12:00:00 AM,187,278,265
Eastern,Poquoson City,51735,26,162,188,45,370,415,5182,46452,51634,01/01/2015 12:00:00 AM,199,287,275
Eastern,Poquoson City,51735,26,163,189,48,375,423,5280,47076,52356,03/01/2015 12:00:00 AM,203,289,277
Eastern,Poquoson City,51735,26,165,191,46,373,419,5873,48526,54399,06/01/2012 12:00:00 AM,226,294,285
Eastern,Poquoson City,51735,26,179,205,43,405,448,5473,54419,59892,10/01/2012 12:00:00 AM,211,304,292
Eastern,Poquoson City,51735,26,184,210,49,395,444,5941,45244,51185,04/01/2014 12:00:00 AM,229,246,244
Eastern,Poquoson City,51735,26,184,210,51,397,448,6103,47304,53407,05/01/2014 12:00:00 AM,235,257,254
Eastern,Poquoson City,51735,26,202,228,46,430,476,5537,57919,63456,06/01/2013 12:00:00 AM,213,287,278
Eastern,Poquoson City,51735,26,207,233,46,445,491,5397,59448,64845,05/01/2013 12:00:00 AM,208,287,278
Eastern,Poquoson City,51735,27,107,134,32,279,311,3451,34497,37948,08/01/2018 12:00:00 AM,128,322,283
Eastern,Poquoson City,51735,27,116,143,35,281,316,3591,35791,39382,06/01/2018 12:00:00 AM,133,309,275
Eastern,Poquoson City,51735,27,124,151,33,302,335,3647,39429,43076,05/01/2018 12:00:00 AM,135,318,285
Eastern,Poquoson City,51735,27,131,158,38,332,370,4373,41205,45578,06/01/2017 12:00:00 AM,162,315,288
Eastern,Poquoson City,51735,27,144,171,40,369,409,5104,42810,47914,03/01/2017 12:00:00 AM,189,297,280
Eastern,Poquoson City,51735,27,151,178,44,364,408,4750,44829,49579,03/01/2016 12:00:00 AM,176,297,279
Eastern,Poquoson City,51735,27,156,183,45,371,416,5293,46326,51619,05/01/2015 12:00:00 AM,196,297,282
Eastern,Poquoson City,51735,27,169,196,52,386,438,6849,51405,58254,07/01/2012 12:00:00 AM,254,304,297
Eastern,Poquoson City,51735,27,188,215,50,395,445,5980,45220,51200,03/01/2014 12:00:00 AM,221,241,238
Eastern,Poquoson City,51735,27,205,232,46,435,481,5357,57022,62379,04/01/2013 12:00:00 AM,198,278,269
Eastern,Poquoson City,51735,28,127,155,34,310,344,3667,40102,43769,04/01/2018 12:00:00 AM,131,316,282
Eastern,Poquoson City,51735,28,131,159,38,328,366,5239,40260,45499,07/01/2017 12:00:00 AM,187,307,286
Eastern,Poquoson City,51735,28,133,161,34,329,363,3748,41876,45624,03/01/2018 12:00:00 AM,134,315,283
Eastern,Poquoson City,51735,28,133,161,36,334,370,4158,40803,44961,02/01/2018 12:00:00 AM,149,307,279
Eastern,Poquoson City,51735,28,160,188,45,389,434,4867,48222,53089,02/01/2016 12:00:00 AM,174,301,282
Eastern,Poquoson City,51735,28,179,207,52,400,452,6485,51908,58393,11/01/2012 12:00:00 AM,232,290,282
Eastern,Poquoson City,51735,28,193,221,48,415,463,5597,55038,60635,01/01/2013 12:00:00 AM,200,285,274
Eastern,Poquoson City,51735,29,122,151,42,311,353,5143,38029,43172,12/01/2017 12:00:00 AM,177,312,286
Eastern,Poquoson City,51735,29,131,160,44,337,381,5397,40283,45680,04/01/2017 12:00:00 AM,186,308,286
Eastern,Poquoson City,51735,29,134,163,43,343,386,5781,41150,46931,05/01/2017 12:00:00 AM,199,307,288
Eastern,Poquoson City,51735,29,150,179,48,367,415,5639,44775,50414,11/01/2015 12:00:00 AM,194,299,282
Eastern,Poquoson City,51735,29,150,179,49,353,402,6024,43188,49212,06/01/2015 12:00:00 AM,208,288,275
Eastern,Poquoson City,51735,29,168,197,57,369,426,8256,50419,58675,09/01/2012 12:00:00 AM,285,300,298
Eastern,Poquoson City,51735,29,169,198,59,381,440,8352,50132,58484,08/01/2012 12:00:00 AM,288,297,295
Eastern,Poquoson City,51735,29,180,209,56,394,450,7420,51746,59166,12/01/2012 12:00:00 AM,256,287,283
Eastern,Poquoson City,51735,30,127,157,40,326,366,4923,40550,45473,09/01/2017 12:00:00 AM,164,319,290
Eastern,Poquoson City,51735,30,130,160,38,333,371,4627,40802,45429,08/01/2017 12:00:00 AM,154,314,284
Eastern,Poquoson City,51735,30,133,163,42,320,362,5674,40851,46525,11/01/2017 12:00:00 AM,189,307,285
Eastern,Poquoson City,51735,30,156,186,52,380,432,5944,46811,52755,12/01/2015 12:00:00 AM,198,300,284
Eastern,Poquoson City,51735,31,133,164,45,326,371,5615,40698,46313,10/01/2017 12:00:00 AM,181,306,282
Eastern,Poquoson City,51735,31,149,180,51,349,400,6191,41988,48179,07/01/2015 12:00:00 AM,200,282,268
Eastern,Poquoson City,51735,31,149,180,55,352,407,6258,44610,50868,10/01/2015 12:00:00 AM,202,299,283
Eastern,Poquoson City,51735,31,151,182,50,355,405,5885,43644,49529,08/01/2015 12:00:00 AM,190,289,272
Eastern,Poquoson City,51735,31,158,189,55,384,439,6299,46518,52817,01/01/2016 12:00:00 AM,203,294,279
Eastern,Poquoson City,51735,32,132,164,45,335,380,5367,40970,46337,01/01/2018 12:00:00 AM,168,310,283
Eastern,Poquoson City,51735,33,146,179,60,338,398,6809,42931,49740,09/01/2015 12:00:00 AM,206,294,278
Eastern,Portsmouth City,51740,1832,7459,9291,2616,16426,19042,296673,2170018,2466691,02/01/2019 12:00:00 AM,162,291,265
Eastern,Portsmouth City,51740,1865,7814,9679,2616,17639,20255,298212,2385191,2683403,04/01/2017 12:00:00 AM,160,305,277
Eastern,Portsmouth City,51740,1869,7808,9677,2675,17022,19697,300773,2235704,2536477,05/01/2019 12:00:00 AM,161,286,262
Eastern,Portsmouth City,51740,1871,7860,9731,2662,17067,19729,301563,2258907,2560470,06/01/2019 12:00:00 AM,161,287,263
Eastern,Portsmouth City,51740,1875,7492,9367,2651,16821,19472,297812,2238046.33,2535858.33,04/01/2018 12:00:00 AM,159,299,271
Eastern,Portsmouth City,51740,1876,7756,9632,2644,17547,20191,301270,2412100,2713370,07/01/2017 12:00:00 AM,161,311,282
Eastern,Portsmouth City,51740,1877,7716,9593,2710,17142,19852,313857,2309557,2623414,12/01/2018 12:00:00 AM,167,299,273
Eastern,Portsmouth City,51740,1878,7885,9763,2648,17823,20471,308695,2450455,2759150,08/01/2017 12:00:00 AM,164,311,283
Eastern,Portsmouth City,51740,1879,7892,9771,2639,17817,20456,304188,2448150,2752338,05/01/2017 12:00:00 AM,162,310,282
Eastern,Portsmouth City,51740,1880,7749,9629,2706,17036,19742,315147,2349976,2665123,01/01/2019 12:00:00 AM,168,303,277
Eastern,Portsmouth City,51740,1882,7735,9617,2654,17347,20001,302023,2311204,2613227,09/01/2018 12:00:00 AM,160,299,272
Eastern,Portsmouth City,51740,1882,7891,9773,2696,17060,19756,305352,2265885.65,2571237.65,07/01/2019 12:00:00 AM,162,287,263
Eastern,Portsmouth City,51740,1883,7709,9592,2691,17236,19927,317082,2335610.86,2652692.86,10/01/2018 12:00:00 AM,168,303,277
Eastern,Portsmouth City,51740,1888,7908,9796,2669,17931,20600,317476,2461420,2778896,09/01/2017 12:00:00 AM,168,311,284
Eastern,Portsmouth City,51740,1889,7796,9685,2722,17000,19722,306164,2242173,2548337,04/01/2019 12:00:00 AM,162,288,263
Eastern,Portsmouth City,51740,1892,7764,9656,2722,17270,19992,315468,2307434.79,2622902.79,11/01/2018 12:00:00 AM,167,297,272
Eastern,Portsmouth City,51740,1893,7948,9841,2677,17826,20503,314036,2441293,2755329,10/01/2017 12:00:00 AM,166,307,280
Eastern,Portsmouth City,51740,1895,7655,9550,2681,17227,19908,304480,2300150,2604630,07/01/2018 12:00:00 AM,161,300,273
Eastern,Portsmouth City,51740,1896,7865,9761,2680,17723,20403,310828,2453927,2764755,06/01/2017 12:00:00 AM,164,312,283
Eastern,Portsmouth City,51740,1898,7810,9708,2727,17106,19833,307337,2242490.12,2549827.12,03/01/2019 12:00:00 AM,162,287,263
Eastern,Portsmouth City,51740,1899,7937,9836,2713,17221,19934,309176,2268045,2577221,08/01/2019 12:00:00 AM,163,286,262
Eastern,Portsmouth City,51740,1903,7771,9674,2711,17498,20209,311996,2324912,2636908,08/01/2018 12:00:00 AM,164,299,273
Eastern,Portsmouth City,51740,1904,7645,9549,2695,17313,20008,307153,2309979,2617132,06/01/2018 12:00:00 AM,161,302,274
Eastern,Portsmouth City,51740,1904,7994,9898,2665,18000,20665,305700,2441487,2747187,03/01/2017 12:00:00 AM,161,305,278
Eastern,Portsmouth City,51740,1912,7958,9870,2730,17257,19987,309639,2295847,2605486,09/01/2019 12:00:00 AM,162,288,264
Eastern,Portsmouth City,51740,1913,7650,9563,2724,17285,20009,309951,2325739,2635690,05/01/2018 12:00:00 AM,162,304,276
Eastern,Portsmouth City,51740,1913,7683,9596,2718,17335,20053,314018,2340088,2654106,03/01/2018 12:00:00 AM,164,305,277
Eastern,Portsmouth City,51740,1917,7907,9824,2785,17109,19894,313027,2272411,2585438,11/01/2019 12:00:00 AM,163,287,263
Eastern,Portsmouth City,51740,1926,7904,9830,2796,17154,19950,306778,2241257,2548035,01/01/2020 12:00:00 AM,159,284,259
Eastern,Portsmouth City,51740,1927,7861,9788,2793,17048,19841,311528,2244772,2556300,02/01/2020 12:00:00 AM,162,286,261
Eastern,Portsmouth City,51740,1928,7988,9916,2783,17208,19991,313875,2297409,2611284,10/01/2019 12:00:00 AM,163,288,263
Eastern,Portsmouth City,51740,1929,7723,9652,2732,17454,20186,302364,2312322,2614686,01/01/2018 12:00:00 AM,157,299,271
Eastern,Portsmouth City,51740,1931,7975,9906,2787,17217,20004,310573,2280136,2590709,12/01/2019 12:00:00 AM,161,286,262
Eastern,Portsmouth City,51740,1934,7686,9620,2766,17370,20136,313768,2314280,2628048,02/01/2018 12:00:00 AM,162,301,273
Eastern,Portsmouth City,51740,1934,7928,9862,2797,17145,19942,505572,2955627,3461199,03/01/2020 12:00:00 AM,261,373,351
Eastern,Portsmouth City,51740,1937,8209,10146,2703,18664,21367,299314,2461816,2761130,02/01/2017 12:00:00 AM,155,300,272
Eastern,Portsmouth City,51740,1943,7905,9848,2785,17849,20634,331002,2427457,2758459,11/01/2017 12:00:00 AM,170,307,280
Eastern,Portsmouth City,51740,1948,7875,9823,2777,17724,20501,326588,2402070,2728658,12/01/2017 12:00:00 AM,168,305,278
Eastern,Portsmouth City,51740,1971,8715,10686,2738,18560,21298,611011,3921483,4532494,02/01/2021 12:00:00 AM,310,450,424
Eastern,Portsmouth City,51740,1972,8208,10180,2816,18563,21379,316446,2436339,2752785,01/01/2017 12:00:00 AM,160,297,270
Eastern,Portsmouth City,51740,1982,8675,10657,2863,18459,21322,521223,3217370,3738593,04/01/2020 12:00:00 AM,263,371,351
Eastern,Portsmouth City,51740,1987,8669,10656,2858,18428,21286,549451,3404950,3954401,11/01/2020 12:00:00 AM,277,393,371
Eastern,Portsmouth City,51740,1999,8631,10630,2808,18234,21042,657548,4238281,4895829,04/01/2021 12:00:00 AM,329,491,461
Eastern,Portsmouth City,51740,2001,8533,10534,2849,18146,20995,624033,3807322,4431355,01/01/2021 12:00:00 AM,312,446,421
Eastern,Portsmouth City,51740,2001,8652,10653,2816,18252,21068,667562,4255132,4922694,05/01/2021 12:00:00 AM,334,492,462
Eastern,Portsmouth City,51740,2005,8598,10603,2883,18314,21197,552725,3331185,3883910,12/01/2020 12:00:00 AM,276,387,366
Eastern,Portsmouth City,51740,2010,8708,10718,2799,18448,21247,617475,3879414,4496889,03/01/2021 12:00:00 AM,307,446,420
Eastern,Portsmouth City,51740,2015,8289,10304,2935,18787,21722,331183,2468463,2799646,12/01/2016 12:00:00 AM,164,298,272
Eastern,Portsmouth City,51740,2017,8314,10331,2902,18906,21808,332352,2486090,2818442,11/01/2016 12:00:00 AM,165,299,273
Eastern,Portsmouth City,51740,2022,8671,10693,2862,18307,21169,674410,4243721,4918131,06/01/2021 12:00:00 AM,334,489,460
Eastern,Portsmouth City,51740,2022,8821,10843,2928,18658,21586,564143,3419082,3983225,10/01/2020 12:00:00 AM,279,388,367
Eastern,Portsmouth City,51740,2031,8983,11014,2951,18986,21937,538128,3314756,3852884,05/01/2020 12:00:00 AM,265,369,350
Eastern,Portsmouth City,51740,2033,8386,10419,2987,19093,22080,344925,2579757,2924682,10/01/2016 12:00:00 AM,170,308,281
Eastern,Portsmouth City,51740,2034,8345,10379,2980,19110,22090,333644,2481169,2814813,09/01/2016 12:00:00 AM,164,297,271
Eastern,Portsmouth City,51740,2037,8318,10355,3022,19167,22189,335799,2490915,2826714,08/01/2016 12:00:00 AM,165,299,273
Eastern,Portsmouth City,51740,2041,9193,11234,3193,20155,23348,346131,2594187,2940318,06/01/2014 12:00:00 AM,170,282,262
Eastern,Portsmouth City,51740,2046,8231,10277,3055,19039,22094,342701,2477540,2820241,07/01/2016 12:00:00 AM,167,301,274
Eastern,Portsmouth City,51740,2048,9006,11054,2979,19076,22055,538209,3293440,3831649,09/01/2020 12:00:00 AM,263,366,347
Eastern,Portsmouth City,51740,2050,8044,10094,3043,18801,21844,339018,2439295,2778313,03/01/2016 12:00:00 AM,165,303,275
Eastern,Portsmouth City,51740,2054,7972,10026,3038,18723,21761,339336,2417833,2757169,04/01/2016 12:00:00 AM,165,303,275
Eastern,Portsmouth City,51740,2054,8148,10202,3121,18904,22025,354004,2449507,2803511,04/01/2015 12:00:00 AM,172,301,275
Eastern,Portsmouth City,51740,2055,8111,10166,3019,18938,21957,337831,2454749,2792580,05/01/2016 12:00:00 AM,164,303,275
Eastern,Portsmouth City,51740,2058,9164,11222,3001,19324,22325,547979,3355789,3903768,06/01/2020 12:00:00 AM,266,366,348
Eastern,Portsmouth City,51740,2059,8124,10183,3123,18977,22100,353712,2471601,2825313,05/01/2015 12:00:00 AM,172,304,277
Eastern,Portsmouth City,51740,2060,9131,11191,2996,19254,22250,542473,3308740.9,3851213.9,08/01/2020 12:00:00 AM,263,362,344
Eastern,Portsmouth City,51740,2060,9250,11310,3266,20092,23358,356023,2599475,2955498,05/01/2014 12:00:00 AM,173,281,261
Eastern,Portsmouth City,51740,2062,8042,10104,3094,18745,21839,346026,2438586,2784612,02/01/2016 12:00:00 AM,168,303,276
Eastern,Portsmouth City,51740,2067,8215,10282,3052,19114,22166,341922,2476692,2818614,06/01/2016 12:00:00 AM,165,301,274
Eastern,Portsmouth City,51740,2069,8111,10180,3136,18936,22072,351155,2469903,2821058,06/01/2015 12:00:00 AM,170,305,277
Eastern,Portsmouth City,51740,2069,9266,11335,3023,19589,22612,551960,3404911,3956871,07/01/2020 12:00:00 AM,267,367,349
Eastern,Portsmouth City,51740,2070,8144,10214,3091,18984,22075,349181,2468026,2817207,10/01/2015 12:00:00 AM,169,303,276
Eastern,Portsmouth City,51740,2076,8043,10119,3098,18800,21898,345304,2434704,2780008,01/01/2016 12:00:00 AM,166,303,275
Eastern,Portsmouth City,51740,2082,8126,10208,3206,18832,22038,365132,2441836,2806968,03/01/2015 12:00:00 AM,175,300,275
Eastern,Portsmouth City,51740,2083,8170,10253,3105,19054,22159,350151,2477894,2828045,09/01/2015 12:00:00 AM,168,303,276
Eastern,Portsmouth City,51740,2083,9428,11511,3317,20212,23529,362187,2598645,2960832,03/01/2014 12:00:00 AM,174,276,257
Eastern,Portsmouth City,51740,2087,9323,11410,3332,20111,23443,362111,2602675,2964786,04/01/2014 12:00:00 AM,174,279,260
Eastern,Portsmouth City,51740,2090,8105,10195,3128,18920,22048,347356,2458912,2806268,12/01/2015 12:00:00 AM,166,303,275
Eastern,Portsmouth City,51740,2091,9046,11137,3273,19980,23253,357725,2557107,2914832,07/01/2014 12:00:00 AM,171,283,262
Eastern,Portsmouth City,51740,2093,8103,10196,3144,18963,22107,350856,2475975,2826831,07/01/2015 12:00:00 AM,168,306,277
Eastern,Portsmouth City,51740,2096,8149,10245,3136,19061,22197,354776,2488431,2843207,08/01/2015 12:00:00 AM,169,305,278
Eastern,Portsmouth City,51740,2105,8144,10249,3291,18844,22135,374713,2446963,2821676,02/01/2015 12:00:00 AM,178,300,275
Eastern,Portsmouth City,51740,2107,8107,10214,3155,18913,22068,352828,2460921,2813749,11/01/2015 12:00:00 AM,167,304,275
Eastern,Portsmouth City,51740,2114,9928,12042,3574,20917,24491,443578,2935282,3378860,10/01/2012 12:00:00 AM,210,296,281
Eastern,Portsmouth City,51740,2115,8755,10870,3335,19663,22998,369484,2488307,2857791,09/01/2014 12:00:00 AM,175,284,263
Eastern,Portsmouth City,51740,2126,9410,11536,3659,19898,23557,452212,2744163,3196375,04/01/2012 12:00:00 AM,213,292,277
Eastern,Portsmouth City,51740,2126,9499,11625,3642,20050,23692,447873,2770856,3218729,05/01/2012 12:00:00 AM,211,292,277
Eastern,Portsmouth City,51740,2127,9423,11550,3418,20203,23621,373398,2596135,2969533,02/01/2014 12:00:00 AM,176,276,257
Eastern,Portsmouth City,51740,2129,8832,10961,3349,19727,23076,368602,2517105,2885707,08/01/2014 12:00:00 AM,173,285,263
Eastern,Portsmouth City,51740,2132,9796,11928,3571,20696,24267,437260,2889253,3326513,05/01/2013 12:00:00 AM,205,295,279
Eastern,Portsmouth City,51740,2133,8683,10816,3382,19606,22988,398139,2574380,2972519,10/01/2014 12:00:00 AM,187,296,275
Eastern,Portsmouth City,51740,2133,9618,11751,3651,20301,23952,448916,2815233,3264149,06/01/2012 12:00:00 AM,210,293,278
Eastern,Portsmouth City,51740,2134,9804,11938,3544,20733,24277,437851,2885954,3323805,06/01/2013 12:00:00 AM,205,294,278
Eastern,Portsmouth City,51740,2135,9820,11955,3624,20835,24459,455926,2914613,3370539,12/01/2012 12:00:00 AM,214,297,282
Eastern,Portsmouth City,51740,2137,9840,11977,3534,20860,24394,432626,2900265,3332891,07/01/2013 12:00:00 AM,202,295,278
Eastern,Portsmouth City,51740,2139,9857,11996,3661,20723,24384,456836,2906334,3363170,09/01/2012 12:00:00 AM,214,295,280
Eastern,Portsmouth City,51740,2142,9902,12044,3652,20955,24607,456359,2932477,3388836,11/01/2012 12:00:00 AM,213,296,281
Eastern,Portsmouth City,51740,2143,9841,11984,3636,20692,24328,450074,2890760,3340834,08/01/2012 12:00:00 AM,210,294,279
Eastern,Portsmouth City,51740,2145,9901,12046,3485,21041,24526,426071,2898946,3325017,08/01/2013 12:00:00 AM,199,293,276
Eastern,Portsmouth City,51740,2154,9396,11550,3712,19906,23618,456753,2736256,3193009,03/01/2012 12:00:00 AM,212,291,276
Eastern,Portsmouth City,51740,2154,9470,11624,3444,20350,23794,379840,2596501,2976341,01/01/2014 12:00:00 AM,176,274,256
Eastern,Portsmouth City,51740,2162,9701,11863,3707,20485,24192,456821,2843563,3300384,07/01/2012 12:00:00 AM,211,293,278
Eastern,Portsmouth City,51740,2164,8282,10446,3401,19008,22409,387716,2441649,2829365,01/01/2015 12:00:00 AM,179,295,271
Eastern,Portsmouth City,51740,2166,8616,10782,3484,19494,22978,409315,2551982,2961297,11/01/2014 12:00:00 AM,189,296,275
Eastern,Portsmouth City,51740,2169,8529,10698,3470,19352,22822,406875,2517426,2924301,12/01/2014 12:00:00 AM,188,295,273
Eastern,Portsmouth City,51740,2172,9704,11876,3487,20704,24191,392710,2657744,3050454,12/01/2013 12:00:00 AM,181,274,257
Eastern,Portsmouth City,51740,2174,9927,12101,3509,21122,24631,423980,2911289,3335269,09/01/2013 12:00:00 AM,195,293,276
Eastern,Portsmouth City,51740,2175,9752,11927,3668,20549,24217,452493,2868192,3320685,04/01/2013 12:00:00 AM,208,294,278
Eastern,Portsmouth City,51740,2175,9791,11966,3494,20864,24358,395768,2681443,3077211,11/01/2013 12:00:00 AM,182,274,257
Eastern,Portsmouth City,51740,2176,9806,11982,3715,20680,24395,461837,2863491,3325328,01/01/2013 12:00:00 AM,212,292,278
Eastern,Portsmouth City,51740,2180,9734,11914,3719,20532,24251,458070,2856255,3314325,03/01/2013 12:00:00 AM,210,293,278
Eastern,Portsmouth City,51740,2187,9333,11520,3791,19788,23579,465018,2701661,3166679,01/01/2012 12:00:00 AM,213,289,275
Eastern,Portsmouth City,51740,2198,9789,11987,3741,20629,24370,465700,2872593,3338293,02/01/2013 12:00:00 AM,212,293,278
Eastern,Portsmouth City,51740,2202,9876,12078,3551,21018,24569,432952,2896519,3329471,10/01/2013 12:00:00 AM,197,293,276
Eastern,Portsmouth City,51740,2203,9361,11564,3817,19901,23718,471306,2742660,3213966,02/01/2012 12:00:00 AM,214,293,278
Eastern,Prince George County,51149,159,1061,1220,246,2462,2708,25114,318311,343425,01/01/2020 12:00:00 AM,158,300,281
Eastern,Prince George County,51149,163,1075,1238,224,2630,2854,25488,337876,363364,07/01/2017 12:00:00 AM,156,314,294
Eastern,Prince George County,51149,165,1074,1239,255,2493,2748,27327,318217,345544,12/01/2019 12:00:00 AM,166,296,279
Eastern,Prince George County,51149,166,1050,1216,253,2414,2667,24773,313892,338665,02/01/2020 12:00:00 AM,149,299,279
Eastern,Prince George County,51149,167,1076,1243,250,2511,2761,26338,315906,342244,11/01/2019 12:00:00 AM,158,294,275
Eastern,Prince George County,51149,169,1078,1247,255,2545,2800,27362,324508,351870,10/01/2019 12:00:00 AM,162,301,282
Eastern,Prince George County,51149,169,1083,1252,245,2647,2892,28100,341501,369601,08/01/2017 12:00:00 AM,166,315,295
Eastern,Prince George County,51149,170,1234,1404,244,2804,3048,54093,584642,638735,01/01/2021 12:00:00 AM,318,474,455
Eastern,Prince George County,51149,170,1262,1432,238,2854,3092,45368,514636,560004,12/01/2020 12:00:00 AM,267,408,391
Eastern,Prince George County,51149,171,1077,1248,250,2636,2886,28887,340165,369052,09/01/2017 12:00:00 AM,169,316,296
Eastern,Prince George County,51149,171,1095,1266,248,2678,2926,28984,341401,370385,06/01/2017 12:00:00 AM,169,312,293
Eastern,Prince George County,51149,171,1122,1293,260,2739,2999,28906,344416,373322,06/01/2016 12:00:00 AM,169,307,289
Eastern,Prince George County,51149,171,1241,1412,233,2811,3044,53494,599917,653411,02/01/2021 12:00:00 AM,313,483,463
Eastern,Prince George County,51149,172,1030,1202,274,2413,2687,31656,317231,348887,03/01/2012 12:00:00 AM,184,308,290
Eastern,Prince George County,51149,172,1080,1252,249,2649,2898,28143,334706,362849,05/01/2017 12:00:00 AM,164,310,290
Eastern,Prince George County,51149,172,1080,1252,252,2566,2818,25926,329981,355907,09/01/2019 12:00:00 AM,151,306,284
Eastern,Prince George County,51149,172,1088,1260,255,2638,2893,27870,340350,368220,10/01/2017 12:00:00 AM,162,313,292
Eastern,Prince George County,51149,173,1073,1246,263,2464,2727,46997,420809,467806,03/01/2020 12:00:00 AM,272,392,375
Eastern,Prince George County,51149,175,1252,1427,245,2840,3085,47411,526142,573553,11/01/2020 12:00:00 AM,271,420,402
Eastern,Prince George County,51149,177,1036,1213,274,2427,2701,31030,320643,351673,04/01/2012 12:00:00 AM,175,310,290
Eastern,Prince George County,51149,177,1099,1276,271,2680,2951,31824,343593,375417,11/01/2017 12:00:00 AM,180,313,294
Eastern,Prince George County,51149,177,1133,1310,269,2759,3028,29569,343008,372577,07/01/2016 12:00:00 AM,167,303,284
Eastern,Prince George County,51149,177,1275,1452,248,2919,3167,47963,524987,572950,10/01/2020 12:00:00 AM,271,412,395
Eastern,Prince George County,51149,178,1034,1212,268,2444,2712,29862,323172,353034,05/01/2012 12:00:00 AM,168,313,291
Eastern,Prince George County,51149,179,1041,1220,295,2431,2726,34776,323824,358600,02/01/2012 12:00:00 AM,194,311,294
Eastern,Prince George County,51149,179,1095,1274,261,2710,2971,30869,345736,376605,04/01/2017 12:00:00 AM,172,316,296
Eastern,Prince George County,51149,179,1099,1278,276,2670,2946,31607,335837,367444,05/01/2016 12:00:00 AM,177,306,288
Eastern,Prince George County,51149,180,1066,1246,275,2603,2878,31074,332065,363139,12/01/2017 12:00:00 AM,173,312,291
Eastern,Prince George County,51149,180,1098,1278,273,2585,2858,26786,333039,359825,08/01/2019 12:00:00 AM,149,303,282
Eastern,Prince George County,51149,181,1026,1207,296,2394,2690,34224,315725,349949,01/01/2012 12:00:00 AM,189,308,290
Eastern,Prince George County,51149,181,1099,1280,260,2711,2971,29923,339941,369864,03/01/2017 12:00:00 AM,165,309,289
Eastern,Prince George County,51149,182,1116,1298,275,2750,3025,32245,347343,379588,11/01/2016 12:00:00 AM,177,311,292
Eastern,Prince George County,51149,182,1214,1396,282,2795,3077,50594,488769,539363,04/01/2020 12:00:00 AM,278,403,386
Eastern,Prince George County,51149,182,1266,1448,286,2907,3193,51743,500054,551797,05/01/2020 12:00:00 AM,284,395,381
Eastern,Prince George County,51149,183,1093,1276,277,2583,2860,27490,328849,356339,07/01/2019 12:00:00 AM,150,301,279
Eastern,Prince George County,51149,183,1123,1306,263,2757,3020,30365,345448,375813,02/01/2017 12:00:00 AM,166,308,288
Eastern,Prince George County,51149,183,1135,1318,284,2783,3067,32125,350047,382172,08/01/2016 12:00:00 AM,176,308,290
Eastern,Prince George County,51149,183,1251,1434,252,2827,3079,54770,585246,640016,03/01/2021 12:00:00 AM,299,468,446
Eastern,Prince George County,51149,183,1271,1454,288,2912,3200,51560,501029,552589,06/01/2020 12:00:00 AM,282,394,380
Eastern,Prince George County,51149,183,1286,1469,278,2950,3228,49314,497914,547228,08/01/2020 12:00:00 AM,269,387,373
Eastern,Prince George County,51149,183,1290,1473,268,2960,3228,47497,511155,558652,09/01/2020 12:00:00 AM,260,396,379
Eastern,Prince George County,51149,184,1068,1252,282,2620,2902,31148,328252,359400,01/01/2018 12:00:00 AM,169,307,287
Eastern,Prince George County,51149,184,1103,1287,270,2612,2882,26226,336151,362377,06/01/2019 12:00:00 AM,143,305,282
Eastern,Prince George County,51149,184,1104,1288,269,2703,2972,31111,338107,369218,12/01/2016 12:00:00 AM,169,306,287
Eastern,Prince George County,51149,184,1106,1290,288,2687,2975,32962,335798,368760,04/01/2016 12:00:00 AM,179,304,286
Eastern,Prince George County,51149,184,1247,1431,262,2828,3090,61855,659451,721306,06/01/2021 12:00:00 AM,336,529,504
Eastern,Prince George County,51149,185,1062,1247,276,2533,2809,31322,327179,358501,06/01/2018 12:00:00 AM,169,308,287
Eastern,Prince George County,51149,185,1074,1259,270,2595,2865,30469,333939,364408,04/01/2018 12:00:00 AM,165,311,289
Eastern,Prince George County,51149,185,1111,1296,286,2729,3015,33654,344674,378328,10/01/2016 12:00:00 AM,182,310,292
Eastern,Prince George County,51149,185,1244,1429,260,2787,3047,60820,644566,705386,04/01/2021 12:00:00 AM,329,518,494
Eastern,Prince George County,51149,186,1296,1482,288,2975,3263,53031,513001,566032,07/01/2020 12:00:00 AM,285,396,382
Eastern,Prince George County,51149,187,1092,1279,280,2575,2855,28498,329159,357657,05/01/2019 12:00:00 AM,152,301,280
Eastern,Prince George County,51149,188,1051,1239,293,2462,2755,33566,326406,359972,06/01/2012 12:00:00 AM,179,311,291
Eastern,Prince George County,51149,188,1064,1252,285,2605,2890,32186,329150,361336,02/01/2018 12:00:00 AM,171,309,289
Eastern,Prince George County,51149,188,1078,1266,274,2627,2901,30965,330552,361517,03/01/2018 12:00:00 AM,165,307,286
Eastern,Prince George County,51149,188,1094,1282,294,2651,2945,33417,327826,361243,03/01/2016 12:00:00 AM,178,300,282
Eastern,Prince George County,51149,188,1117,1305,291,2741,3032,33297,340589,373886,09/01/2016 12:00:00 AM,177,305,287
Eastern,Prince George County,51149,189,1051,1240,275,2502,2777,31103,320478,351581,05/01/2018 12:00:00 AM,165,305,284
Eastern,Prince George County,51149,189,1078,1267,289,2507,2796,29685,330649,360334,04/01/2019 12:00:00 AM,157,307,284
Eastern,Prince George County,51149,189,1114,1303,278,2722,3000,32831,344000,376831,01/01/2017 12:00:00 AM,174,309,289
Eastern,Prince George County,51149,189,1230,1419,268,2753,3021,62484,634330,696814,05/01/2021 12:00:00 AM,331,516,491
Eastern,Prince George County,51149,191,1086,1277,284,2530,2814,31403,332053,363456,03/01/2019 12:00:00 AM,164,306,285
Eastern,Prince George County,51149,192,1072,1264,307,2501,2808,35929,328773,364702,07/01/2012 12:00:00 AM,187,307,289
Eastern,Prince George County,51149,192,1084,1276,280,2624,2904,32155,340411,372566,08/01/2018 12:00:00 AM,167,314,292
Eastern,Prince George County,51149,194,1074,1268,286,2622,2908,32212,342053,374265,09/01/2018 12:00:00 AM,166,318,295
Eastern,Prince George County,51149,195,1082,1277,281,2616,2897,32592,341508,374100,07/01/2018 12:00:00 AM,167,316,293
Eastern,Prince George County,51149,195,1171,1366,316,2735,3051,32567,337037,369604,04/01/2014 12:00:00 AM,167,288,271
Eastern,Prince George County,51149,197,1095,1292,318,2649,2967,36122,329482,365604,02/01/2016 12:00:00 AM,183,301,283
Eastern,Prince George County,51149,197,1162,1359,318,2727,3045,32296,334285,366581,05/01/2014 12:00:00 AM,164,288,270
Eastern,Prince George County,51149,198,1107,1305,331,2688,3019,36178,332731,368909,01/01/2016 12:00:00 AM,183,301,283
Eastern,Prince George County,51149,199,1057,1256,306,2507,2813,32580,329819,362399,02/01/2019 12:00:00 AM,164,312,289
Eastern,Prince George County,51149,200,1166,1366,338,2638,2976,37198,321107,358305,01/01/2014 12:00:00 AM,186,275,262
Eastern,Prince George County,51149,200,1180,1380,337,2683,3020,37842,329712,367554,12/01/2013 12:00:00 AM,189,279,266
Eastern,Prince George County,51149,201,1072,1273,300,2574,2874,32332,336595,368927,12/01/2018 12:00:00 AM,161,314,290
Eastern,Prince George County,51149,201,1076,1277,333,2490,2823,38990,327758,366748,08/01/2012 12:00:00 AM,194,305,287
Eastern,Prince George County,51149,201,1122,1323,335,2701,3036,37872,336110,373982,12/01/2015 12:00:00 AM,188,300,283
Eastern,Prince George County,51149,201,1183,1384,344,2672,3016,38992,332796,371788,11/01/2013 12:00:00 AM,194,281,269
Eastern,Prince George County,51149,202,1087,1289,291,2622,2913,33042,352010,385052,10/01/2018 12:00:00 AM,164,324,299
Eastern,Prince George County,51149,202,1181,1383,340,2715,3055,36722,332712,369434,03/01/2014 12:00:00 AM,182,282,267
Eastern,Prince George County,51149,203,1194,1397,354,2700,3054,43395,359750,403145,10/01/2013 12:00:00 AM,214,301,289
Eastern,Prince George County,51149,204,1089,1293,299,2583,2882,31950,340823,372773,01/01/2019 12:00:00 AM,157,313,288
Eastern,Prince George County,51149,205,1092,1297,337,2534,2871,39727,335548,375275,09/01/2012 12:00:00 AM,194,307,289
Eastern,Prince George County,51149,205,1122,1327,339,2719,3058,36674,340660,377334,11/01/2015 12:00:00 AM,179,304,284
Eastern,Prince George County,51149,205,1169,1374,336,2739,3075,35415,333362,368777,06/01/2014 12:00:00 AM,173,285,268
Eastern,Prince George County,51149,206,1159,1365,355,2660,3015,39049,327829,366878,02/01/2014 12:00:00 AM,190,283,269
Eastern,Prince George County,51149,207,1185,1392,326,2788,3114,35048,336924,371972,07/01/2014 12:00:00 AM,169,284,267
Eastern,Prince George County,51149,208,1078,1286,322,2616,2938,36089,343031,379120,11/01/2018 12:00:00 AM,174,318,295
Eastern,Prince George County,51149,210,1076,1286,340,2580,2920,37055,323798,360853,05/01/2015 12:00:00 AM,176,301,281
Eastern,Prince George County,51149,211,1154,1365,344,2730,3074,38506,347658,386164,10/01/2014 12:00:00 AM,182,301,283
Eastern,Prince George County,51149,211,1158,1369,336,2741,3077,35798,332015,367813,08/01/2014 12:00:00 AM,170,287,269
Eastern,Prince George County,51149,212,1090,1302,350,2623,2973,38715,328352,367067,06/01/2015 12:00:00 AM,183,301,282
Eastern,Prince George County,51149,212,1110,1322,367,2562,2929,43416,339976,383392,12/01/2012 12:00:00 AM,205,306,290
Eastern,Prince George County,51149,212,1158,1370,345,2722,3067,36581,330398,366979,09/01/2014 12:00:00 AM,173,285,268
Eastern,Prince George County,51149,212,1189,1401,382,2669,3051,46111,353933,400044,09/01/2013 12:00:00 AM,218,298,286
Eastern,Prince George County,51149,213,1163,1376,365,2666,3031,41905,354069,395974,04/01/2013 12:00:00 AM,197,304,288
Eastern,Prince George County,51149,214,1063,1277,353,2543,2896,38100,314866,352966,04/01/2015 12:00:00 AM,178,296,276
Eastern,Prince George County,51149,214,1104,1318,356,2660,3016,38508,335594,374102,10/01/2015 12:00:00 AM,180,304,284
Eastern,Prince George County,51149,214,1111,1325,349,2721,3070,39078,341737,380815,08/01/2015 12:00:00 AM,183,308,287
Eastern,Prince George County,51149,214,1122,1336,358,2603,2961,42969,342905,385874,11/01/2012 12:00:00 AM,201,306,289
Eastern,Prince George County,51149,215,1095,1310,359,2665,3024,40051,332163,372214,07/01/2015 12:00:00 AM,186,303,284
Eastern,Prince George County,51149,215,1155,1370,375,2635,3010,44174,347761,391935,03/01/2013 12:00:00 AM,205,301,286
Eastern,Prince George County,51149,215,1176,1391,376,2680,3056,44251,353872,398123,07/01/2013 12:00:00 AM,206,301,286
Eastern,Prince George County,51149,216,1049,1265,357,2525,2882,39179,313118,352297,03/01/2015 12:00:00 AM,181,298,278
Eastern,Prince George County,51149,217,1109,1326,360,2586,2946,43063,343184,386247,10/01/2012 12:00:00 AM,198,309,291
Eastern,Prince George County,51149,217,1184,1401,389,2686,3075,45861,355783,401644,08/01/2013 12:00:00 AM,211,300,287
Eastern,Prince George County,51149,218,1135,1353,382,2602,2984,44577,340438,385015,01/01/2013 12:00:00 AM,204,300,285
Eastern,Prince George County,51149,218,1184,1402,376,2700,3076,43005,360055,403060,05/01/2013 12:00:00 AM,197,304,287
Eastern,Prince George County,51149,219,1063,1282,370,2563,2933,40727,321208,361935,02/01/2015 12:00:00 AM,186,302,282
Eastern,Prince George County,51149,219,1161,1380,385,2640,3025,44972,350774,395746,02/01/2013 12:00:00 AM,205,302,287
Eastern,Prince George County,51149,219,1178,1397,377,2692,3069,43595,358145,401740,06/01/2013 12:00:00 AM,199,304,288
Eastern,Prince George County,51149,220,1150,1370,364,2760,3124,40230,350280,390510,11/01/2014 12:00:00 AM,183,305,285
Eastern,Prince George County,51149,221,1117,1338,376,2678,3054,41229,339989,381218,09/01/2015 12:00:00 AM,187,304,285
Eastern,Prince George County,51149,226,1097,1323,378,2620,2998,41611,325614,367225,01/01/2015 12:00:00 AM,184,297,278
Eastern,Prince George County,51149,232,1122,1354,387,2701,3088,43591,340088,383679,12/01/2014 12:00:00 AM,188,303,283
Eastern,Southampton County,51175,231,906,1137,277,1934,2211,62636,409152,471788,02/01/2021 12:00:00 AM,271,452,415
Eastern,Southampton County,51175,233,910,1143,286,1936,2222,68674,442122,510796,04/01/2021 12:00:00 AM,295,486,447
Eastern,Southampton County,51175,234,891,1125,289,1902,2191,69006,427047,496053,05/01/2021 12:00:00 AM,295,479,441
Eastern,Southampton County,51175,235,908,1143,293,1915,2208,66063,401562,467625,03/01/2021 12:00:00 AM,281,442,409
Eastern,Southampton County,51175,236,926,1162,293,1986,2279,58529,363211,421740,12/01/2020 12:00:00 AM,248,392,363
Eastern,Southampton County,51175,237,903,1140,296,1954,2250,65555,403447,469002,01/01/2021 12:00:00 AM,277,447,411
Eastern,Southampton County,51175,239,893,1132,300,1911,2211,70965,425013,495978,06/01/2021 12:00:00 AM,297,476,438
Eastern,Southampton County,51175,239,931,1170,297,1991,2288,57837,367870,425707,11/01/2020 12:00:00 AM,242,395,364
Eastern,Southampton County,51175,242,892,1134,308,1994,2302,30078,238475,268553,07/01/2018 12:00:00 AM,124,267,237
Eastern,Southampton County,51175,244,1011,1255,310,2148,2458,30171,275218,305389,08/01/2017 12:00:00 AM,124,272,243
Eastern,Southampton County,51175,244,897,1141,314,2025,2339,30780,246765,277545,08/01/2018 12:00:00 AM,126,275,243
Eastern,Southampton County,51175,245,888,1133,325,1978,2303,34365,233100,267465,10/01/2018 12:00:00 AM,140,263,236
Eastern,Southampton County,51175,246,879,1125,315,1933,2248,29728,232312,262040,02/01/2018 12:00:00 AM,121,264,233
Eastern,Southampton County,51175,246,883,1129,318,1986,2304,30273,238546,268819,06/01/2018 12:00:00 AM,123,270,238
Eastern,Southampton County,51175,246,892,1138,324,2000,2324,31426,241557,272983,09/01/2018 12:00:00 AM,128,271,240
Eastern,Southampton County,51175,246,969,1215,310,2132,2442,31333,259218,290551,10/01/2017 12:00:00 AM,127,268,239
Eastern,Southampton County,51175,247,893,1140,328,2017,2345,34542,241135,275677,11/01/2018 12:00:00 AM,140,270,242
Eastern,Southampton County,51175,247,931,1178,318,2062,2380,33780,244416,278196,11/01/2017 12:00:00 AM,137,263,236
Eastern,Southampton County,51175,248,1004,1252,309,2095,2404,30433,259069,289502,07/01/2017 12:00:00 AM,123,258,231
Eastern,Southampton County,51175,248,1008,1256,310,2103,2413,30681,266138,296819,05/01/2017 12:00:00 AM,124,264,236
Eastern,Southampton County,51175,249,851,1100,327,1923,2250,32480,223126,255606,04/01/2019 12:00:00 AM,130,262,232
Eastern,Southampton County,51175,249,890,1139,320,1966,2286,30216,241522,271738,01/01/2018 12:00:00 AM,121,271,239
Eastern,Southampton County,51175,249,922,1171,320,1969,2289,62623,362804,425427,10/01/2020 12:00:00 AM,251,393,363
Eastern,Southampton County,51175,249,955,1204,314,2065,2379,31330,254996,286326,09/01/2017 12:00:00 AM,126,267,238
Eastern,Southampton County,51175,250,1004,1254,316,2100,2416,31081,262364,293445,04/01/2017 12:00:00 AM,124,261,234
Eastern,Southampton County,51175,250,1042,1292,321,2188,2509,31445,277455,308900,03/01/2017 12:00:00 AM,126,266,239
Eastern,Southampton County,51175,250,796,1046,315,1746,2061,30662,199243,229905,02/01/2020 12:00:00 AM,123,250,220
Eastern,Southampton County,51175,250,844,1094,323,1911,2234,32254,216237,248491,05/01/2019 12:00:00 AM,129,256,227
Eastern,Southampton County,51175,250,886,1136,321,2001,2322,30456,238648,269104,04/01/2018 12:00:00 AM,122,269,237
Eastern,Southampton County,51175,250,892,1142,324,2010,2334,30262,243407,273669,03/01/2018 12:00:00 AM,121,273,240
Eastern,Southampton County,51175,250,902,1152,318,2014,2332,31663,240875,272538,12/01/2017 12:00:00 AM,127,267,237
Eastern,Southampton County,51175,251,882,1133,325,1998,2323,30808,240300,271108,05/01/2018 12:00:00 AM,123,272,239
Eastern,Southampton County,51175,251,924,1175,318,1952,2270,58890,334813,393703,09/01/2020 12:00:00 AM,235,362,335
Eastern,Southampton County,51175,252,870,1122,329,1944,2273,33229,227250,260479,03/01/2019 12:00:00 AM,132,261,232
Eastern,Southampton County,51175,253,842,1095,333,1899,2232,33989,219416,253405,06/01/2019 12:00:00 AM,134,261,231
Eastern,Southampton County,51175,253,888,1141,334,2004,2338,35413,233736,269149,12/01/2018 12:00:00 AM,140,263,236
Eastern,Southampton County,51175,253,909,1162,330,1951,2281,60917,338659,399576,06/01/2020 12:00:00 AM,241,373,344
Eastern,Southampton County,51175,254,1025,1279,319,2138,2457,30540,267835,298375,06/01/2017 12:00:00 AM,120,261,233
Eastern,Southampton County,51175,254,799,1053,328,1769,2097,60774,304871,365645,03/01/2020 12:00:00 AM,239,382,347
Eastern,Southampton County,51175,254,824,1078,333,1809,2142,34196,213218,247414,02/01/2019 12:00:00 AM,135,259,230
Eastern,Southampton County,51175,255,925,1180,328,1927,2255,61849,339073,400922,08/01/2020 12:00:00 AM,243,367,340
Eastern,Southampton County,51175,257,881,1138,340,1980,2320,36214,252110,288324,01/01/2019 12:00:00 AM,141,286,253
Eastern,Southampton County,51175,257,885,1142,339,1915,2254,62780,331591,394371,04/01/2020 12:00:00 AM,244,375,345
Eastern,Southampton County,51175,258,1072,1330,332,2269,2601,32816,273671,306487,01/01/2017 12:00:00 AM,127,255,230
Eastern,Southampton County,51175,258,1197,1455,348,2506,2854,32036,291312,323348,09/01/2014 12:00:00 AM,124,243,222
Eastern,Southampton County,51175,259,1242,1501,346,2597,2943,32419,306132,338551,05/01/2014 12:00:00 AM,125,246,226
Eastern,Southampton County,51175,259,816,1075,323,1809,2132,31694,209244,240938,11/01/2019 12:00:00 AM,122,256,224
Eastern,Southampton County,51175,259,838,1097,337,1839,2176,34059,217646,251705,07/01/2019 12:00:00 AM,132,260,229
Eastern,Southampton County,51175,259,911,1170,339,1980,2319,62567,350964,413531,05/01/2020 12:00:00 AM,242,385,353
Eastern,Southampton County,51175,259,940,1199,336,1977,2313,62217,343799,406016,07/01/2020 12:00:00 AM,240,366,339
Eastern,Southampton County,51175,260,1078,1338,338,2290,2628,33029,276446,309475,12/01/2016 12:00:00 AM,127,256,231
Eastern,Southampton County,51175,260,1226,1486,349,2596,2945,31817,306770,338587,06/01/2014 12:00:00 AM,122,250,228
Eastern,Southampton County,51175,260,810,1070,333,1790,2123,33568,203064,236632,12/01/2019 12:00:00 AM,129,251,221
Eastern,Southampton County,51175,260,841,1101,330,1874,2204,33243,222127,255370,09/01/2019 12:00:00 AM,128,264,232
Eastern,Southampton County,51175,261,1076,1337,330,2287,2617,32443,280383,312826,02/01/2017 12:00:00 AM,124,261,234
Eastern,Southampton County,51175,261,1128,1389,368,2394,2762,39756,287048,326804,12/01/2014 12:00:00 AM,152,254,235
Eastern,Southampton County,51175,261,1212,1473,351,2578,2929,32682,303720,336402,08/01/2014 12:00:00 AM,125,251,228
Eastern,Southampton County,51175,261,804,1065,332,1776,2108,33849,204627,238476,01/01/2020 12:00:00 AM,130,255,224
Eastern,Southampton County,51175,261,823,1084,330,1812,2142,32693,208060,240753,10/01/2019 12:00:00 AM,125,253,222
Eastern,Southampton County,51175,262,1069,1331,368,2291,2659,37472,272617,310089,02/01/2015 12:00:00 AM,143,255,233
Eastern,Southampton County,51175,262,825,1087,335,1819,2154,34497,209290,243787,08/01/2019 12:00:00 AM,132,254,224
Eastern,Southampton County,51175,263,1081,1344,374,2310,2684,38579,273352,311931,01/01/2015 12:00:00 AM,147,253,232
Eastern,Southampton County,51175,264,1090,1354,345,2325,2670,33881,280726,314607,09/01/2016 12:00:00 AM,128,258,232
Eastern,Southampton County,51175,264,1090,1354,351,2318,2669,34324,282774,317098,11/01/2016 12:00:00 AM,130,259,234
Eastern,Southampton County,51175,264,1148,1412,370,2394,2764,38839,289789,328628,11/01/2014 12:00:00 AM,147,252,233
Eastern,Southampton County,51175,264,1215,1479,355,2580,2935,32444,305732,338176,07/01/2014 12:00:00 AM,123,252,229
Eastern,Southampton County,51175,265,1169,1434,364,2435,2799,36993,295871,332864,10/01/2014 12:00:00 AM,140,253,232
Eastern,Southampton County,51175,265,1234,1499,372,2568,2940,34373,301406,335779,04/01/2014 12:00:00 AM,130,244,224
Eastern,Southampton County,51175,267,1067,1334,364,2278,2642,35882,271107,306989,05/01/2015 12:00:00 AM,134,254,230
Eastern,Southampton County,51175,267,1084,1351,350,2288,2638,35184,278432,313616,10/01/2016 12:00:00 AM,132,257,232
Eastern,Southampton County,51175,267,1087,1354,362,2322,2684,37794,287511,325305,06/01/2016 12:00:00 AM,142,264,240
Eastern,Southampton County,51175,268,1084,1352,361,2308,2669,34607,280132,314739,06/01/2015 12:00:00 AM,129,258,233
Eastern,Southampton County,51175,268,1100,1368,368,2344,2712,36042,288060,324102,08/01/2015 12:00:00 AM,134,262,237
Eastern,Southampton County,51175,268,1104,1372,364,2356,2720,36731,281832,318563,11/01/2015 12:00:00 AM,137,255,232
Eastern,Southampton County,51175,269,1075,1344,362,2294,2656,37642,283885,321527,07/01/2016 12:00:00 AM,140,264,239
Eastern,Southampton County,51175,269,1101,1370,367,2336,2703,39131,285907,325038,04/01/2016 12:00:00 AM,145,260,237
Eastern,Southampton County,51175,269,1110,1379,366,2360,2726,35248,286930,322178,07/01/2015 12:00:00 AM,131,258,234
Eastern,Southampton County,51175,270,1057,1327,375,2261,2636,36925,271121,308046,03/01/2015 12:00:00 AM,137,257,232
Eastern,Southampton County,51175,270,1212,1482,390,2513,2903,36895,300028,336923,03/01/2014 12:00:00 AM,137,248,227
Eastern,Southampton County,51175,271,1053,1324,371,2272,2643,36998,268434,305432,04/01/2015 12:00:00 AM,137,255,231
Eastern,Southampton County,51175,272,1089,1361,378,2328,2706,38398,280925,319323,10/01/2015 12:00:00 AM,141,258,235
Eastern,Southampton County,51175,272,1098,1370,375,2351,2726,38101,286655,324756,09/01/2015 12:00:00 AM,140,261,237
Eastern,Southampton County,51175,272,1106,1378,375,2336,2711,40108,284562,324670,05/01/2016 12:00:00 AM,147,257,236
Eastern,Southampton County,51175,273,1089,1362,365,2343,2708,37770,286034,323804,08/01/2016 12:00:00 AM,138,263,238
Eastern,Southampton County,51175,273,1094,1367,370,2342,2712,37608,277061,314669,12/01/2015 12:00:00 AM,138,253,230
Eastern,Southampton County,51175,273,1094,1367,376,2301,2677,38474,279962,318436,02/01/2016 12:00:00 AM,141,256,233
Eastern,Southampton County,51175,274,1096,1370,382,2321,2703,39770,282117,321887,03/01/2016 12:00:00 AM,145,257,235
Eastern,Southampton County,51175,275,1091,1366,374,2331,2705,37840,276999,314839,01/01/2016 12:00:00 AM,138,254,230
Eastern,Southampton County,51175,277,1204,1481,407,2543,2950,40541,302832,343373,12/01/2013 12:00:00 AM,146,252,232
Eastern,Southampton County,51175,279,1215,1494,414,2554,2968,41317,300432,341749,02/01/2014 12:00:00 AM,148,247,229
Eastern,Southampton County,51175,280,1216,1496,415,2558,2973,41002,300617,341619,01/01/2014 12:00:00 AM,146,247,228
Eastern,Southampton County,51175,281,1219,1500,410,2591,3001,41206,307986,349192,11/01/2013 12:00:00 AM,147,253,233
Eastern,Southampton County,51175,282,1239,1521,419,2661,3080,44719,339685,384404,05/01/2013 12:00:00 AM,159,274,253
Eastern,Southampton County,51175,283,1241,1524,418,2673,3091,44606,342049,386655,04/01/2013 12:00:00 AM,158,276,254
Eastern,Southampton County,51175,286,1236,1522,426,2603,3029,46248,335310,381558,10/01/2013 12:00:00 AM,162,271,251
Eastern,Southampton County,51175,287,1230,1517,420,2645,3065,44580,337215,381795,06/01/2013 12:00:00 AM,155,274,252
Eastern,Southampton County,51175,287,1239,1526,428,2606,3034,45299,334963,380262,08/01/2013 12:00:00 AM,158,270,249
Eastern,Southampton County,51175,288,1243,1531,421,2616,3037,45347,336328,381675,09/01/2013 12:00:00 AM,157,271,249
Eastern,Southampton County,51175,289,1231,1520,434,2600,3034,46848,333106,379954,07/01/2013 12:00:00 AM,162,271,250
Eastern,Southampton County,51175,290,1241,1531,443,2632,3075,48961,337824,386785,11/01/2012 12:00:00 AM,169,272,253
Eastern,Southampton County,51175,291,1241,1532,437,2649,3086,47421,341929,389350,12/01/2012 12:00:00 AM,163,276,254
Eastern,Southampton County,51175,293,1230,1523,446,2598,3044,47881,334081,381962,10/01/2012 12:00:00 AM,163,272,251
Eastern,Southampton County,51175,294,1200,1494,464,2577,3041,51690,327556,379246,07/01/2012 12:00:00 AM,176,273,254
Eastern,Southampton County,51175,296,1186,1482,470,2529,2999,53340,322395,375735,06/01/2012 12:00:00 AM,180,272,254
Eastern,Southampton County,51175,297,1188,1485,477,2520,2997,53418,323655,377073,04/01/2012 12:00:00 AM,180,272,254
Eastern,Southampton County,51175,297,1193,1490,474,2531,3005,52761,326726,379487,05/01/2012 12:00:00 AM,178,274,255
Eastern,Southampton County,51175,298,1224,1522,469,2606,3075,52668,330979,383647,08/01/2012 12:00:00 AM,177,270,252
Eastern,Southampton County,51175,298,1229,1527,468,2589,3057,52420,333203,385623,09/01/2012 12:00:00 AM,176,271,253
Eastern,Southampton County,51175,298,1234,1532,457,2628,3085,50330,334530,384860,03/01/2013 12:00:00 AM,169,271,251
Eastern,Southampton County,51175,299,1225,1524,468,2599,3067,50982,329225,380207,01/01/2013 12:00:00 AM,171,269,249
Eastern,Southampton County,51175,301,1229,1530,471,2615,3086,52762,331885,384647,02/01/2013 12:00:00 AM,175,270,251
Eastern,Southampton County,51175,302,1163,1465,488,2463,2951,55504,315415,370919,02/01/2012 12:00:00 AM,184,271,253
Eastern,Southampton County,51175,302,1187,1489,478,2520,2998,53282,320697,373979,03/01/2012 12:00:00 AM,176,270,251
Eastern,Southampton County,51175,303,1159,1462,502,2466,2968,57618,312947,370565,01/01/2012 12:00:00 AM,190,270,253
Eastern,Suffolk City,51800,1103,4109,5212,1402,9059,10461,315951,1927436,2243387,02/01/2021 12:00:00 AM,286,469,430
Eastern,Suffolk City,51800,1126,3688,4814,1484,8225,9709,142442,992632,1135074,02/01/2019 12:00:00 AM,127,269,236
Eastern,Suffolk City,51800,1129,4058,5187,1487,8856,10343,351528,1999316,2350844,04/01/2021 12:00:00 AM,311,493,453
Eastern,Suffolk City,51800,1129,4112,5241,1461,9020,10481,325315,1888821,2214136,03/01/2021 12:00:00 AM,288,459,422
Eastern,Suffolk City,51800,1134,3773,4907,1492,8489,9981,143566,1026744,1170310,02/01/2020 12:00:00 AM,127,272,238
Eastern,Suffolk City,51800,1138,4027,5165,1506,8779,10285,354552,1978301,2332853,05/01/2021 12:00:00 AM,312,491,452
Eastern,Suffolk City,51800,1142,4052,5194,1511,8903,10414,333519,1854150,2187669,01/01/2021 12:00:00 AM,292,458,421
Eastern,Suffolk City,51800,1144,3811,4955,1494,8585,10079,141105,1035443,1176548,01/01/2020 12:00:00 AM,123,272,237
Eastern,Suffolk City,51800,1144,3815,4959,1523,8579,10102,278437,1460271,1738708,03/01/2020 12:00:00 AM,243,383,351
Eastern,Suffolk City,51800,1150,4048,5198,1496,9420,10916,144573,1160672,1305245,04/01/2017 12:00:00 AM,126,287,251
Eastern,Suffolk City,51800,1153,3850,5003,1502,8656,10158,144713,1053557,1198270,11/01/2019 12:00:00 AM,126,274,240
Eastern,Suffolk City,51800,1154,4052,5206,1495,9427,10922,146238,1171878,1318116,07/01/2017 12:00:00 AM,127,289,253
Eastern,Suffolk City,51800,1156,4030,5186,1516,9136,10652,142565,1099382,1241947,04/01/2018 12:00:00 AM,123,273,239
Eastern,Suffolk City,51800,1157,3898,5055,1489,8921,10410,148674,1091233,1239907,10/01/2018 12:00:00 AM,128,280,245
Eastern,Suffolk City,51800,1157,3904,5061,1494,8840,10334,149409,1077464,1226873,12/01/2018 12:00:00 AM,129,276,242
Eastern,Suffolk City,51800,1157,3996,5153,1543,8737,10280,363890,1976150,2340040,06/01/2021 12:00:00 AM,315,495,454
Eastern,Suffolk City,51800,1158,4109,5267,1507,9493,11000,148306,1187356,1335662,08/01/2017 12:00:00 AM,128,289,254
Eastern,Suffolk City,51800,1159,3894,5053,1539,8737,10276,152510,1062978,1215488,12/01/2019 12:00:00 AM,132,273,241
Eastern,Suffolk City,51800,1160,4048,5208,1516,9376,10892,147993,1162419,1310412,05/01/2017 12:00:00 AM,128,287,252
Eastern,Suffolk City,51800,1161,4031,5192,1509,9153,10662,145146,1108439,1253585,06/01/2018 12:00:00 AM,125,275,241
Eastern,Suffolk City,51800,1162,4074,5236,1520,9459,10979,150836,1170460,1321296,06/01/2017 12:00:00 AM,130,287,252
Eastern,Suffolk City,51800,1162,4121,5283,1515,9543,11058,147639,1181356,1328995,03/01/2017 12:00:00 AM,127,287,252
Eastern,Suffolk City,51800,1162,5217,6379,1675,11223,12898,178921,1479249,1658170,04/01/2012 12:00:00 AM,154,284,260
Eastern,Suffolk City,51800,1163,4006,5169,1483,9193,10676,142915,1117457,1260372,08/01/2018 12:00:00 AM,123,279,244
Eastern,Suffolk City,51800,1163,4055,5218,1524,9232,10756,144616,1122765,1267381,03/01/2018 12:00:00 AM,124,277,243
Eastern,Suffolk City,51800,1163,4073,5236,1546,8927,10473,303385,1627084,1930469,12/01/2020 12:00:00 AM,261,399,369
Eastern,Suffolk City,51800,1164,3847,5011,1515,8680,10195,142661,1049813,1192474,08/01/2019 12:00:00 AM,123,273,238
Eastern,Suffolk City,51800,1164,4043,5207,1523,9187,10710,143635,1120466,1264101,05/01/2018 12:00:00 AM,123,277,243
Eastern,Suffolk City,51800,1165,3847,5012,1552,8653,10205,146444,1047517,1193961,07/01/2019 12:00:00 AM,126,272,238
Eastern,Suffolk City,51800,1166,4106,5272,1552,9062,10614,300852,1662250,1963102,11/01/2020 12:00:00 AM,258,405,372
Eastern,Suffolk City,51800,1167,3854,5021,1540,8619,10159,149283,1044010,1193293,05/01/2019 12:00:00 AM,128,271,238
Eastern,Suffolk City,51800,1167,4038,5205,1499,9258,10757,142495,1132525,1275020,07/01/2018 12:00:00 AM,122,280,245
Eastern,Suffolk City,51800,1167,4052,5219,1529,9314,10843,143434,1126029,1269463,01/01/2018 12:00:00 AM,123,278,243
Eastern,Suffolk City,51800,1168,3888,5056,1546,8777,10323,150741,1068179,1218920,10/01/2019 12:00:00 AM,129,275,241
Eastern,Suffolk City,51800,1170,3906,5076,1512,8965,10477,147930,1090903,1238833,09/01/2018 12:00:00 AM,126,279,244
Eastern,Suffolk City,51800,1171,3838,5009,1566,8623,10189,147857,1049551,1197408,06/01/2019 12:00:00 AM,126,273,239
Eastern,Suffolk City,51800,1171,3948,5119,1511,8903,10414,147274,1134706,1281980,01/01/2019 12:00:00 AM,126,287,250
Eastern,Suffolk City,51800,1171,4054,5225,1541,9193,10734,145834,1112939,1258773,02/01/2018 12:00:00 AM,125,275,241
Eastern,Suffolk City,51800,1171,4058,5229,1535,9353,10888,153480,1148244,1301724,10/01/2017 12:00:00 AM,131,283,249
Eastern,Suffolk City,51800,1171,4064,5235,1525,9417,10942,151390,1173438,1324828,09/01/2017 12:00:00 AM,129,289,253
Eastern,Suffolk City,51800,1172,3920,5092,1557,8781,10338,149213,1053119,1202332,03/01/2019 12:00:00 AM,127,269,236
Eastern,Suffolk City,51800,1172,5207,6379,1711,11229,12940,181197,1480915,1662112,03/01/2012 12:00:00 AM,155,284,261
Eastern,Suffolk City,51800,1173,3877,5050,1509,8836,10345,151033,1077802,1228835,11/01/2018 12:00:00 AM,129,278,243
Eastern,Suffolk City,51800,1173,5222,6395,1736,11289,13025,185683,1494703,1680386,02/01/2012 12:00:00 AM,158,286,263
Eastern,Suffolk City,51800,1174,4146,5320,1579,9242,10821,289925,1591392,1881317,04/01/2020 12:00:00 AM,247,384,354
Eastern,Suffolk City,51800,1174,5231,6405,1738,11299,13037,185972,1482399,1668371,01/01/2012 12:00:00 AM,158,283,260
Eastern,Suffolk City,51800,1175,3896,5071,1556,8791,10347,150635,1068634,1219269,04/01/2019 12:00:00 AM,128,274,240
Eastern,Suffolk City,51800,1177,4168,5345,1566,9172,10738,303668,1668402,1972070,10/01/2020 12:00:00 AM,258,400,369
Eastern,Suffolk City,51800,1178,4036,5214,1560,9351,10911,153695,1142736,1296431,11/01/2017 12:00:00 AM,130,283,249
Eastern,Suffolk City,51800,1178,5339,6517,1686,11465,13151,183310,1522586,1705896,08/01/2012 12:00:00 AM,156,285,262
Eastern,Suffolk City,51800,1180,4264,5444,1579,10072,11651,160440,1245552,1405992,10/01/2016 12:00:00 AM,136,292,258
Eastern,Suffolk City,51800,1181,3892,5073,1555,8780,10335,146440,1064936,1211376,09/01/2019 12:00:00 AM,124,274,239
Eastern,Suffolk City,51800,1182,5243,6425,1719,11295,13014,183075,1493659,1676734,06/01/2012 12:00:00 AM,155,285,261
Eastern,Suffolk City,51800,1183,4217,5400,1560,9805,11365,149569,1188878,1338447,01/01/2017 12:00:00 AM,126,282,248
Eastern,Suffolk City,51800,1184,4051,5235,1571,9355,10926,156426,1130783,1287209,12/01/2017 12:00:00 AM,132,279,246
Eastern,Suffolk City,51800,1185,5216,6401,1745,11205,12950,188808,1477585,1666393,05/01/2012 12:00:00 AM,159,283,260
Eastern,Suffolk City,51800,1186,4244,5430,1577,9353,10930,290669,1606186,1896855,09/01/2020 12:00:00 AM,245,378,349
Eastern,Suffolk City,51800,1186,4247,5433,1570,9883,11453,150870,1206587,1357457,02/01/2017 12:00:00 AM,127,284,250
Eastern,Suffolk City,51800,1190,4190,5380,1592,9853,11445,155176,1187423,1342599,11/01/2016 12:00:00 AM,130,283,250
Eastern,Suffolk City,51800,1190,4352,5542,1599,10272,11871,153530,1222755,1376285,08/01/2016 12:00:00 AM,129,281,248
Eastern,Suffolk City,51800,1191,4300,5491,1613,9484,11097,298565,1657149,1955714,05/01/2020 12:00:00 AM,251,385,356
Eastern,Suffolk City,51800,1191,4348,5539,1603,10257,11860,154551,1214245,1368796,06/01/2016 12:00:00 AM,130,279,247
Eastern,Suffolk City,51800,1192,4302,5494,1601,10115,11716,154044,1206851,1360895,07/01/2016 12:00:00 AM,129,281,248
Eastern,Suffolk City,51800,1193,5239,6432,1760,11251,13011,201371,1543311,1744682,07/01/2012 12:00:00 AM,169,295,271
Eastern,Suffolk City,51800,1194,4541,5735,1629,10578,12207,157413,1274124,1431537,10/01/2015 12:00:00 AM,132,281,250
Eastern,Suffolk City,51800,1195,4354,5549,1616,10252,11868,154121,1215320,1369441,03/01/2016 12:00:00 AM,129,279,247
Eastern,Suffolk City,51800,1197,4285,5482,1613,10130,11743,157201,1202218,1359419,09/01/2016 12:00:00 AM,131,281,248
Eastern,Suffolk City,51800,1197,4310,5507,1618,10156,11774,154921,1198558,1353479,04/01/2016 12:00:00 AM,129,278,246
Eastern,Suffolk City,51800,1198,4320,5518,1623,10164,11787,158008,1205617,1363625,05/01/2016 12:00:00 AM,132,279,247
Eastern,Suffolk City,51800,1198,4402,5600,1644,10347,11991,156955,1223499,1380454,01/01/2016 12:00:00 AM,131,278,247
Eastern,Suffolk City,51800,1199,4344,5543,1617,9539,11156,297427,1651275,1948702,06/01/2020 12:00:00 AM,248,380,352
Eastern,Suffolk City,51800,1199,4515,5714,1643,10541,12184,159800,1268131,1427931,11/01/2015 12:00:00 AM,133,281,250
Eastern,Suffolk City,51800,1199,5311,6510,1751,11348,13099,189736,1507594,1697330,09/01/2012 12:00:00 AM,158,284,261
Eastern,Suffolk City,51800,1200,4576,5776,1652,10585,12237,160788,1273486,1434274,09/01/2015 12:00:00 AM,134,278,248
Eastern,Suffolk City,51800,1201,4577,5778,1658,10592,12250,160933,1278265,1439198,08/01/2015 12:00:00 AM,134,279,249
Eastern,Suffolk City,51800,1201,4588,5789,1635,10602,12237,155070,1282853,1437923,07/01/2015 12:00:00 AM,129,280,248
Eastern,Suffolk City,51800,1202,4305,5507,1612,9484,11096,301983.5,1639098.5,1941082,08/01/2020 12:00:00 AM,251,381,352
Eastern,Suffolk City,51800,1204,4670,5874,1671,10711,12382,160056,1292701,1452757,04/01/2015 12:00:00 AM,133,277,247
Eastern,Suffolk City,51800,1208,4157,5365,1621,9769,11390,158703,1177121,1335824,12/01/2016 12:00:00 AM,131,283,249
Eastern,Suffolk City,51800,1208,4439,5647,1692,10376,12068,163348,1238031,1401379,12/01/2015 12:00:00 AM,135,279,248
Eastern,Suffolk City,51800,1209,4608,5817,1666,10638,12304,159657,1289465,1449122,06/01/2015 12:00:00 AM,132,280,249
Eastern,Suffolk City,51800,1209,5449,6658,1780,11655,13435,170253,1430107,1600360,04/01/2014 12:00:00 AM,141,262,240
Eastern,Suffolk City,51800,1210,4388,5598,1666,10324,11990,158988,1222501,1381489,02/01/2016 12:00:00 AM,131,279,247
Eastern,Suffolk City,51800,1211,4615,5826,1684,10623,12307,161082,1282827,1443909,05/01/2015 12:00:00 AM,133,278,248
Eastern,Suffolk City,51800,1211,4667,5878,1703,10704,12407,164174,1294895,1459069,03/01/2015 12:00:00 AM,136,277,248
Eastern,Suffolk City,51800,1214,4343,5557,1633,9549,11182,301253,1648931,1950184,07/01/2020 12:00:00 AM,248,380,351
Eastern,Suffolk City,51800,1218,5377,6595,1764,11464,13228,184325,1518885,1703210,02/01/2013 12:00:00 AM,151,282,258
Eastern,Suffolk City,51800,1219,5382,6601,1760,11519,13279,184274,1521798,1706072,03/01/2013 12:00:00 AM,151,283,258
Eastern,Suffolk City,51800,1219,5405,6624,1788,11547,13335,188310,1532960,1721270,04/01/2013 12:00:00 AM,154,284,260
Eastern,Suffolk City,51800,1221,5338,6559,1785,11380,13165,194279,1514629,1708908,10/01/2012 12:00:00 AM,159,284,261
Eastern,Suffolk City,51800,1221,5384,6605,1797,11570,13367,170452,1410559,1581011,05/01/2014 12:00:00 AM,140,262,239
Eastern,Suffolk City,51800,1224,5293,6517,1781,11449,13230,169354,1392993,1562347,06/01/2014 12:00:00 AM,138,263,240
Eastern,Suffolk City,51800,1224,5314,6538,1827,11327,13154,199148,1503171,1702319,11/01/2012 12:00:00 AM,163,283,260
Eastern,Suffolk City,51800,1224,5438,6662,1811,11630,13441,174173,1417216,1591389,03/01/2014 12:00:00 AM,142,261,239
Eastern,Suffolk City,51800,1226,5311,6537,1809,11331,13140,195713,1500129,1695842,12/01/2012 12:00:00 AM,160,282,259
Eastern,Suffolk City,51800,1228,5326,6554,1789,11329,13118,187382,1480860,1668242,01/01/2013 12:00:00 AM,153,278,255
Eastern,Suffolk City,51800,1229,4670,5899,1743,10713,12456,170888,1305360,1476248,02/01/2015 12:00:00 AM,139,280,250
Eastern,Suffolk City,51800,1229,5449,6678,1798,11700,13498,171631,1429949,1601580,02/01/2014 12:00:00 AM,140,262,240
Eastern,Suffolk City,51800,1233,4792,6025,1793,10848,12641,183548,1330033,1513581,12/01/2014 12:00:00 AM,149,278,251
Eastern,Suffolk City,51800,1241,5236,6477,1831,11391,13222,176497,1378316,1554813,07/01/2014 12:00:00 AM,142,263,240
Eastern,Suffolk City,51800,1243,5428,6671,1854,11578,13432,197453,1529948,1727401,05/01/2013 12:00:00 AM,159,282,259
Eastern,Suffolk City,51800,1246,4828,6074,1808,10896,12704,183218,1349941,1533159,11/01/2014 12:00:00 AM,147,280,252
Eastern,Suffolk City,51800,1247,5095,6342,1832,11229,13061,176543,1355939,1532482,09/01/2014 12:00:00 AM,142,266,242
Eastern,Suffolk City,51800,1248,5436,6684,1843,11652,13495,180376,1426874,1607250,12/01/2013 12:00:00 AM,145,262,240
Eastern,Suffolk City,51800,1249,4704,5953,1797,10751,12548,175720,1297145,1472865,01/01/2015 12:00:00 AM,141,276,247
Eastern,Suffolk City,51800,1250,5396,6646,1867,11578,13445,179598,1401485,1581083,01/01/2014 12:00:00 AM,144,260,238
Eastern,Suffolk City,51800,1251,5458,6709,1872,11654,13526,208826,1579254,1788080,06/01/2013 12:00:00 AM,167,289,267
Eastern,Suffolk City,51800,1252,4945,6197,1827,11056,12883,186101,1374632,1560733,10/01/2014 12:00:00 AM,149,278,252
Eastern,Suffolk City,51800,1256,5506,6762,1863,11758,13621,200703,1546367,1747070,07/01/2013 12:00:00 AM,160,281,258
Eastern,Suffolk City,51800,1259,5462,6721,1875,11721,13596,184035,1432232,1616267,11/01/2013 12:00:00 AM,146,262,240
Eastern,Suffolk City,51800,1259,5531,6790,1892,11795,13687,202690,1552439,1755129,08/01/2013 12:00:00 AM,161,281,258
Eastern,Suffolk City,51800,1264,5520,6784,1904,11806,13710,205447,1560171,1765618,09/01/2013 12:00:00 AM,163,283,260
Eastern,Suffolk City,51800,1265,5180,6445,1845,11332,13177,176216,1371294,1547510,08/01/2014 12:00:00 AM,139,265,240
Eastern,Suffolk City,51800,1278,5549,6827,1924,11867,13791,209993,1550756,1760749,10/01/2013 12:00:00 AM,164,279,258
Eastern,Surry County,51181,101,411,512,144,838,982,12342,105746,118088,01/01/2016 12:00:00 AM,122,257,231
Eastern,Surry County,51181,102,407,509,148,834,982,13929,107054,120983,11/01/2015 12:00:00 AM,137,263,238
Eastern,Surry County,51181,102,415,517,152,851,1003,14925,106359,121284,05/01/2015 12:00:00 AM,146,256,235
Eastern,Surry County,51181,102,415,517,152,864,1016,14943,106238,121181,07/01/2015 12:00:00 AM,147,256,234
Eastern,Surry County,51181,104,402,506,151,820,971,13398,104829,118227,09/01/2015 12:00:00 AM,129,261,234
Eastern,Surry County,51181,104,406,510,145,834,979,12666,108293,120959,12/01/2015 12:00:00 AM,122,267,237
Eastern,Surry County,51181,104,414,518,151,869,1020,14287,108501,122788,06/01/2015 12:00:00 AM,137,262,237
Eastern,Surry County,51181,104,422,526,173,832,1005,20205,108619,128824,05/01/2012 12:00:00 AM,194,257,245
Eastern,Surry County,51181,105,402,507,152,812,964,14168,103201,117369,10/01/2015 12:00:00 AM,135,257,231
Eastern,Surry County,51181,105,410,515,164,815,979,16633,101308,117941,01/01/2015 12:00:00 AM,158,247,229
Eastern,Surry County,51181,105,413,518,162,822,984,16552,105938,122490,02/01/2015 12:00:00 AM,158,257,236
Eastern,Surry County,51181,106,419,525,154,847,1001,15336,106541,121877,12/01/2014 12:00:00 AM,145,254,232
Eastern,Surry County,51181,106,422,528,174,847,1021,19368,109782,129150,07/01/2012 12:00:00 AM,183,260,245
Eastern,Surry County,51181,107,410,517,160,825,985,15702,107030,122732,04/01/2015 12:00:00 AM,147,261,237
Eastern,Surry County,51181,107,412,519,164,821,985,16299,105519,121818,03/01/2015 12:00:00 AM,152,256,235
Eastern,Surry County,51181,107,431,538,187,847,1034,21403,111889,133292,04/01/2012 12:00:00 AM,200,260,248
Eastern,Surry County,51181,108,422,530,160,852,1012,15667,109953,125620,11/01/2014 12:00:00 AM,145,261,237
Eastern,Surry County,51181,108,424,532,174,844,1018,19407,109505,128912,06/01/2012 12:00:00 AM,180,258,242
Eastern,Surry County,51181,109,450,559,164,922,1086,17250,117122,134372,07/01/2013 12:00:00 AM,158,260,240
Eastern,Surry County,51181,110,405,515,210,796,1006,23112,100474,123586,01/01/2012 12:00:00 AM,210,248,240
Eastern,Surry County,51181,110,422,532,169,855,1024,15797,102023,117820,09/01/2014 12:00:00 AM,144,242,221
Eastern,Surry County,51181,110,425,535,161,860,1021,15892,107602,123494,10/01/2014 12:00:00 AM,144,253,231
Eastern,Surry County,51181,111,408,519,206,808,1014,23157,104854,128011,02/01/2012 12:00:00 AM,209,257,247
Eastern,Surry County,51181,112,405,517,184,847,1031,21044,107582,128626,11/01/2012 12:00:00 AM,188,266,249
Eastern,Surry County,51181,112,417,529,186,835,1021,20386,107996,128382,08/01/2012 12:00:00 AM,182,259,243
Eastern,Surry County,51181,112,419,531,170,849,1019,16134,101841,117975,08/01/2014 12:00:00 AM,144,243,222
Eastern,Surry County,51181,112,421,533,207,826,1033,23619,106506,130125,03/01/2012 12:00:00 AM,211,253,244
Eastern,Surry County,51181,113,413,526,190,835,1025,22154,106562,128716,02/01/2013 12:00:00 AM,196,258,245
Eastern,Surry County,51181,113,424,537,169,876,1045,16317,106761,123078,07/01/2014 12:00:00 AM,144,252,229
Eastern,Surry County,51181,113,431,544,185,855,1040,20232,111119,131351,04/01/2013 12:00:00 AM,179,258,241
Eastern,Surry County,51181,113,437,550,170,894,1064,15755,110570,126325,06/01/2014 12:00:00 AM,139,253,230
Eastern,Surry County,51181,113,438,551,181,879,1060,19229,113886,133115,06/01/2013 12:00:00 AM,170,260,242
Eastern,Surry County,51181,114,404,518,188,837,1025,20569,108517,129086,12/01/2012 12:00:00 AM,180,269,249
Eastern,Surry County,51181,115,409,524,188,834,1022,21194,108199,129393,09/01/2012 12:00:00 AM,184,265,247
Eastern,Surry County,51181,115,417,532,186,840,1026,21349,108905,130254,03/01/2013 12:00:00 AM,186,261,245
Eastern,Surry County,51181,115,442,557,177,898,1075,19384,113381,132765,08/01/2013 12:00:00 AM,169,257,238
Eastern,Surry County,51181,116,410,526,191,860,1051,22257,112161,134418,10/01/2012 12:00:00 AM,192,274,256
Eastern,Surry County,51181,116,430,546,178,888,1066,18127,107899,126026,12/01/2013 12:00:00 AM,156,251,231
Eastern,Surry County,51181,116,438,554,190,869,1059,20974,113084,134058,05/01/2013 12:00:00 AM,181,258,242
Eastern,Surry County,51181,117,440,557,174,889,1063,18257,109900,128157,03/01/2014 12:00:00 AM,156,250,230
Eastern,Surry County,51181,118,432,550,180,876,1056,19052,108102,127154,02/01/2014 12:00:00 AM,161,250,231
Eastern,Surry County,51181,118,446,564,187,905,1092,21325,119206,140531,10/01/2013 12:00:00 AM,181,267,249
Eastern,Surry County,51181,119,440,559,189,886,1075,19836,109085,128921,11/01/2013 12:00:00 AM,167,248,231
Eastern,Surry County,51181,119,443,562,181,901,1082,18034,109252,127286,05/01/2014 12:00:00 AM,152,247,226
Eastern,Surry County,51181,120,406,526,202,832,1034,22377,104680,127057,01/01/2013 12:00:00 AM,186,258,242
Eastern,Surry County,51181,120,441,561,186,897,1083,18997,108353,127350,01/01/2014 12:00:00 AM,158,246,227
Eastern,Surry County,51181,121,432,553,194,868,1062,21048,112747,133795,09/01/2013 12:00:00 AM,174,261,242
Eastern,Surry County,51181,122,443,565,189,892,1081,19715,109025,128740,04/01/2014 12:00:00 AM,162,246,228
Eastern,Surry County,51181,75,347,422,93,699,792,8883,88200,97083,07/01/2019 12:00:00 AM,118,254,230
Eastern,Surry County,51181,76,346,422,93,678,771,7798,82388,90186,02/01/2020 12:00:00 AM,103,238,214
Eastern,Surry County,51181,76,353,429,95,683,778,7762,80555,88317,01/01/2020 12:00:00 AM,102,228,206
Eastern,Surry County,51181,77,357,434,100,702,802,9084,83557,92641,11/01/2019 12:00:00 AM,118,234,213
Eastern,Surry County,51181,77,364,441,98,725,823,9246,86279,95525,06/01/2019 12:00:00 AM,120,237,217
Eastern,Surry County,51181,77,365,442,99,719,818,9010,87475,96485,08/01/2019 12:00:00 AM,117,240,218
Eastern,Surry County,51181,77,370,447,97,735,832,8803,91591,100394,09/01/2019 12:00:00 AM,114,248,225
Eastern,Surry County,51181,78,359,437,100,694,794,8818,82205,91023,12/01/2019 12:00:00 AM,113,229,208
Eastern,Surry County,51181,79,350,429,95,689,784,18151,123023,141174,03/01/2020 12:00:00 AM,230,351,329
Eastern,Surry County,51181,79,356,435,102,706,808,9450,82786,92236,04/01/2019 12:00:00 AM,120,233,212
Eastern,Surry County,51181,79,364,443,105,709,814,9550,91535,101085,10/01/2019 12:00:00 AM,121,251,228
Eastern,Surry County,51181,81,323,404,118,643,761,11817,74579,86396,02/01/2019 12:00:00 AM,146,231,214
Eastern,Surry County,51181,81,332,413,115,680,795,11813,83068,94881,12/01/2018 12:00:00 AM,146,250,230
Eastern,Surry County,51181,81,358,439,106,710,816,10811,82382,93193,05/01/2019 12:00:00 AM,133,230,212
Eastern,Surry County,51181,82,341,423,118,688,806,11814,81482,93296,11/01/2018 12:00:00 AM,144,239,221
Eastern,Surry County,51181,82,384,466,101,744,845,18986,129370,148356,04/01/2020 12:00:00 AM,232,337,318
Eastern,Surry County,51181,83,338,421,117,682,799,11285,83220,94505,10/01/2018 12:00:00 AM,136,246,224
Eastern,Surry County,51181,84,361,445,101,721,822,8645,90347,98992,12/01/2017 12:00:00 AM,103,250,222
Eastern,Surry County,51181,85,346,431,122,695,817,12432,89265,101697,01/01/2019 12:00:00 AM,146,258,236
Eastern,Surry County,51181,85,351,436,108,699,807,9971,85851,95822,02/01/2018 12:00:00 AM,117,245,220
Eastern,Surry County,51181,85,360,445,102,715,817,8851,87344,96195,11/01/2017 12:00:00 AM,104,243,216
Eastern,Surry County,51181,85,360,445,106,724,830,10107,88311,98418,03/01/2018 12:00:00 AM,119,245,221
Eastern,Surry County,51181,85,398,483,108,775,883,19778,135105,154883,05/01/2020 12:00:00 AM,233,339,321
Eastern,Surry County,51181,85,415,500,105,804,909,19601,140863,160464,07/01/2020 12:00:00 AM,231,339,321
Eastern,Surry County,51181,86,342,428,109,692,801,10786,84396,95182,07/01/2018 12:00:00 AM,125,247,222
Eastern,Surry County,51181,86,350,436,122,696,818,11765,81364,93129,03/01/2019 12:00:00 AM,137,232,214
Eastern,Surry County,51181,86,358,444,106,724,830,9698,86232,95930,04/01/2018 12:00:00 AM,113,241,216
Eastern,Surry County,51181,86,379,465,109,768,877,10868,97601,108469,05/01/2017 12:00:00 AM,126,258,233
Eastern,Surry County,51181,86,417,503,117,864,981,11112,102932,114044,08/01/2016 12:00:00 AM,129,247,227
Eastern,Surry County,51181,87,346,433,106,693,799,10073,87975,98048,06/01/2018 12:00:00 AM,116,254,226
Eastern,Surry County,51181,87,346,433,107,710,817,10327,87577,97904,05/01/2018 12:00:00 AM,119,253,226
Eastern,Surry County,51181,87,356,443,102,722,824,9394,91046,100440,09/01/2017 12:00:00 AM,108,256,227
Eastern,Surry County,51181,87,360,447,107,730,837,10891,92311,103202,08/01/2017 12:00:00 AM,125,256,231
Eastern,Surry County,51181,87,362,449,110,724,834,10216,89377,99593,01/01/2018 12:00:00 AM,117,247,222
Eastern,Surry County,51181,87,362,449,112,679,791,26659,162005,188664,06/01/2021 12:00:00 AM,306,448,420
Eastern,Surry County,51181,87,366,453,110,734,844,10424,93778,104202,07/01/2017 12:00:00 AM,120,256,230
Eastern,Surry County,51181,87,369,456,112,694,806,26626,166470,193096,05/01/2021 12:00:00 AM,306,451,423
Eastern,Surry County,51181,87,374,461,107,695,802,23795,149712,173507,03/01/2021 12:00:00 AM,274,400,376
Eastern,Surry County,51181,87,402,489,110,780,890,20005,135786,155791,08/01/2020 12:00:00 AM,230,338,319
Eastern,Surry County,51181,87,407,494,109,784,893,20594,136507,157101,06/01/2020 12:00:00 AM,237,335,318
Eastern,Surry County,51181,88,343,431,125,697,822,12421,86467,98888,09/01/2018 12:00:00 AM,141,252,229
Eastern,Surry County,51181,88,345,433,120,696,816,11627,86951,98578,08/01/2018 12:00:00 AM,132,252,228
Eastern,Surry County,51181,88,371,459,112,747,859,10349,93391,103740,06/01/2017 12:00:00 AM,118,252,226
Eastern,Surry County,51181,88,372,460,116,704,820,23104,135103,158207,11/01/2020 12:00:00 AM,263,363,344
Eastern,Surry County,51181,88,409,497,122,842,964,10933,104385,115318,05/01/2016 12:00:00 AM,124,255,232
Eastern,Surry County,51181,88,422,510,121,868,989,10743,105804,116547,06/01/2016 12:00:00 AM,122,251,229
Eastern,Surry County,51181,89,358,447,107,719,826,9961,91317,101278,10/01/2017 12:00:00 AM,112,255,227
Eastern,Surry County,51181,89,368,457,114,685,799,27246,158606,185852,04/01/2021 12:00:00 AM,306,431,407
Eastern,Surry County,51181,89,369,458,113,748,861,10830,91085,101915,04/01/2017 12:00:00 AM,122,247,223
Eastern,Surry County,51181,89,373,462,121,702,823,23068,131979,155047,12/01/2020 12:00:00 AM,259,354,336
Eastern,Surry County,51181,89,383,472,120,733,853,23824,134966,158790,10/01/2020 12:00:00 AM,268,352,336
Eastern,Surry County,51181,89,389,478,118,742,860,21262,131990,153252,09/01/2020 12:00:00 AM,239,339,321
Eastern,Surry County,51181,89,410,499,122,843,965,11291,101293,112584,07/01/2016 12:00:00 AM,127,247,226
Eastern,Surry County,51181,91,392,483,120,739,859,27836,162017,189853,02/01/2021 12:00:00 AM,306,413,393
Eastern,Surry County,51181,92,379,471,118,781,899,10969,98169,109138,03/01/2017 12:00:00 AM,119,259,232
Eastern,Surry County,51181,92,383,475,127,716,843,27497,153107,180604,01/01/2021 12:00:00 AM,299,400,380
Eastern,Surry County,51181,92,397,489,125,822,947,12436,98968,111404,12/01/2016 12:00:00 AM,135,249,228
Eastern,Surry County,51181,92,403,495,129,831,960,13127,102665,115792,10/01/2016 12:00:00 AM,143,255,234
Eastern,Surry County,51181,92,409,501,131,843,974,11325,103411,114736,04/01/2016 12:00:00 AM,123,253,229
Eastern,Surry County,51181,93,401,494,131,833,964,13150,99387,112537,09/01/2016 12:00:00 AM,141,248,228
Eastern,Surry County,51181,94,391,485,126,809,935,11616,96624,108240,01/01/2017 12:00:00 AM,124,247,223
Eastern,Surry County,51181,94,394,488,132,813,945,12975,99972,112947,11/01/2016 12:00:00 AM,138,254,231
Eastern,Surry County,51181,94,412,506,133,838,971,11740,106852,118592,03/01/2016 12:00:00 AM,125,259,234
Eastern,Surry County,51181,96,411,507,135,832,967,12216,105835,118051,02/01/2016 12:00:00 AM,127,258,233
Eastern,Surry County,51181,99,391,490,130,807,937,11466,99506,110972,02/01/2017 12:00:00 AM,116,254,226
Eastern,Surry County,51181,99,415,514,143,853,996,12218,106737,118955,08/01/2015 12:00:00 AM,123,257,231
Eastern,Sussex County,51183,152,684,836,232,1350,1582,23102,173147,196249,06/01/2019 12:00:00 AM,152,253,235
Eastern,Sussex County,51183,153,665,818,223,1315,1538,22327,167615,189942,03/01/2019 12:00:00 AM,146,252,232
Eastern,Sussex County,51183,153,676,829,233,1325,1558,22621,165834,188455,05/01/2019 12:00:00 AM,148,245,227
Eastern,Sussex County,51183,154,658,812,207,1439,1646,20257,173476,193733,04/01/2017 12:00:00 AM,132,264,239
Eastern,Sussex County,51183,155,656,811,233,1290,1523,21717,157096,178813,04/01/2019 12:00:00 AM,140,239,220
Eastern,Sussex County,51183,155,690,845,219,1342,1561,50120,314271,364391,04/01/2021 12:00:00 AM,323,455,431
Eastern,Sussex County,51183,156,641,797,228,1307,1535,22281,160388,182669,02/01/2019 12:00:00 AM,143,250,229
Eastern,Sussex County,51183,156,660,816,220,1355,1575,20983,170744,191727,01/01/2019 12:00:00 AM,135,259,235
Eastern,Sussex County,51183,156,690,846,224,1349,1573,48447,287331,335778,03/01/2021 12:00:00 AM,311,416,397
Eastern,Sussex County,51183,156,690,846,226,1369,1595,50462,280931,331393,01/01/2021 12:00:00 AM,323,407,392
Eastern,Sussex County,51183,156,692,848,241,1371,1612,25010,172481,197491,07/01/2019 12:00:00 AM,160,249,233
Eastern,Sussex County,51183,156,707,863,219,1399,1618,48238,296009,344247,02/01/2021 12:00:00 AM,309,419,399
Eastern,Sussex County,51183,157,686,843,221,1321,1542,51599,312473,364072,05/01/2021 12:00:00 AM,329,456,432
Eastern,Sussex County,51183,157,723,880,233,1428,1661,43598,264060,307658,10/01/2020 12:00:00 AM,278,365,350
Eastern,Sussex County,51183,158,654,812,217,1430,1647,20986,171878,192864,05/01/2017 12:00:00 AM,133,263,238
Eastern,Sussex County,51183,158,679,837,216,1477,1693,20683,184779,205462,03/01/2017 12:00:00 AM,131,272,245
Eastern,Sussex County,51183,158,687,845,245,1388,1633,25544,171072,196616,08/01/2019 12:00:00 AM,162,249,233
Eastern,Sussex County,51183,158,700,858,227,1402,1629,43487,258450,301937,11/01/2020 12:00:00 AM,275,369,352
Eastern,Sussex County,51183,158,701,859,226,1399,1625,42599,263374,305973,12/01/2020 12:00:00 AM,270,376,356
Eastern,Sussex County,51183,159,644,803,244,1316,1560,24501,165415,189916,02/01/2020 12:00:00 AM,154,257,237
Eastern,Sussex County,51183,159,654,813,241,1325,1566,43992,227229,271221,03/01/2020 12:00:00 AM,277,347,334
Eastern,Sussex County,51183,159,661,820,239,1330,1569,24533,164508,189041,01/01/2020 12:00:00 AM,154,249,231
Eastern,Sussex County,51183,159,672,831,238,1364,1602,25651,167616,193267,11/01/2019 12:00:00 AM,161,249,233
Eastern,Sussex County,51183,160,658,818,225,1444,1669,21451,176610,198061,06/01/2017 12:00:00 AM,134,268,242
Eastern,Sussex County,51183,160,671,831,241,1366,1607,26125,168604,194729,12/01/2019 12:00:00 AM,163,251,234
Eastern,Sussex County,51183,160,686,846,236,1398,1634,24142,176050,200192,10/01/2019 12:00:00 AM,151,257,237
Eastern,Sussex County,51183,160,705,865,223,1372,1595,52076,318069,370145,06/01/2021 12:00:00 AM,325,451,428
Eastern,Sussex County,51183,160,768,928,274,1644,1918,30272,208118,238390,05/01/2012 12:00:00 AM,189,271,257
Eastern,Sussex County,51183,161,646,807,235,1409,1644,23471,168517,191988,07/01/2017 12:00:00 AM,146,261,238
Eastern,Sussex County,51183,161,646,807,239,1407,1646,23497,171910,195407,09/01/2017 12:00:00 AM,146,266,242
Eastern,Sussex County,51183,161,648,809,235,1439,1674,23100,172891.45,195991.45,08/01/2017 12:00:00 AM,143,267,242
Eastern,Sussex County,51183,161,691,852,252,1410,1662,26680,170749,197429,09/01/2019 12:00:00 AM,166,247,232
Eastern,Sussex County,51183,162,645,807,235,1335,1570,23709,163070,186779,11/01/2018 12:00:00 AM,146,253,231
Eastern,Sussex County,51183,162,737,899,244,1472,1716,44045,257197,301242,09/01/2020 12:00:00 AM,272,349,335
Eastern,Sussex County,51183,163,632,795,247,1310,1557,25356,165374,190730,06/01/2018 12:00:00 AM,156,262,240
Eastern,Sussex County,51183,163,734,897,245,1485,1730,44289,257212,301501,05/01/2020 12:00:00 AM,272,350,336
Eastern,Sussex County,51183,163,756,919,246,1514,1760,44066,265269,309335,06/01/2020 12:00:00 AM,270,351,337
Eastern,Sussex County,51183,164,621,785,241,1301,1542,26467,155676,182143,04/01/2018 12:00:00 AM,161,251,232
Eastern,Sussex County,51183,164,711,875,246,1428,1674,44182,247987,292169,04/01/2020 12:00:00 AM,269,349,334
Eastern,Sussex County,51183,164,764,928,280,1668,1948,32238,209170,241408,01/01/2012 12:00:00 AM,197,274,260
Eastern,Sussex County,51183,164,769,933,269,1666,1935,30061,210991,241052,06/01/2012 12:00:00 AM,183,274,258
Eastern,Sussex County,51183,165,626,791,248,1298,1546,25236,158821,184057,05/01/2018 12:00:00 AM,153,254,233
Eastern,Sussex County,51183,165,634,799,246,1358,1604,24995,162674,187669,12/01/2017 12:00:00 AM,151,257,235
Eastern,Sussex County,51183,165,638,803,246,1366,1612,24661,164107,188768,02/01/2018 12:00:00 AM,149,257,235
Eastern,Sussex County,51183,165,653,818,243,1354,1597,25843,167629,193472,12/01/2018 12:00:00 AM,157,257,237
Eastern,Sussex County,51183,165,771,936,249,1535,1784,44997,265592,310589,08/01/2020 12:00:00 AM,273,344,332
Eastern,Sussex County,51183,166,634,800,252,1318,1570,25787,159836,185623,07/01/2018 12:00:00 AM,155,252,232
Eastern,Sussex County,51183,166,766,932,267,1663,1930,27594,211207,238801,07/01/2012 12:00:00 AM,166,276,256
Eastern,Sussex County,51183,166,775,941,286,1675,1961,32659,211256,243915,04/01/2012 12:00:00 AM,197,273,259
Eastern,Sussex County,51183,167,640,807,250,1348,1598,25557,159718,185275,01/01/2018 12:00:00 AM,153,250,230
Eastern,Sussex County,51183,167,691,858,234,1506,1740,23500,178218,201718,02/01/2017 12:00:00 AM,141,258,235
Eastern,Sussex County,51183,167,769,936,251,1543,1794,45483,268683,314166,07/01/2020 12:00:00 AM,272,349,336
Eastern,Sussex County,51183,168,625,793,251,1320,1571,25518,158631,184149,03/01/2018 12:00:00 AM,152,254,232
Eastern,Sussex County,51183,168,635,803,250,1358,1608,25125,162849,187974,10/01/2017 12:00:00 AM,150,256,234
Eastern,Sussex County,51183,168,694,862,222,1519,1741,20931,175681,196612,01/01/2017 12:00:00 AM,125,253,228
Eastern,Sussex County,51183,168,832,1000,265,1750,2015,26046,203141,229187,12/01/2013 12:00:00 AM,155,244,229
Eastern,Sussex County,51183,169,650,819,253,1390,1643,26152,168876,195028,11/01/2017 12:00:00 AM,155,260,238
Eastern,Sussex County,51183,169,695,864,237,1514,1751,23161,178894,202055,11/01/2016 12:00:00 AM,137,257,234
Eastern,Sussex County,51183,169,730,899,239,1569,1808,23898,190222,214120,04/01/2016 12:00:00 AM,141,261,238
Eastern,Sussex County,51183,170,651,821,250,1340,1590,25861,165629,191490,10/01/2018 12:00:00 AM,152,254,233
Eastern,Sussex County,51183,170,660,830,250,1362,1612,25848,169100,194948,09/01/2018 12:00:00 AM,152,256,235
Eastern,Sussex County,51183,170,722,892,243,1538,1781,26449,181418,207867,02/01/2016 12:00:00 AM,156,251,233
Eastern,Sussex County,51183,170,816,986,271,1715,1986,26421,196054,222475,01/01/2014 12:00:00 AM,155,240,226
Eastern,Sussex County,51183,171,647,818,262,1337,1599,26569,164586,191155,08/01/2018 12:00:00 AM,155,254,234
Eastern,Sussex County,51183,171,713,884,243,1540,1783,24991,186332,211323,05/01/2016 12:00:00 AM,146,261,239
Eastern,Sussex County,51183,171,762,933,292,1660,1952,34712,209596,244308,02/01/2012 12:00:00 AM,203,275,262
Eastern,Sussex County,51183,171,767,938,283,1653,1936,33526,208635,242161,03/01/2012 12:00:00 AM,196,272,258
Eastern,Sussex County,51183,171,843,1014,264,1797,2061,28093,231344,259437,10/01/2013 12:00:00 AM,164,274,256
Eastern,Sussex County,51183,172,711,883,252,1532,1784,25862,183149,209011,06/01/2016 12:00:00 AM,150,258,237
Eastern,Sussex County,51183,172,803,975,268,1708,1976,26359,200149,226508,02/01/2014 12:00:00 AM,153,249,232
Eastern,Sussex County,51183,172,840,1012,266,1777,2043,26127,210812,236939,11/01/2013 12:00:00 AM,152,251,234
Eastern,Sussex County,51183,173,695,868,235,1521,1756,21724,178721,200445,12/01/2016 12:00:00 AM,126,257,231
Eastern,Sussex County,51183,173,727,900,254,1553,1807,26818,185743,212561,03/01/2016 12:00:00 AM,155,255,236
Eastern,Sussex County,51183,173,768,941,281,1649,1930,29340,209242,238582,09/01/2012 12:00:00 AM,170,272,254
Eastern,Sussex County,51183,174,763,937,279,1650,1929,29060,205896,234956,12/01/2012 12:00:00 AM,167,270,251
Eastern,Sussex County,51183,174,763,937,280,1650,1930,29025,212463,241488,08/01/2012 12:00:00 AM,167,278,258
Eastern,Sussex County,51183,174,787,961,258,1696,1954,24739,198123,222862,04/01/2014 12:00:00 AM,142,252,232
Eastern,Sussex County,51183,175,705,880,252,1541,1793,25094,180718,205812,10/01/2016 12:00:00 AM,143,256,234
Eastern,Sussex County,51183,175,713,888,255,1532,1787,27834,178631,206465,01/01/2016 12:00:00 AM,159,251,233
Eastern,Sussex County,51183,175,752,927,256,1642,1898,24734,188351,213085,05/01/2014 12:00:00 AM,141,250,230
Eastern,Sussex County,51183,175,766,941,268,1664,1932,27157,199863,227020,09/01/2014 12:00:00 AM,155,261,241
Eastern,Sussex County,51183,175,770,945,278,1669,1947,28828,211426,240254,10/01/2012 12:00:00 AM,165,275,254
Eastern,Sussex County,51183,176,794,970,277,1694,1971,27941,196623,224564,03/01/2014 12:00:00 AM,159,248,232
Eastern,Sussex County,51183,176,847,1023,274,1803,2077,29201,234140,263341,09/01/2013 12:00:00 AM,166,276,257
Eastern,Sussex County,51183,177,693,870,257,1495,1752,26782,179386,206168,08/01/2016 12:00:00 AM,151,259,237
Eastern,Sussex County,51183,177,700,877,251,1525,1776,26432,183152,209584,07/01/2016 12:00:00 AM,149,262,239
Eastern,Sussex County,51183,178,710,888,271,1530,1801,29025,177474,206499,12/01/2015 12:00:00 AM,163,250,233
Eastern,Sussex County,51183,178,764,942,286,1643,1929,31727,201259,232986,01/01/2013 12:00:00 AM,178,263,247
Eastern,Sussex County,51183,178,775,953,288,1676,1964,29791,209453,239244,11/01/2012 12:00:00 AM,167,270,251
Eastern,Sussex County,51183,179,712,891,264,1573,1837,26938,179126,206064,10/01/2015 12:00:00 AM,150,252,231
Eastern,Sussex County,51183,179,839,1018,273,1778,2051,30686,230936,261622,07/01/2013 12:00:00 AM,171,275,257
Eastern,Sussex County,51183,180,686,866,264,1499,1763,27962,176063,204025,09/01/2016 12:00:00 AM,155,257,236
Eastern,Sussex County,51183,180,755,935,283,1624,1907,29303,190405,219708,08/01/2014 12:00:00 AM,163,252,235
Eastern,Sussex County,51183,180,797,977,266,1709,1975,28303,216282,244585,04/01/2013 12:00:00 AM,157,271,250
Eastern,Sussex County,51183,180,839,1019,278,1791,2069,31970,232995,264965,08/01/2013 12:00:00 AM,178,278,260
Eastern,Sussex County,51183,181,719,900,270,1552,1822,27389,182663,210052,11/01/2015 12:00:00 AM,151,254,233
Eastern,Sussex County,51183,181,759,940,266,1682,1948,26406,195224,221630,07/01/2015 12:00:00 AM,146,257,236
Eastern,Sussex County,51183,181,768,949,281,1665,1946,31240,205037,236277,10/01/2014 12:00:00 AM,173,267,249
Eastern,Sussex County,51183,181,776,957,262,1711,1973,27768,207778,235546,02/01/2015 12:00:00 AM,153,268,246
Eastern,Sussex County,51183,181,791,972,278,1698,1976,29996,217704,247700,03/01/2013 12:00:00 AM,166,275,255
Eastern,Sussex County,51183,182,746,928,271,1654,1925,26623,192758,219381,08/01/2015 12:00:00 AM,146,258,236
Eastern,Sussex County,51183,182,747,929,275,1630,1905,27997,188066,216063,06/01/2014 12:00:00 AM,154,252,233
Eastern,Sussex County,51183,182,771,953,267,1699,1966,26824,199447,226271,06/01/2015 12:00:00 AM,147,259,237
Eastern,Sussex County,51183,182,801,983,271,1724,1995,28226,221085,249311,05/01/2013 12:00:00 AM,155,276,254
Eastern,Sussex County,51183,183,746,929,286,1614,1900,30292,185644,215936,07/01/2014 12:00:00 AM,166,249,232
Eastern,Sussex County,51183,183,776,959,267,1713,1980,27731,207975,235706,01/01/2015 12:00:00 AM,152,268,246
Eastern,Sussex County,51183,183,780,963,290,1674,1964,31859,211670,243529,02/01/2013 12:00:00 AM,174,271,253
Eastern,Sussex County,51183,184,778,962,271,1726,1997,29197,206614,235811,04/01/2015 12:00:00 AM,159,266,245
Eastern,Sussex County,51183,184,788,972,276,1730,2006,29719,212411,242130,12/01/2014 12:00:00 AM,162,270,249
Eastern,Sussex County,51183,184,818,1002,282,1746,2028,30716,223268,253984,06/01/2013 12:00:00 AM,167,273,253
Eastern,Sussex County,51183,186,726,912,287,1601,1888,30603,184710,215313,09/01/2015 12:00:00 AM,165,254,236
Eastern,Sussex County,51183,186,776,962,271,1737,2008,29614,206715,236329,05/01/2015 12:00:00 AM,159,266,246
Eastern,Sussex County,51183,188,776,964,290,1687,1977,31258,208965,240223,11/01/2014 12:00:00 AM,166,269,249
Eastern,Sussex County,51183,188,789,977,274,1752,2026,30216,210494,240710,03/01/2015 12:00:00 AM,161,267,246
Eastern,Virginia Beach City,51810,2169,10735,12904,2889,25615,28504,307996,3222960,3530956,04/01/2017 12:00:00 AM,142,300,274
Eastern,Virginia Beach City,51810,2173,11027,13200,2857,26220,29077,303521,3308143,3611664,03/01/2017 12:00:00 AM,140,300,274
Eastern,Virginia Beach City,51810,2193,10778,12971,2919,25746,28665,314068,3245027,3559095,05/01/2017 12:00:00 AM,143,301,274
Eastern,Virginia Beach City,51810,2203,10747,12950,2915,25743,28658,312785,3276368,3589153,06/01/2017 12:00:00 AM,142,305,277
Eastern,Virginia Beach City,51810,2223,10579,12802,2962,25485,28447,316887,3233992,3550879,07/01/2017 12:00:00 AM,143,306,277
Eastern,Virginia Beach City,51810,2253,11218,13471,3054,26856,29910,314047,3301837,3615884,01/01/2017 12:00:00 AM,139,294,268
Eastern,Virginia Beach City,51810,2254,11155,13409,3031,26702,29733,315267,3285787,3601054,02/01/2017 12:00:00 AM,140,295,269
Eastern,Virginia Beach City,51810,2255,10775,13030,3002,25889,28891,322222,3311020,3633242,08/01/2017 12:00:00 AM,143,307,279
Eastern,Williamsburg City,51830,68,518,586,121,1114,1235,14216,136660,150876,11/01/2013 12:00:00 AM,209,264,257
Eastern,Virginia Beach City,51810,2265,10672,12937,3029,25736,28765,326631,3283736,3610367,09/01/2017 12:00:00 AM,144,308,279
Eastern,Virginia Beach City,51810,2270,11325,13595,3099,27153,30252,327275,3365010,3692285,11/01/2016 12:00:00 AM,144,297,272
Eastern,Virginia Beach City,51810,2281,11317,13598,3122,27155,30277,331975,3361554,3693529,12/01/2016 12:00:00 AM,146,297,272
Eastern,Virginia Beach City,51810,2290,11492,13782,3128,27584,30712,336239,3497863,3834102,10/01/2016 12:00:00 AM,147,304,278
Eastern,Virginia Beach City,51810,2293,11760,14053,3138,28084,31222,325279,3440398,3765677,07/01/2016 12:00:00 AM,142,293,268
Eastern,Virginia Beach City,51810,2309,10635,12944,3112,25567,28679,340793,3229953,3570746,10/01/2017 12:00:00 AM,148,304,276
Eastern,Virginia Beach City,51810,2310,11624,13934,3184,27889,31073,332411,3418318,3750729,09/01/2016 12:00:00 AM,144,294,269
Eastern,Virginia Beach City,51810,2312,11712,14024,3222,27989,31211,335463,3429453,3764916,08/01/2016 12:00:00 AM,145,293,268
Eastern,Virginia Beach City,51810,2314,11883,14197,3204,28288,31492,333040,3475124,3808164,06/01/2016 12:00:00 AM,144,292,268
Eastern,Virginia Beach City,51810,2322,11886,14208,3216,28204,31420,331546,3471888,3803434,05/01/2016 12:00:00 AM,143,292,268
Eastern,Virginia Beach City,51810,2324,10601,12925,3114,25449,28563,336748,3194892,3531640,12/01/2017 12:00:00 AM,145,301,273
Eastern,Virginia Beach City,51810,2324,10612,12936,3107,25552,28659,335693,3222360,3558053,11/01/2017 12:00:00 AM,144,304,275
Eastern,Virginia Beach City,51810,2326,12060,14386,3214,28486,31700,332021,3478570,3810591,04/01/2016 12:00:00 AM,143,288,265
Eastern,Virginia Beach City,51810,2330,10117,12447,3090,23943,27033,318926,3003918,3322844,07/01/2018 12:00:00 AM,137,297,267
Eastern,Virginia Beach City,51810,2333,10503,12836,3124,25236,28360,324764,3173125.01,3497889.01,01/01/2018 12:00:00 AM,139,302,273
Eastern,Virginia Beach City,51810,2344,10172,12516,3133,24179,27312,326229,3042245,3368474,06/01/2018 12:00:00 AM,139,299,269
Eastern,Virginia Beach City,51810,2349,10149,12498,3131,23994,27125,325901,3012356,3338257,08/01/2018 12:00:00 AM,139,297,267
Eastern,Virginia Beach City,51810,2349,10472,12821,3123,25016,28139,321836,3145494,3467330,02/01/2018 12:00:00 AM,137,300,270
Eastern,Virginia Beach City,51810,2351,10203,12554,3120,24321,27441,322675,3058181,3380856,05/01/2018 12:00:00 AM,137,300,269
Eastern,Virginia Beach City,51810,2352,12211,14563,3275,28792,32067,335881,3518310,3854191,03/01/2016 12:00:00 AM,143,288,265
Eastern,Virginia Beach City,51810,2367,9995,12362,3130,23686,26816,325080,2974179,3299259,09/01/2018 12:00:00 AM,137,298,267
Eastern,Virginia Beach City,51810,2372,12175,14547,3334,28770,32104,344557,3515784,3860341,02/01/2016 12:00:00 AM,145,289,265
Eastern,Virginia Beach City,51810,2372,9493,11865,3117,21718,24835,308204,2679717,2987921,01/01/2020 12:00:00 AM,130,282,252
Eastern,Virginia Beach City,51810,2374,10258,12632,3152,24489,27641,326982.65,3064110,3391092.65,04/01/2018 12:00:00 AM,138,299,268
Eastern,Virginia Beach City,51810,2374,9350,11724,3129,21485,24614,307925,2660934,2968859,02/01/2020 12:00:00 AM,130,285,253
Eastern,Virginia Beach City,51810,2377,10452,12829,3180,24928,28108,332707,3126051,3458758,03/01/2018 12:00:00 AM,140,299,270
Eastern,Virginia Beach City,51810,2378,9558,11936,3109,22110,25219,316986,2776232,3093218,02/01/2019 12:00:00 AM,133,290,259
Eastern,Virginia Beach City,51810,2391,9459,11850,3147,21624,24771,580348,3723139,4303487,03/01/2020 12:00:00 AM,243,394,363
Eastern,Virginia Beach City,51810,2394,12230,14624,3413,28877,32290,356161,3498850,3855011,01/01/2016 12:00:00 AM,149,286,264
Eastern,Virginia Beach City,51810,2397,9685,12082,3174,22260,25434,326356,2790113,3116469,12/01/2019 12:00:00 AM,136,288,258
Eastern,Virginia Beach City,51810,2404,12440,14844,3425,29287,32712,355565,3553735,3909300,12/01/2015 12:00:00 AM,148,286,263
Eastern,Virginia Beach City,51810,2406,10021,12427,3190,23580,26770,337452,2972300.5,3309752.5,10/01/2018 12:00:00 AM,140,297,266
Eastern,Virginia Beach City,51810,2406,9825,12231,3173,22649,25822,317294,2838972,3156266,09/01/2019 12:00:00 AM,132,289,258
Eastern,Virginia Beach City,51810,2410,12668,15078,3386,29897,33283,352415,3619912,3972327,09/01/2015 12:00:00 AM,146,286,263
Eastern,Virginia Beach City,51810,2410,9742,12152,3191,22358,25549,321819,2785191,3107010,11/01/2019 12:00:00 AM,134,286,256
Eastern,Virginia Beach City,51810,2413,12630,15043,3407,29803,33210,356143,3621494,3977637,10/01/2015 12:00:00 AM,148,287,264
Eastern,Virginia Beach City,51810,2413,9804,12217,3195,22474,25669,325289,2830718,3156007,10/01/2019 12:00:00 AM,135,289,258
Eastern,Virginia Beach City,51810,2415,12716,15131,3434,29956,33390,361114,3641146,4002260,06/01/2015 12:00:00 AM,150,286,265
Eastern,Virginia Beach City,51810,2416,9871,12287,3162,22822,25984,315840,2829881.2,3145721.2,08/01/2019 12:00:00 AM,131,287,256
Eastern,Virginia Beach City,51810,2419,12691,15110,3384,30077,33461,352439,3644856,3997295,08/01/2015 12:00:00 AM,146,287,265
Eastern,Virginia Beach City,51810,2430,12574,15004,3466,29619,33085,361772,3607765,3969537,11/01/2015 12:00:00 AM,149,287,265
Eastern,Virginia Beach City,51810,2432,14083,16515,3596,31757,35353,374208,3851128,4225336,07/01/2014 12:00:00 AM,154,273,256
Eastern,Virginia Beach City,51810,2433,10030,12463,3220,23585,26805,347105,2979460,3326565,11/01/2018 12:00:00 AM,143,297,267
Eastern,Virginia Beach City,51810,2434,12610,15044,3488,29742,33230,364962,3613688,3978650,05/01/2015 12:00:00 AM,150,287,264
Eastern,Virginia Beach City,51810,2435,10087,12522,3203,23593,26796,340474,3002510,3342984,12/01/2018 12:00:00 AM,140,298,267
Eastern,Virginia Beach City,51810,2436,12664,15100,3453,29925,33378,362548,3624114,3986662,07/01/2015 12:00:00 AM,149,286,264
Eastern,Virginia Beach City,51810,2438,9864,12302,3192,22808,26000,324540,2841403,3165943,07/01/2019 12:00:00 AM,133,288,257
Eastern,Virginia Beach City,51810,2440,12937,15377,3492,30174,33666,364839,3692414,4057253,02/01/2015 12:00:00 AM,150,285,264
Eastern,Virginia Beach City,51810,2441,9921,12362,3206,22893,26099,321453,2869081,3190534,06/01/2019 12:00:00 AM,132,289,258
Eastern,Virginia Beach City,51810,2442,10111,12553,3232,23536,26768,343824,3168121,3511945,01/01/2019 12:00:00 AM,141,313,280
Eastern,Virginia Beach City,51810,2444,14381,16825,3714,31988,35702,424555,4191269,4615824,07/01/2013 12:00:00 AM,174,291,274
Eastern,Virginia Beach City,51810,2444,14396,16840,3716,31988,35704,430282,4208141,4638423,06/01/2013 12:00:00 AM,176,292,275
Eastern,Virginia Beach City,51810,2449,12865,15314,3513,30146,33659,370405,3651189,4021594,03/01/2015 12:00:00 AM,151,284,263
Eastern,Virginia Beach City,51810,2450,12732,15182,3499,29900,33399,367639,3625637,3993276,04/01/2015 12:00:00 AM,150,285,263
Eastern,Virginia Beach City,51810,2452,13717,16169,3590,31302,34892,369963,3766292,4136255,09/01/2014 12:00:00 AM,151,275,256
Eastern,Virginia Beach City,51810,2453,13478,15931,3574,31070,34644,385712,3865838,4251550,11/01/2014 12:00:00 AM,157,287,267
Eastern,Virginia Beach City,51810,2456,10192,12648,3238,23666,26904,328115,2963839,3291954,03/01/2019 12:00:00 AM,134,291,260
Eastern,Virginia Beach City,51810,2457,10070,12527,3220,23370,26590,323259,2910561,3233820,05/01/2019 12:00:00 AM,132,289,258
Eastern,Virginia Beach City,51810,2459,14353,16812,3737,31894,35631,432844,4201565,4634409,05/01/2013 12:00:00 AM,176,293,276
Eastern,Virginia Beach City,51810,2459,14496,16955,3741,32224,35965,428718,4229204,4657922,08/01/2013 12:00:00 AM,174,292,275
Eastern,Virginia Beach City,51810,2460,14395,16855,3680,32185,35865,387079,3931341,4318420,05/01/2014 12:00:00 AM,157,273,256
Eastern,Virginia Beach City,51810,2461,14282,16743,3620,32147,35767,373029,3913306,4286335,06/01/2014 12:00:00 AM,152,274,256
Eastern,Virginia Beach City,51810,2464,11648,14112,3092,25360,28452,708317,5439186,6147503,02/01/2021 12:00:00 AM,287,467,436
Eastern,Virginia Beach City,51810,2466,13708,16174,3581,31395,34976,390953,3906672,4297625,10/01/2014 12:00:00 AM,159,285,266
Eastern,Virginia Beach City,51810,2468,10148,12616,3240,23483,26723,327550,2946325,3273875,04/01/2019 12:00:00 AM,133,290,260
Eastern,Virginia Beach City,51810,2468,14292,16760,3787,31726,35513,441166,4191315,4632481,04/01/2013 12:00:00 AM,179,293,276
Eastern,Virginia Beach City,51810,2471,13864,16335,3630,31549,35179,377338,3808981,4186319,08/01/2014 12:00:00 AM,153,275,256
Eastern,Virginia Beach City,51810,2471,14508,16979,3760,32272,36032,434790,4233588,4668378,09/01/2013 12:00:00 AM,176,292,275
Eastern,Virginia Beach City,51810,2482,10977,13459,3284,24448,27732,607321,4283905,4891226,04/01/2020 12:00:00 AM,245,390,363
Eastern,Virginia Beach City,51810,2484,13119,15603,3580,30479,34059,375793,3699490,4075283,01/01/2015 12:00:00 AM,151,282,261
Eastern,Virginia Beach City,51810,2485,14652,17137,3778,32511,36289,440741,4270009,4710750,10/01/2013 12:00:00 AM,177,291,275
Eastern,Virginia Beach City,51810,2487,11400,13887,3242,24981,28223,639635,4638507,5278142,12/01/2020 12:00:00 AM,257,407,380
Eastern,Virginia Beach City,51810,2490,11309,13799,3166,24240,27406,756033,5630094,6386127,05/01/2021 12:00:00 AM,304,498,463
Eastern,Virginia Beach City,51810,2491,13380,15871,3625,30865,34490,390613,3816984,4207597,12/01/2014 12:00:00 AM,157,285,265
Eastern,Virginia Beach City,51810,2491,14548,17039,3786,32297,36083,401719,3962984,4364703,04/01/2014 12:00:00 AM,161,272,256
Eastern,Virginia Beach City,51810,2492,11209,13701,3256,24726,27982,643498,4592924,5236422,11/01/2020 12:00:00 AM,258,410,382
Eastern,Virginia Beach City,51810,2492,11593,14085,3138,25110,28248,708878,5317865,6026743,03/01/2021 12:00:00 AM,284,459,428
Eastern,Virginia Beach City,51810,2493,14573,17066,3751,32329,36080,395958,3955111,4351069,02/01/2014 12:00:00 AM,159,271,255
Eastern,Virginia Beach City,51810,2494,14565,17059,3748,32264,36012,396083,3941815,4337898,03/01/2014 12:00:00 AM,159,271,254
Eastern,Virginia Beach City,51810,2495,11330,13825,3249,24732,27981,732752,5237662,5970414,01/01/2021 12:00:00 AM,294,462,432
Eastern,Virginia Beach City,51810,2496,11207,13703,3152,24015,27167,759593,5547018,6306611,06/01/2021 12:00:00 AM,304,495,460
Eastern,Virginia Beach City,51810,2499,14774,17273,3790,32852,36642,402364,3988307,4390671,12/01/2013 12:00:00 AM,161,270,254
Eastern,Virginia Beach City,51810,2500,14266,16766,3905,31663,35568,458836,4192857,4651693,03/01/2013 12:00:00 AM,184,294,277
Eastern,Virginia Beach City,51810,2502,11399,13901,3183,24451,27634,756028,5620428,6376456,04/01/2021 12:00:00 AM,302,493,459
Eastern,Virginia Beach City,51810,2503,14769,17272,3797,32783,36580,403982,4000080,4404062,11/01/2013 12:00:00 AM,161,271,255
Eastern,Virginia Beach City,51810,2505,11313,13818,3284,24952,28236,636893,4610861,5247754,10/01/2020 12:00:00 AM,254,408,380
Eastern,Virginia Beach City,51810,2505,14601,17106,3824,32410,36234,401878,3919119,4320997,01/01/2014 12:00:00 AM,160,268,253
Eastern,Virginia Beach City,51810,2522,14254,16776,3982,31635,35617,473721,4179692,4653413,02/01/2013 12:00:00 AM,188,293,277
Eastern,Virginia Beach City,51810,2528,13709,16237,4078,30555,34633,487096,3989904,4477000,04/01/2012 12:00:00 AM,193,291,276
Eastern,Virginia Beach City,51810,2530,11474,14004,3361,25349,28710,624160,4479500,5103660,05/01/2020 12:00:00 AM,247,390,364
Eastern,Virginia Beach City,51810,2537,14232,16769,3974,31599,35573,465275,4143039,4608314,01/01/2013 12:00:00 AM,183,291,275
Eastern,Virginia Beach City,51810,2543,11580,14123,3345,25590,28935,616553,4444833,5061386,09/01/2020 12:00:00 AM,242,384,358
Eastern,Virginia Beach City,51810,2543,13730,16273,4085,30746,34831,490806,4021746,4512552,07/01/2012 12:00:00 AM,193,293,277
Eastern,Virginia Beach City,51810,2544,13717,16261,4123,30626,34749,489408,4011200,4500608,06/01/2012 12:00:00 AM,192,292,277
Eastern,Virginia Beach City,51810,2555,11605,14160,3387,25714,29101,626421,4446163,5072584,06/01/2020 12:00:00 AM,245,383,358
Eastern,Virginia Beach City,51810,2555,13711,16266,4139,30548,34687,492722,4003297,4496019,05/01/2012 12:00:00 AM,193,292,276
Eastern,Virginia Beach City,51810,2556,14121,16677,4037,31388,35425,486896,4167254,4654150,12/01/2012 12:00:00 AM,190,295,279
Eastern,Virginia Beach City,51810,2556,14134,16690,4025,31400,35425,485084,4160657,4645741,11/01/2012 12:00:00 AM,190,294,278
Eastern,Virginia Beach City,51810,2557,13844,16401,4046,30902,34948,484156,4074181,4558337,09/01/2012 12:00:00 AM,189,294,278
Eastern,Virginia Beach City,51810,2559,11766,14325,3374,25981,29355,620430,4447591,5068021,08/01/2020 12:00:00 AM,242,378,354
Eastern,Virginia Beach City,51810,2560,13888,16448,4074,30981,35055,488560,4065281,4553841,08/01/2012 12:00:00 AM,191,293,277
Eastern,Virginia Beach City,51810,2561,13764,16325,4162,30650,34812,499141,3998195,4497336,03/01/2012 12:00:00 AM,195,290,275
Eastern,Virginia Beach City,51810,2565,13713,16278,4175,30662,34837,504828,3969017,4473845,01/01/2012 12:00:00 AM,197,289,275
Eastern,Virginia Beach City,51810,2567,14031,16598,4032,31208,35240,485480,4152433,4637913,10/01/2012 12:00:00 AM,189,296,279
Eastern,Virginia Beach City,51810,2586,11844,14430,3423,26197,29620,634845,4533438,5168283,07/01/2020 12:00:00 AM,245,383,358
Eastern,Virginia Beach City,51810,2589,13773,16362,4241,30697,34938,510570,4000831,4511401,02/01/2012 12:00:00 AM,197,290,276
Eastern,Williamsburg City,51830,423,4976,5399,468,9006,9474,44263,1188972.7,1233235.7,08/01/2016 12:00:00 AM,105,239,228
Eastern,Williamsburg City,51830,52,500,552,71,1066,1137,7355,137596,144951,02/01/2016 12:00:00 AM,141,275,263
Eastern,Williamsburg City,51830,53,495,548,76,1066,1142,7896,136711,144607,01/01/2016 12:00:00 AM,149,276,264
Eastern,Williamsburg City,51830,53,498,551,72,1033,1105,7388,131576,138964,04/01/2016 12:00:00 AM,139,264,252
Eastern,Williamsburg City,51830,55,506,561,77,1068,1145,8080,136477,144557,03/01/2016 12:00:00 AM,147,270,258
Eastern,Williamsburg City,51830,57,494,551,90,1064,1154,10639,136191,146830,12/01/2015 12:00:00 AM,187,276,266
Eastern,Williamsburg City,51830,57,498,555,85,1036,1121,9213,130047,139260,05/01/2016 12:00:00 AM,162,261,251
Eastern,Williamsburg City,51830,57,541,598,92,1158,1250,10370,151784,162154,04/01/2015 12:00:00 AM,182,281,271
Eastern,Williamsburg City,51830,61,511,572,102,1098,1200,10145,135555,145700,09/01/2014 12:00:00 AM,166,265,255
Eastern,Williamsburg City,51830,61,530,591,107,1107,1214,11843,145159,157002,02/01/2015 12:00:00 AM,194,274,266
Eastern,Williamsburg City,51830,61,541,602,101,1160,1261,11346,150160,161506,05/01/2015 12:00:00 AM,186,278,268
Eastern,Williamsburg City,51830,62,507,569,97,1082,1179,11318,139056,150374,11/01/2015 12:00:00 AM,183,274,264
Eastern,Williamsburg City,51830,62,523,585,97,1111,1208,10426,140702,151128,01/01/2015 12:00:00 AM,168,269,258
Eastern,Williamsburg City,51830,63,473,536,87,1005,1092,9651,123818,133469,11/01/2016 12:00:00 AM,153,262,249
Eastern,Williamsburg City,51830,63,505,568,93,1064,1157,10507,134205,144712,06/01/2016 12:00:00 AM,167,266,255
Eastern,Williamsburg City,51830,63,506,569,103,1082,1185,10762,140793,151555,10/01/2014 12:00:00 AM,171,278,266
Eastern,Williamsburg City,51830,63,512,575,103,1078,1181,12120,139242,151362,11/01/2014 12:00:00 AM,192,272,263
Eastern,Williamsburg City,51830,63,539,602,106,1151,1257,12113,150847,162960,06/01/2015 12:00:00 AM,192,280,271
Eastern,Williamsburg City,51830,63,550,613,112,1147,1259,12702,151925,164627,03/01/2015 12:00:00 AM,202,276,269
Eastern,Williamsburg City,51830,64,466,530,93,992,1085,9630,125918,135548,01/01/2017 12:00:00 AM,150,270,256
Eastern,Williamsburg City,51830,64,476,540,95,1011,1106,10352,125671,136023,10/01/2016 12:00:00 AM,162,264,252
Eastern,Williamsburg City,51830,64,480,544,94,1023,1117,10481,124695,135176,09/01/2016 12:00:00 AM,164,260,248
Eastern,Williamsburg City,51830,64,498,562,96,1058,1154,10880,131677,142557,07/01/2016 12:00:00 AM,170,264,254
Eastern,Williamsburg City,51830,64,518,582,105,1100,1205,12382,141480,153862,12/01/2014 12:00:00 AM,193,273,264
Eastern,Williamsburg City,51830,66,486,552,101,1048,1149,10860,132841,143701,04/01/2018 12:00:00 AM,165,273,260
Eastern,Williamsburg City,51830,66,512,578,113,1090,1203,11086,137164,148250,07/01/2014 12:00:00 AM,168,268,256
Eastern,Williamsburg City,51830,66,525,591,112,1116,1228,12407,143302,155709,07/01/2015 12:00:00 AM,188,273,263
Eastern,Williamsburg City,51830,67,471,538,98,996,1094,10702,122419,133121,12/01/2016 12:00:00 AM,160,260,247
Eastern,Williamsburg City,51830,67,480,547,105,1045,1150,11409,134061,145470,03/01/2018 12:00:00 AM,170,279,266
Eastern,Williamsburg City,51830,68,483,551,93,1072,1165,10753,138616,149369,11/01/2017 12:00:00 AM,158,287,271
Eastern,Williamsburg City,51830,68,500,568,113,1056,1169,12575,135343,147918,10/01/2015 12:00:00 AM,185,271,260
Eastern,Williamsburg City,51830,68,505,573,124,1069,1193,13669,134249,147918,06/01/2014 12:00:00 AM,201,266,258
Eastern,Williamsburg City,51830,68,520,588,117,1110,1227,11847,138333,150180,08/01/2014 12:00:00 AM,174,266,255
Eastern,Williamsburg City,51830,69,452,521,118,915,1033,21046,158762,179808,03/01/2020 12:00:00 AM,305,351,345
Eastern,Williamsburg City,51830,69,469,538,97,1034,1131,10320,132332,142652,01/01/2018 12:00:00 AM,150,282,265
Eastern,Williamsburg City,51830,69,474,543,98,1047,1145,11560,132994,144554,12/01/2017 12:00:00 AM,168,281,266
Eastern,Williamsburg City,51830,69,479,548,91,1021,1112,9014,129437,138451,02/01/2017 12:00:00 AM,131,270,253
Eastern,Williamsburg City,51830,70,478,548,103,1049,1152,10312,135034,145346,10/01/2017 12:00:00 AM,147,282,265
Eastern,Williamsburg City,51830,70,496,566,133,1025,1158,15903,137707,153610,04/01/2013 12:00:00 AM,227,278,271
Eastern,Williamsburg City,51830,70,511,581,114,1078,1192,12462,139366,151828,09/01/2015 12:00:00 AM,178,273,261
Eastern,Williamsburg City,51830,70,519,589,114,1099,1213,12578,144989,157567,08/01/2015 12:00:00 AM,180,279,268
Eastern,Williamsburg City,51830,71,456,527,122,959,1081,15730,130222,145952,06/01/2012 12:00:00 AM,222,286,277
Eastern,Williamsburg City,51830,71,504,575,109,1092,1201,11956,139868,151824,05/01/2018 12:00:00 AM,168,278,264
Eastern,Williamsburg City,51830,71,504,575,135,1057,1192,18423,152749,171172,06/01/2013 12:00:00 AM,259,303,298
Eastern,Williamsburg City,51830,71,508,579,132,1054,1186,14943,142227,157170,05/01/2013 12:00:00 AM,210,280,271
Eastern,Williamsburg City,51830,71,513,584,129,1090,1219,16519,140095,156614,10/01/2013 12:00:00 AM,233,273,268
Eastern,Williamsburg City,51830,71,517,588,130,1093,1223,16270,133772,150042,12/01/2013 12:00:00 AM,229,259,255
Eastern,Williamsburg City,51830,72,443,515,122,929,1051,15703,125768,141471,05/01/2012 12:00:00 AM,218,284,275
Eastern,Williamsburg City,51830,72,459,531,110,997,1107,11337,131276,142613,09/01/2017 12:00:00 AM,157,286,269
Eastern,Williamsburg City,51830,72,459,531,113,943,1056,12537,118012,130549,12/01/2019 12:00:00 AM,174,257,246
Eastern,Williamsburg City,51830,72,466,538,126,979,1105,15157,133623,148780,01/01/2012 12:00:00 AM,211,287,277
Eastern,Williamsburg City,51830,72,467,539,97,978,1075,9303,127762,137065,03/01/2017 12:00:00 AM,129,274,254
Eastern,Williamsburg City,51830,72,506,578,131,1066,1197,15075,135599,150674,04/01/2014 12:00:00 AM,209,268,261
Eastern,Williamsburg City,51830,72,506,578,134,1085,1219,15595,136487,152082,03/01/2014 12:00:00 AM,217,270,263
Eastern,Williamsburg City,51830,72,522,594,136,1098,1234,15903,147178,163081,07/01/2013 12:00:00 AM,221,282,275
Eastern,Williamsburg City,51830,73,445,518,121,923,1044,13674,116259,129933,01/01/2020 12:00:00 AM,187,261,251
Eastern,Williamsburg City,51830,73,451,524,120,932,1052,12921,117384,130305,02/01/2020 12:00:00 AM,177,260,249
Eastern,Williamsburg City,51830,73,456,529,124,954,1078,16427,129738,146165,04/01/2012 12:00:00 AM,225,285,276
Eastern,Williamsburg City,51830,73,458,531,101,976,1077,10771,125092,135863,04/01/2017 12:00:00 AM,148,273,256
Eastern,Williamsburg City,51830,73,463,536,111,1004,1115,11769,130350,142119,08/01/2017 12:00:00 AM,161,282,265
Eastern,Williamsburg City,51830,73,467,540,126,975,1101,15644,135348,150992,02/01/2012 12:00:00 AM,214,290,280
Eastern,Williamsburg City,51830,73,495,568,117,1074,1191,13434,141418,154852,06/01/2018 12:00:00 AM,184,286,273
Eastern,Williamsburg City,51830,73,519,592,134,1094,1228,16377,143993,160370,09/01/2013 12:00:00 AM,224,277,271
Eastern,Williamsburg City,51830,73,523,596,137,1093,1230,16118,133902,150020,01/01/2014 12:00:00 AM,221,256,252
Eastern,Williamsburg City,51830,74,460,534,123,952,1075,12926,121244,134170,10/01/2019 12:00:00 AM,175,264,251
Eastern,Williamsburg City,51830,74,466,540,110,1002,1112,11786,130616,142402,05/01/2017 12:00:00 AM,159,280,264
Eastern,Williamsburg City,51830,74,466,540,110,1006,1116,11628,128114,139742,06/01/2017 12:00:00 AM,157,275,259
Eastern,Williamsburg City,51830,74,475,549,117,1026,1143,13054,130122,143176,02/01/2018 12:00:00 AM,176,274,261
Eastern,Williamsburg City,51830,74,504,578,134,1058,1192,15530,140178,155708,01/01/2013 12:00:00 AM,210,278,269
Eastern,Williamsburg City,51830,75,428,503,109,910,1019,11853,117128,128981,02/01/2019 12:00:00 AM,158,274,256
Eastern,Williamsburg City,51830,75,460,535,130,959,1089,16800,128310,145110,07/01/2012 12:00:00 AM,224,279,271
Eastern,Williamsburg City,51830,75,475,550,135,1000,1135,14876,133809,148685,10/01/2012 12:00:00 AM,198,282,270
Eastern,Williamsburg City,51830,75,515,590,145,1074,1219,17535,135893,153428,02/01/2014 12:00:00 AM,234,264,260
Eastern,Williamsburg City,51830,75,530,605,112,1110,1222,24647,237609,262256,02/01/2021 12:00:00 AM,329,448,433
Eastern,Williamsburg City,51830,76,453,529,122,928,1050,13923,116892,130815,08/01/2019 12:00:00 AM,183,258,247
Eastern,Williamsburg City,51830,76,475,551,114,1026,1140,11568,134828,146396,07/01/2017 12:00:00 AM,152,284,266
Eastern,Williamsburg City,51830,76,477,553,131,998,1129,16618,136201,152819,03/01/2012 12:00:00 AM,219,286,276
Eastern,Williamsburg City,51830,76,485,561,155,984,1139,18970,134382,153352,03/01/2013 12:00:00 AM,250,277,273
Eastern,Williamsburg City,51830,76,502,578,146,1046,1192,17377,131718,149095,05/01/2014 12:00:00 AM,229,262,258
Eastern,Williamsburg City,51830,76,503,579,139,1054,1193,16202,142919,159121,02/01/2013 12:00:00 AM,213,284,275
Eastern,Williamsburg City,51830,76,526,602,139,1100,1239,17019,145946,162965,08/01/2013 12:00:00 AM,224,277,271
Eastern,Williamsburg City,51830,77,458,535,126,925,1051,13917,118246,132163,11/01/2019 12:00:00 AM,181,258,247
Eastern,Williamsburg City,51830,77,460,537,143,965,1108,16826,130433,147259,09/01/2012 12:00:00 AM,219,284,274
Eastern,Williamsburg City,51830,77,485,562,125,1039,1164,14721,132939,147660,07/01/2018 12:00:00 AM,191,274,263
Eastern,Williamsburg City,51830,77,494,571,139,1043,1182,15585,140500,156085,12/01/2012 12:00:00 AM,202,284,273
Eastern,Williamsburg City,51830,77,499,576,133,1009,1142,22967,176687,199654,04/01/2020 12:00:00 AM,298,354,347
Eastern,Williamsburg City,51830,78,441,519,126,921,1047,13713,112391,126104,09/01/2019 12:00:00 AM,176,255,243
Eastern,Williamsburg City,51830,78,482,560,131,1037,1168,15503,134654,150157,08/01/2018 12:00:00 AM,199,279,268
Eastern,Williamsburg City,51830,79,450,529,124,924,1048,13396,117625,131021,05/01/2019 12:00:00 AM,170,261,248
Eastern,Williamsburg City,51830,79,481,560,145,1017,1162,16166,136552,152718,11/01/2012 12:00:00 AM,205,284,273
Eastern,Williamsburg City,51830,79,487,566,125,1040,1165,14737,136273.5,151010.5,10/01/2018 12:00:00 AM,187,280,267
Eastern,Williamsburg City,51830,79,487,566,126,1036,1162,14710,132391,147101,09/01/2018 12:00:00 AM,186,272,260
Eastern,Williamsburg City,51830,79,513,592,134,1045,1179,23896,181249,205145,05/01/2020 12:00:00 AM,302,353,347
Eastern,Williamsburg City,51830,79,537,616,117,1105,1222,25493,237021,262514,03/01/2021 12:00:00 AM,323,441,426
Eastern,Williamsburg City,51830,80,471,551,127,1012,1139,14412,130905,145317,12/01/2018 12:00:00 AM,180,278,264
Eastern,Williamsburg City,51830,80,514,594,136,1049,1185,24066,184616,208682,06/01/2020 12:00:00 AM,301,359,351
Eastern,Williamsburg City,51830,81,444,525,120,905,1025,12791,113612,126403,07/01/2019 12:00:00 AM,158,256,241
Eastern,Williamsburg City,51830,81,452,533,126,927,1053,14133,116422,130555,06/01/2019 12:00:00 AM,174,258,245
Eastern,Williamsburg City,51830,81,465,546,147,963,1110,17210,127551,144761,08/01/2012 12:00:00 AM,212,274,265
Eastern,Williamsburg City,51830,81,541,622,118,1107,1225,30674,259360,290034,04/01/2021 12:00:00 AM,379,479,466
Eastern,Williamsburg City,51830,82,439,521,128,920,1048,13920,116421,130341,04/01/2019 12:00:00 AM,170,265,250
Eastern,Williamsburg City,51830,82,502,584,133,1046,1179,24016,181771,205787,09/01/2020 12:00:00 AM,293,362,352
Eastern,Williamsburg City,51830,82,526,608,139,1082,1221,25549,188907,214456,07/01/2020 12:00:00 AM,312,359,353
Eastern,Williamsburg City,51830,83,431,514,127,915,1042,14980,114973,129953,03/01/2019 12:00:00 AM,180,267,253
Eastern,Williamsburg City,51830,83,444,527,126,950,1076,15881,128029,143910,01/01/2019 12:00:00 AM,191,288,273
Eastern,Williamsburg City,51830,83,482,565,127,1032,1159,15138,133582,148720,11/01/2018 12:00:00 AM,182,277,263
Eastern,Williamsburg City,51830,83,504,587,138,1043,1181,29358,218419,247777,01/01/2021 12:00:00 AM,354,433,422
Eastern,Williamsburg City,51830,83,522,605,141,1079,1220,24564,188916,213480,08/01/2020 12:00:00 AM,296,362,353
Eastern,Williamsburg City,51830,85,545,630,130,1119,1249,27762,260667,288429,05/01/2021 12:00:00 AM,327,478,458
Eastern,Williamsburg City,51830,86,497,583,143,1028,1171,26953,190032,216985,12/01/2020 12:00:00 AM,313,382,372
Eastern,Williamsburg City,51830,86,503,589,138,1024,1162,25804,193345,219149,10/01/2020 12:00:00 AM,300,384,372
Eastern,Williamsburg City,51830,86,547,633,135,1110,1245,32584,255770,288354,06/01/2021 12:00:00 AM,379,468,456
Eastern,Williamsburg City,51830,88,488,576,149,1005,1154,27527,184405,211932,11/01/2020 12:00:00 AM,313,378,368
Eastern,York County,51199,157,759,916,234,1771,2005,25967,223841.45,249808.45,10/01/2018 12:00:00 AM,165,295,273
Eastern,York County,51199,157,801,958,244,1878,2122,25875,231437,257312,10/01/2019 12:00:00 AM,165,289,269
Eastern,York County,51199,158,801,959,240,1884,2124,26214,229393,255607,12/01/2018 12:00:00 AM,166,286,267
Eastern,York County,51199,159,1051,1210,219,2373,2592,51465,539242,590707,04/01/2021 12:00:00 AM,324,513,488
Eastern,York County,51199,159,1075,1234,222,2423,2645,50430,499907,550337,03/01/2021 12:00:00 AM,317,465,446
Eastern,York County,51199,159,770,929,244,1803,2047,27732,224903,252635,11/01/2018 12:00:00 AM,174,292,272
Eastern,York County,51199,159,782,941,253,1833,2086,27885,220994,248879,11/01/2019 12:00:00 AM,175,283,264
Eastern,York County,51199,159,817,976,237,1919,2156,24222,241412,265634,01/01/2019 12:00:00 AM,152,295,272
Eastern,York County,51199,160,1037,1197,232,2366,2598,53249,536561,589810,05/01/2021 12:00:00 AM,333,517,493
Eastern,York County,51199,160,773,933,238,1849,2087,27028,224514,251542,08/01/2018 12:00:00 AM,169,290,270
Eastern,York County,51199,160,787,947,243,1870,2113,25362,228539,253901,07/01/2019 12:00:00 AM,159,290,268
Eastern,York County,51199,161,1079,1240,225,2460,2685,49596,516418,566014,02/01/2021 12:00:00 AM,308,479,456
Eastern,York County,51199,161,873,1034,230,2142,2372,25181,262502,287683,09/01/2017 12:00:00 AM,156,301,278
Eastern,York County,51199,162,1022,1184,235,2343,2578,45161,429187,474348,11/01/2020 12:00:00 AM,279,420,401
Eastern,York County,51199,162,1058,1220,230,2423,2653,49115,500779,549894,01/01/2021 12:00:00 AM,303,473,451
Eastern,York County,51199,162,784,946,250,1831,2081,26974,215324,242298,08/01/2019 12:00:00 AM,167,275,256
Eastern,York County,51199,162,795,957,257,1895,2152,27364,224872,252236,09/01/2019 12:00:00 AM,169,283,264
Eastern,York County,51199,162,804,966,257,1887,2144,27474,225642,253116,12/01/2019 12:00:00 AM,170,281,262
Eastern,York County,51199,163,860,1023,231,2111,2342,22753,257941,280694,07/01/2017 12:00:00 AM,140,300,274
Eastern,York County,51199,163,870,1033,243,2133,2376,25864,257800,283664,05/01/2017 12:00:00 AM,159,296,275
Eastern,York County,51199,163,877,1040,243,2110,2353,27943,257842,285785,10/01/2017 12:00:00 AM,171,294,275
Eastern,York County,51199,164,1005,1169,243,2309,2552,47222,419496,466718,10/01/2020 12:00:00 AM,288,417,399
Eastern,York County,51199,164,1033,1197,244,2359,2603,58611,533307,591918,06/01/2021 12:00:00 AM,357,516,495
Eastern,York County,51199,164,1045,1209,233,2368,2601,45567,433483,479050,12/01/2020 12:00:00 AM,278,415,396
Eastern,York County,51199,164,743,907,247,1751,1998,27989,215678,243667,09/01/2018 12:00:00 AM,171,290,269
Eastern,York County,51199,164,802,966,247,1915,2162,28508,230755,259263,07/01/2018 12:00:00 AM,174,288,268
Eastern,York County,51199,165,869,1034,226,2147,2373,23028,264092,287120,08/01/2017 12:00:00 AM,140,304,278
Eastern,York County,51199,165,878,1043,237,2137,2374,24825,258016,282841,06/01/2017 12:00:00 AM,150,294,271
Eastern,York County,51199,166,864,1030,245,2066,2311,27325,249691,277016,11/01/2017 12:00:00 AM,165,289,269
Eastern,York County,51199,166,864,1030,251,2071,2322,27908,253586,281494,04/01/2018 12:00:00 AM,168,294,273
Eastern,York County,51199,166,875,1041,254,2130,2384,27364,252572,279936,04/01/2017 12:00:00 AM,165,289,269
Eastern,York County,51199,167,791,958,249,1849,2098,25760,222928,248688,05/01/2019 12:00:00 AM,154,282,260
Eastern,York County,51199,168,754,922,262,1769,2031,27735,212404,240139,02/01/2019 12:00:00 AM,165,282,260
Eastern,York County,51199,168,777,945,258,1806,2064,26285,218400,244685,04/01/2019 12:00:00 AM,156,281,259
Eastern,York County,51199,168,782,950,254,1828,2082,26124,221985,248109,06/01/2019 12:00:00 AM,156,284,261
Eastern,York County,51199,168,892,1060,259,2173,2432,28678,253584,282262,03/01/2017 12:00:00 AM,171,284,266
Eastern,York County,51199,168,989,1157,251,2250,2501,46652,392597,439249,09/01/2020 12:00:00 AM,278,397,380
Eastern,York County,51199,169,786,955,251,1826,2077,26412,223375,249787,03/01/2019 12:00:00 AM,156,284,262
Eastern,York County,51199,169,824,993,258,1976,2234,30696,238816,269512,06/01/2018 12:00:00 AM,182,290,271
Eastern,York County,51199,169,875,1044,253,2098,2351,27256,247529,274785,12/01/2017 12:00:00 AM,161,283,263
Eastern,York County,51199,169,967,1136,260,2194,2454,47034,382196,429230,06/01/2020 12:00:00 AM,278,395,378
Eastern,York County,51199,170,821,991,260,1909,2169,47327,328799,376126,03/01/2020 12:00:00 AM,278,400,380
Eastern,York County,51199,170,844,1014,252,2040,2292,29615,241791,271406,05/01/2018 12:00:00 AM,174,286,268
Eastern,York County,51199,170,887,1057,264,2137,2401,28110,258330,286440,02/01/2018 12:00:00 AM,165,291,271
Eastern,York County,51199,170,926,1096,265,2277,2542,28664,264588,293252,02/01/2017 12:00:00 AM,169,286,268
Eastern,York County,51199,170,977,1147,263,2213,2476,47050,377529,424579,08/01/2020 12:00:00 AM,277,386,370
Eastern,York County,51199,171,798,969,273,1839,2112,29979,216963,246942,02/01/2020 12:00:00 AM,175,272,255
Eastern,York County,51199,171,922,1093,275,2233,2508,29447,257239,286686,01/01/2017 12:00:00 AM,172,279,262
Eastern,York County,51199,172,889,1061,260,2138,2398,28364,253202,281566,01/01/2018 12:00:00 AM,165,285,265
Eastern,York County,51199,172,928,1100,267,2118,2385,48277,368820,417097,04/01/2020 12:00:00 AM,281,397,379
Eastern,York County,51199,173,902,1075,271,2182,2453,31343,265489,296832,03/01/2018 12:00:00 AM,181,294,276
Eastern,York County,51199,173,971,1144,270,2194,2464,48838,376211,425049,07/01/2020 12:00:00 AM,282,387,372
Eastern,York County,51199,174,792,966,276,1829,2105,29996,218970,248966,01/01/2020 12:00:00 AM,172,276,258
Eastern,York County,51199,178,912,1090,288,2246,2534,31736,261409,293145,12/01/2016 12:00:00 AM,178,287,269
Eastern,York County,51199,179,945,1124,289,2153,2442,51756,373123,424879,05/01/2020 12:00:00 AM,289,395,378
Eastern,York County,51199,183,907,1090,301,2232,2533,33121,261549,294670,11/01/2016 12:00:00 AM,181,288,270
Eastern,York County,51199,184,930,1114,310,2228,2538,33648,261021,294669,05/01/2016 12:00:00 AM,183,281,265
Eastern,York County,51199,185,1006,1191,321,2355,2676,34162,280676,314838,07/01/2015 12:00:00 AM,185,279,264
Eastern,York County,51199,185,1027,1212,323,2372,2695,36733,288325,325058,05/01/2015 12:00:00 AM,199,281,268
Eastern,York County,51199,186,925,1111,317,2249,2566,34656,266230,300886,07/01/2016 12:00:00 AM,186,288,271
Eastern,York County,51199,186,931,1117,325,2247,2572,36197,267306,303503,06/01/2016 12:00:00 AM,195,287,272
Eastern,York County,51199,187,1012,1199,324,2366,2690,35730,284858,320588,06/01/2015 12:00:00 AM,191,281,267
Eastern,York County,51199,188,1016,1204,327,2337,2664,36257,284097,320354,04/01/2015 12:00:00 AM,193,280,266
Eastern,York County,51199,188,981,1169,331,2284,2615,36573,274329,310902,08/01/2015 12:00:00 AM,195,280,266
Eastern,York County,51199,189,1023,1212,333,2340,2673,36472,286869,323341,02/01/2015 12:00:00 AM,193,280,267
Eastern,York County,51199,190,1023,1213,335,2348,2683,36849,285423,322272,03/01/2015 12:00:00 AM,194,279,266
Eastern,York County,51199,190,965,1155,330,2303,2633,36150,275411,311561,02/01/2016 12:00:00 AM,190,285,270
Eastern,York County,51199,191,897,1088,326,2190,2516,36021,254715,290736,10/01/2016 12:00:00 AM,189,284,267
Eastern,York County,51199,191,916,1107,319,2230,2549,35383,260701,296084,09/01/2016 12:00:00 AM,185,285,267
Eastern,York County,51199,191,979,1170,329,2299,2628,36144,275420,311564,09/01/2015 12:00:00 AM,189,281,266
Eastern,York County,51199,191,985,1176,337,2312,2649,39123,279789,318912,11/01/2015 12:00:00 AM,205,284,271
Eastern,York County,51199,192,1044,1236,335,2387,2722,36976,286982,323958,01/01/2015 12:00:00 AM,193,275,262
Eastern,York County,51199,192,931,1123,338,2226,2564,36500,264499,300999,04/01/2016 12:00:00 AM,190,284,268
Eastern,York County,51199,193,1049,1242,337,2365,2702,37774,291031,328805,12/01/2014 12:00:00 AM,196,277,265
Eastern,York County,51199,193,944,1137,343,2236,2579,38138,265007,303145,03/01/2016 12:00:00 AM,198,281,267
Eastern,York County,51199,193,969,1162,343,2286,2629,39873,274221,314094,12/01/2015 12:00:00 AM,207,283,270
Eastern,York County,51199,194,918,1112,328,2242,2570,37296,264430,301726,08/01/2016 12:00:00 AM,192,288,271
Eastern,York County,51199,194,970,1164,340,2290,2630,38156,269400,307556,01/01/2016 12:00:00 AM,197,278,264
Eastern,York County,51199,194,985,1179,347,2308,2655,40933,278573,319506,10/01/2015 12:00:00 AM,211,283,271
Eastern,York County,51199,197,1081,1278,352,2465,2817,41583,304528,346111,10/01/2014 12:00:00 AM,211,282,271
Eastern,York County,51199,197,1130,1327,342,2563,2905,37943,303198,341141,08/01/2014 12:00:00 AM,193,268,257
Eastern,York County,51199,201,1087,1288,356,2517,2873,42115,330914,373029,08/01/2012 12:00:00 AM,210,304,290
Eastern,York County,51199,202,1126,1328,349,2547,2896,38204,310552,348756,05/01/2014 12:00:00 AM,189,276,263
Eastern,York County,51199,203,1061,1264,363,2407,2770,41880,298326,340206,11/01/2014 12:00:00 AM,206,281,269
Eastern,York County,51199,203,1073,1276,356,2517,2873,42238,326818,369056,06/01/2012 12:00:00 AM,208,305,289
Eastern,York County,51199,204,1120,1324,359,2541,2900,41012,299659,340671,07/01/2014 12:00:00 AM,201,268,257
Eastern,York County,51199,205,1045,1250,379,2437,2816,44796,316660,361456,07/01/2012 12:00:00 AM,219,303,289
Eastern,York County,51199,205,1129,1334,357,2551,2908,38882,306865,345747,04/01/2014 12:00:00 AM,190,272,259
Eastern,York County,51199,206,1097,1303,363,2493,2856,40965,300249,341214,09/01/2014 12:00:00 AM,199,274,262
Eastern,York County,51199,206,1103,1309,367,2517,2884,43646,334136,377782,09/01/2012 12:00:00 AM,212,303,289
Eastern,York County,51199,207,1050,1257,387,2403,2790,49332,313862,363194,03/01/2012 12:00:00 AM,238,299,289
Eastern,York County,51199,208,1057,1265,397,2397,2794,50640,315418,366058,02/01/2012 12:00:00 AM,243,298,289
Eastern,York County,51199,208,1068,1276,376,2489,2865,45797,324085,369882,05/01/2012 12:00:00 AM,220,303,290
Eastern,York County,51199,208,1132,1340,372,2555,2927,40130,302392,342522,03/01/2014 12:00:00 AM,193,267,256
Eastern,York County,51199,208,1155,1363,365,2616,2981,39421,312479,351900,02/01/2014 12:00:00 AM,190,271,258
Eastern,York County,51199,209,1064,1273,386,2451,2837,48534,318284,366818,04/01/2012 12:00:00 AM,232,299,288
Eastern,York County,51199,209,1122,1331,369,2550,2919,40260,299713,339973,01/01/2014 12:00:00 AM,193,267,255
Eastern,York County,51199,209,1136,1345,370,2553,2923,42926,304504,347430,06/01/2014 12:00:00 AM,205,268,258
Eastern,York County,51199,209,1136,1345,372,2561,2933,40647,305572,346219,12/01/2013 12:00:00 AM,194,269,257
Eastern,York County,51199,210,1046,1256,400,2369,2769,49845,308175,358020,01/01/2012 12:00:00 AM,237,295,285
Eastern,York County,51199,210,1121,1331,382,2539,2921,46272,333230,379502,12/01/2012 12:00:00 AM,220,297,285
Eastern,York County,51199,211,1120,1331,376,2489,2865,45385,321791,367176,10/01/2013 12:00:00 AM,215,287,276
Eastern,York County,51199,212,1102,1314,390,2497,2887,46918,331442,378360,10/01/2012 12:00:00 AM,221,301,288
Eastern,York County,51199,213,1119,1332,388,2531,2919,46941,332321,379262,11/01/2012 12:00:00 AM,220,297,285
Eastern,York County,51199,213,1120,1333,383,2545,2928,46762,329616,376378,01/01/2013 12:00:00 AM,220,294,282
Eastern,York County,51199,213,1140,1353,374,2582,2956,46954,331709,378663,08/01/2013 12:00:00 AM,220,291,280
Eastern,York County,51199,214,1100,1314,372,2501,2873,46452,325857,372309,07/01/2013 12:00:00 AM,217,296,283
Eastern,York County,51199,214,1134,1348,380,2521,2901,41196,302448,343644,11/01/2013 12:00:00 AM,193,267,255
Eastern,York County,51199,216,1106,1322,387,2545,2932,48509,335740,384249,03/01/2013 12:00:00 AM,225,304,291
Eastern,York County,51199,216,1118,1334,388,2496,2884,47837,321946,369783,09/01/2013 12:00:00 AM,221,288,277
Eastern,York County,51199,217,1093,1310,375,2513,2888,47231,332408,379639,06/01/2013 12:00:00 AM,218,304,290
Eastern,York County,51199,218,1090,1308,378,2535,2913,46544,333957,380501,05/01/2013 12:00:00 AM,214,306,291
Eastern,York County,51199,219,1103,1322,389,2548,2937,47909,336304,384213,04/01/2013 12:00:00 AM,219,305,291
Eastern,York County,51199,220,1117,1337,396,2547,2943,49961,333265,383226,02/01/2013 12:00:00 AM,227,298,287
Northern,Alexandria City,51510,1003,3218,4221,1756,6839,8595,184085,893016,1077101,01/01/2019 12:00:00 AM,184,278,255
Northern,Alexandria City,51510,1007,3206,4213,1762,6922,8684,184485,876087,1060572,12/01/2018 12:00:00 AM,183,273,252
Northern,Alexandria City,51510,1014,3308,4322,1807,7156,8963,192135,908823.2,1100958.2,04/01/2017 12:00:00 AM,189,275,255
Northern,Alexandria City,51510,1016,3252,4268,1775,7037,8812,183496,885530,1069026,11/01/2018 12:00:00 AM,181,272,250
Northern,Alexandria City,51510,1021,3433,4454,1755,7412,9167,177475,906626,1084101,09/01/2016 12:00:00 AM,174,264,243
Northern,Alexandria City,51510,1026,3250,4276,1836,7040,8876,193844,879753,1073597,10/01/2018 12:00:00 AM,189,271,251
Northern,Alexandria City,51510,1027,3387,4414,1773,7275,9048,176522,893112,1069634,07/01/2016 12:00:00 AM,172,264,242
Northern,Alexandria City,51510,1028,3357,4385,1782,7207,8989,181064,881916,1062980,06/01/2016 12:00:00 AM,176,263,242
Northern,Alexandria City,51510,1029,3282,4311,1835,7073,8908,190262,878656,1068918,09/01/2018 12:00:00 AM,185,268,248
Northern,Alexandria City,51510,1029,3305,4334,1868,7095,8963,192852,882545,1075397,08/01/2018 12:00:00 AM,187,267,248
Northern,Alexandria City,51510,1029,3350,4379,1773,7183,8956,182955,889514,1072469,07/01/2015 12:00:00 AM,178,266,245
Northern,Alexandria City,51510,1029,3410,4439,1773,7364,9137,176442,909310,1085752,08/01/2016 12:00:00 AM,171,267,245
Northern,Alexandria City,51510,1032,3335,4367,1798,7136,8934,178856,888875,1067731,06/01/2015 12:00:00 AM,173,267,244
Northern,Alexandria City,51510,1032,3394,4426,1797,7369,9166,184786,914807,1099593,11/01/2016 12:00:00 AM,179,270,248
Northern,Alexandria City,51510,1034,3444,4478,1811,7439,9250,186432,920471,1106903,10/01/2016 12:00:00 AM,180,267,247
Northern,Alexandria City,51510,1034,3461,4495,1813,7458,9271,186137,929536.54,1115673.54,01/01/2017 12:00:00 AM,180,269,248
Northern,Alexandria City,51510,1035,3330,4365,1764,7134,8898,179611,883211,1062822,08/01/2015 12:00:00 AM,174,265,243
Northern,Alexandria City,51510,1036,3342,4378,1892,7239,9131,206768,928151,1134919,05/01/2017 12:00:00 AM,200,278,259
Northern,Alexandria City,51510,1037,3445,4482,1714,7046,8760,165236,863839,1029075,05/01/2014 12:00:00 AM,159,251,230
Northern,Alexandria City,51510,1041,3427,4468,1823,7408,9231,189306,918617,1107923,12/01/2016 12:00:00 AM,182,268,248
Northern,Alexandria City,51510,1043,3262,4305,1949,6991,8940,205129,873028,1078157,07/01/2018 12:00:00 AM,197,268,250
Northern,Alexandria City,51510,1043,3335,4378,1828,7075,8903,184102,886399,1070501,05/01/2015 12:00:00 AM,177,266,245
Northern,Alexandria City,51510,1045,3289,4334,1947,7016,8963,204208,873958,1078166,06/01/2018 12:00:00 AM,195,266,249
Northern,Alexandria City,51510,1046,3495,4541,1798,7583,9381,183127,944957,1128084,02/01/2017 12:00:00 AM,175,270,248
Northern,Alexandria City,51510,1049,3345,4394,1847,7174,9021,189646,884831,1074477,05/01/2016 12:00:00 AM,181,265,245
Northern,Alexandria City,51510,1052,3331,4383,1831,7171,9002,189512,880320,1069832,04/01/2016 12:00:00 AM,180,264,244
Northern,Alexandria City,51510,1054,3314,4368,1846,7009,8855,187254,876816,1064070,04/01/2015 12:00:00 AM,178,265,244
Northern,Alexandria City,51510,1055,3373,4428,1969,7163,9132,208207,898960,1107167,04/01/2018 12:00:00 AM,197,267,250
Northern,Alexandria City,51510,1056,3322,4378,1824,7073,8897,187022,877620,1064642,09/01/2015 12:00:00 AM,177,264,243
Northern,Alexandria City,51510,1057,3313,4370,1853,7150,9003,189656,889171,1078827,12/01/2015 12:00:00 AM,179,268,247
Northern,Alexandria City,51510,1060,3307,4367,1976,7039,9015,209857,879803,1089660,05/01/2018 12:00:00 AM,198,266,250
Northern,Alexandria City,51510,1061,3645,4706,1708,7344,9052,160764,918516,1079280,12/01/2013 12:00:00 AM,152,252,229
Northern,Alexandria City,51510,1063,3320,4383,1840,7073,8913,187508,881571,1069079,10/01/2015 12:00:00 AM,176,266,244
Northern,Alexandria City,51510,1063,3339,4402,1851,7202,9053,191998,879867,1071865,03/01/2016 12:00:00 AM,181,264,243
Northern,Alexandria City,51510,1063,3687,4750,1691,7431,9122,158925,921571,1080496,11/01/2013 12:00:00 AM,150,250,227
Northern,Alexandria City,51510,1064,3293,4357,1882,7072,8954,196966,871400,1068366,02/01/2016 12:00:00 AM,185,265,245
Northern,Alexandria City,51510,1064,3370,4434,1955,7273,9228,212740,926082,1138822,06/01/2017 12:00:00 AM,200,275,257
Northern,Alexandria City,51510,1066,3269,4335,1879,7044,8923,189927,867086,1057013,01/01/2016 12:00:00 AM,178,265,244
Northern,Alexandria City,51510,1067,3316,4383,1853,7097,8950,187753,877591,1065344,11/01/2015 12:00:00 AM,176,265,243
Northern,Alexandria City,51510,1067,3414,4481,1765,6982,8747,175547,853797,1029344,06/01/2014 12:00:00 AM,165,250,230
Northern,Alexandria City,51510,1069,3411,4480,1794,7017,8811,177142,858317,1035459,07/01/2014 12:00:00 AM,166,252,231
Northern,Alexandria City,51510,1069,3699,4768,1710,7422,9132,177489,996532,1174021,10/01/2013 12:00:00 AM,166,269,246
Northern,Alexandria City,51510,1070,3305,4375,1890,6974,8864,195435,877658,1073093,03/01/2015 12:00:00 AM,183,266,245
Northern,Alexandria City,51510,1070,3368,4438,2047,7166,9213,218613,905168,1123781,03/01/2018 12:00:00 AM,204,269,253
Northern,Alexandria City,51510,1070,3498,4568,1786,7143,8929,174535,882323,1056858,03/01/2014 12:00:00 AM,163,252,231
Northern,Alexandria City,51510,1071,3361,4432,2005,7227,9232,214960,915692,1130652,07/01/2017 12:00:00 AM,201,272,255
Northern,Alexandria City,51510,1078,3381,4459,1803,6958,8761,180454,854236,1034690,08/01/2014 12:00:00 AM,167,253,232
Northern,Alexandria City,51510,1081,3334,4415,2096,7082,9178,222868,890474,1113342,02/01/2018 12:00:00 AM,206,267,252
Northern,Alexandria City,51510,1082,3462,4544,1830,7072,8902,179440,870523,1049963,04/01/2014 12:00:00 AM,166,251,231
Northern,Alexandria City,51510,1083,3537,4620,1820,7193,9013,178745,886464,1065209,02/01/2014 12:00:00 AM,165,251,231
Northern,Alexandria City,51510,1084,3339,4423,1849,6912,8761,184602,842011,1026613,09/01/2014 12:00:00 AM,170,252,232
Northern,Alexandria City,51510,1085,3581,4666,1794,7227,9021,173992,887507,1061499,01/01/2014 12:00:00 AM,160,248,227
Northern,Alexandria City,51510,1088,3385,4473,2080,7207,9287,225174,923046,1148220,09/01/2017 12:00:00 AM,207,273,257
Northern,Alexandria City,51510,1089,3210,4299,1933,6792,8725,200730,852882,1053612,02/01/2015 12:00:00 AM,184,266,245
Northern,Alexandria City,51510,1090,3350,4440,1888,7059,8947,193422,891089,1084511,12/01/2014 12:00:00 AM,177,266,244
Northern,Alexandria City,51510,1090,3365,4455,1865,7070,8935,194025,891116,1085141,11/01/2014 12:00:00 AM,178,265,244
Northern,Alexandria City,51510,1091,3369,4460,1877,7037,8914,199600,885304,1084904,10/01/2014 12:00:00 AM,183,263,243
Northern,Alexandria City,51510,1091,3682,4773,1777,7367,9144,189009,993004,1182013,09/01/2013 12:00:00 AM,173,270,248
Northern,Alexandria City,51510,1092,3387,4479,2066,7222,9288,220913,910674,1131587,10/01/2017 12:00:00 AM,202,269,253
Northern,Alexandria City,51510,1094,3275,4369,1916,6909,8825,193633,854329,1047962,01/01/2015 12:00:00 AM,177,261,240
Northern,Alexandria City,51510,1094,3422,4516,2114,7254,9368,221623,912623,1134246,01/01/2018 12:00:00 AM,203,267,251
Northern,Alexandria City,51510,1094,3683,4777,1772,7372,9144,184949,985211,1170160,08/01/2013 12:00:00 AM,169,268,245
Northern,Alexandria City,51510,1095,3367,4462,2058,7192,9250,222508,908454,1130962,08/01/2017 12:00:00 AM,203,270,253
Northern,Alexandria City,51510,1098,3427,4525,2107,7268,9375,226205,922019,1148224,11/01/2017 12:00:00 AM,206,269,254
Northern,Alexandria City,51510,1105,3656,4761,1805,7304,9109,191214,970172,1161386,07/01/2013 12:00:00 AM,173,265,244
Northern,Alexandria City,51510,1108,3426,4534,2153,7276,9429,230662,913359,1144021,12/01/2017 12:00:00 AM,208,267,252
Northern,Alexandria City,51510,1139,3591,4730,1887,7111,8998,204831,945079,1149910,03/01/2013 12:00:00 AM,180,263,243
Northern,Alexandria City,51510,1139,3616,4755,1873,7155,9028,202415,956667,1159082,04/01/2013 12:00:00 AM,178,265,244
Northern,Alexandria City,51510,1140,3591,4731,1880,7128,9008,202407,952880,1155287,02/01/2013 12:00:00 AM,178,265,244
Northern,Alexandria City,51510,1143,3669,4812,1900,7310,9210,203847,971435,1175282,06/01/2013 12:00:00 AM,178,265,244
Northern,Alexandria City,51510,1147,3549,4696,1879,7082,8961,199909,941685,1141594,01/01/2013 12:00:00 AM,174,265,243
Northern,Alexandria City,51510,1147,3646,4793,1904,7233,9137,203997,966106,1170103,05/01/2013 12:00:00 AM,178,265,244
Northern,Alexandria City,51510,1148,3532,4680,1902,7013,8915,205200,953257,1158457,07/01/2012 12:00:00 AM,179,270,248
Northern,Alexandria City,51510,1148,3552,4700,1872,7000,8872,197895,951568,1149463,06/01/2012 12:00:00 AM,172,268,245
Northern,Alexandria City,51510,1154,3579,4733,1876,7156,9032,204258,956401,1160659,12/01/2012 12:00:00 AM,177,267,245
Northern,Alexandria City,51510,1157,3536,4693,1929,7007,8936,211676,944335,1156011,08/01/2012 12:00:00 AM,183,267,246
Northern,Alexandria City,51510,1158,3571,4729,1921,6940,8861,206588,947673,1154261,05/01/2012 12:00:00 AM,178,265,244
Northern,Alexandria City,51510,1160,3568,4728,1894,7125,9019,206689,953779,1160468,11/01/2012 12:00:00 AM,178,267,245
Northern,Alexandria City,51510,1162,3484,4646,1934,6898,8832,212800,922085,1134885,09/01/2012 12:00:00 AM,183,265,244
Northern,Alexandria City,51510,1165,3513,4678,1914,7004,8918,212434,942384,1154818,10/01/2012 12:00:00 AM,182,268,247
Northern,Alexandria City,51510,1182,3584,4766,1971,6938,8909,214586,947371,1161957,04/01/2012 12:00:00 AM,182,264,244
Northern,Alexandria City,51510,1190,3640,4830,1981,7008,8989,216680,954899,1171579,03/01/2012 12:00:00 AM,182,262,243
Northern,Alexandria City,51510,1191,3635,4826,2006,6977,8983,219706,947334,1167040,02/01/2012 12:00:00 AM,184,261,242
Northern,Alexandria City,51510,1204,3603,4807,2038,6929,8967,223085,932094,1155179,01/01/2012 12:00:00 AM,185,259,240
Northern,Alexandria City,51510,814,3880,4694,1059,8456,9515,239601,1805036,2044637,02/01/2021 12:00:00 AM,294,465,436
Northern,Alexandria City,51510,847,3853,4700,1180,8334,9514,264470,1752265,2016735,03/01/2021 12:00:00 AM,312,455,429
Northern,Alexandria City,51510,851,3843,4694,1219,8171,9390,280072,1883759,2163831,04/01/2021 12:00:00 AM,329,490,461
Northern,Alexandria City,51510,856,2961,3817,1292,6519,7811,232647,1125414,1358061,03/01/2020 12:00:00 AM,272,380,356
Northern,Alexandria City,51510,866,3802,4668,1257,8047,9304,287855,1891081,2178936,05/01/2021 12:00:00 AM,332,497,467
Northern,Alexandria City,51510,867,2895,3762,1314,6331,7645,124990,791773,916763,02/01/2020 12:00:00 AM,144,273,244
Northern,Alexandria City,51510,877,2873,3750,1353,6292,7645,131308,784264,915572,01/01/2020 12:00:00 AM,150,273,244
Northern,Alexandria City,51510,879,3743,4622,1275,8033,9308,277884,1709391,1987275,01/01/2021 12:00:00 AM,316,457,430
Northern,Alexandria City,51510,879,3770,4649,1296,7942,9238,297018,1851094,2148112,06/01/2021 12:00:00 AM,338,491,462
Northern,Alexandria City,51510,885,3681,4566,1302,7916,9218,248585,1479724,1728309,11/01/2020 12:00:00 AM,281,402,379
Northern,Alexandria City,51510,885,3735,4620,1284,8001,9285,247610,1488372,1735982,12/01/2020 12:00:00 AM,280,398,376
Northern,Alexandria City,51510,897,2979,3876,1389,6488,7877,136576,810337,946913,11/01/2019 12:00:00 AM,152,272,244
Northern,Alexandria City,51510,898,2991,3889,1397,6503,7900,137587,827391,964978,10/01/2019 12:00:00 AM,153,277,248
Northern,Alexandria City,51510,898,3426,4324,1416,7405,8821,256729,1289089,1545818,04/01/2020 12:00:00 AM,286,376,357
Northern,Alexandria City,51510,898,3757,4655,1332,8026,9358,253588,1466833,1720421,10/01/2020 12:00:00 AM,282,390,370
Northern,Alexandria City,51510,900,2962,3862,1394,6466,7860,136639,820786,957425,12/01/2019 12:00:00 AM,152,277,248
Northern,Alexandria City,51510,908,3831,4739,1360,8158,9518,244685,1412733,1657418,09/01/2020 12:00:00 AM,269,369,350
Northern,Alexandria City,51510,910,3071,3981,1435,6683,8118,138048,830171,968219,08/01/2019 12:00:00 AM,152,270,243
Northern,Alexandria City,51510,918,3029,3947,1445,6523,7968,139060,830817,969877,09/01/2019 12:00:00 AM,151,274,246
Northern,Alexandria City,51510,918,3865,4783,1380,8256,9636,248335,1410775,1659110,08/01/2020 12:00:00 AM,271,365,347
Northern,Alexandria City,51510,919,3120,4039,1464,6764,8228,141822,847043,988865,07/01/2019 12:00:00 AM,154,271,245
Northern,Alexandria City,51510,927,3689,4616,1483,7844,9327,266025,1359716,1625741,05/01/2020 12:00:00 AM,287,369,352
Northern,Alexandria City,51510,931,3812,4743,1435,8119,9554,258532,1410467,1668999,07/01/2020 12:00:00 AM,278,370,352
Northern,Alexandria City,51510,932,3148,4080,1507,6776,8283,146188,850423,996611,06/01/2019 12:00:00 AM,157,270,244
Northern,Alexandria City,51510,946,3742,4688,1518,7919,9437,273416,1388691,1662107,06/01/2020 12:00:00 AM,289,371,355
Northern,Alexandria City,51510,960,3141,4101,1585,6705,8290,154542,836714,991256,05/01/2019 12:00:00 AM,161,266,242
Northern,Alexandria City,51510,970,3041,4011,1667,6408,8075,170294,809175,979469,02/01/2019 12:00:00 AM,176,266,244
Northern,Alexandria City,51510,972,3168,4140,1630,6749,8379,159143,841957,1001100,04/01/2019 12:00:00 AM,164,266,242
Northern,Alexandria City,51510,981,3172,4153,1682,6780,8462,170988,856297.4,1027285.4,03/01/2019 12:00:00 AM,174,270,247
Northern,Alexandria City,51510,993,3374,4367,1707,7359,9066,177022,941292,1118314,03/01/2017 12:00:00 AM,178,279,256
Northern,Arlington County,51013,1111,2298,3409,1322,4191,5513,101997,474768,576765,02/01/2020 12:00:00 AM,92,207,169
Northern,Arlington County,51013,1115,2349,3464,1321,4286,5607,107018,483084,590102,12/01/2019 12:00:00 AM,96,206,170
Northern,Arlington County,51013,1116,2345,3461,1319,4259,5578,102774,481084,583858,01/01/2020 12:00:00 AM,92,205,169
Northern,Arlington County,51013,1117,2415,3532,1323,4382,5705,103427,493255,596682,06/01/2019 12:00:00 AM,93,204,169
Northern,Arlington County,51013,1123,3065,4188,1281,5770,7051,291805,1253357,1545162,02/01/2021 12:00:00 AM,260,409,369
Northern,Arlington County,51013,1124,2441,3565,1333,4440,5773,104008,503656,607664,05/01/2019 12:00:00 AM,93,206,170
Northern,Arlington County,51013,1126,2421,3547,1333,4416,5749,104744,501891,606635,07/01/2019 12:00:00 AM,93,207,171
Northern,Arlington County,51013,1129,2344,3473,1337,4285,5622,110644,481119,591763,11/01/2019 12:00:00 AM,98,205,170
Northern,Arlington County,51013,1129,2389,3518,1334,4304,5638,250631,760378,1011009,03/01/2020 12:00:00 AM,222,318,287
Northern,Arlington County,51013,1137,2365,3502,1346,4320,5666,109927,491985,601912,10/01/2019 12:00:00 AM,97,208,172
Northern,Arlington County,51013,1140,2391,3531,1353,4358,5711,106792,489328,596120,08/01/2019 12:00:00 AM,94,205,169
Northern,Arlington County,51013,1145,3071,4216,1329,5755,7084,306121,1234070,1540191,03/01/2021 12:00:00 AM,267,402,365
Northern,Arlington County,51013,1146,2376,3522,1353,4305,5658,107276,485844,593120,09/01/2019 12:00:00 AM,94,204,168
Northern,Arlington County,51013,1146,2389,3535,1371,4331,5702,106475,492007,598482,02/01/2019 12:00:00 AM,93,206,169
Northern,Arlington County,51013,1147,2434,3581,1372,4459,5831,108772,503726,612498,04/01/2019 12:00:00 AM,95,207,171
Northern,Arlington County,51013,1147,2694,3841,1351,4849,6200,254724,870345,1125069,04/01/2020 12:00:00 AM,222,323,293
Northern,Arlington County,51013,1151,2997,4148,1363,5611,6974,312895,1207103,1519998,01/01/2021 12:00:00 AM,272,403,366
Northern,Arlington County,51013,1162,2455,3617,1403,4485,5888,111746,510675,622421,03/01/2019 12:00:00 AM,96,208,172
Northern,Arlington County,51013,1167,2972,4139,1379,5524,6903,275976,1039084,1315060,12/01/2020 12:00:00 AM,236,350,318
Northern,Arlington County,51013,1167,3081,4248,1369,5748,7117,318525,1345553,1664078,04/01/2021 12:00:00 AM,273,437,392
Northern,Arlington County,51013,1173,2922,4095,1390,5455,6845,277019,1039661,1316680,11/01/2020 12:00:00 AM,236,356,322
Northern,Arlington County,51013,1176,2525,3701,1421,4623,6044,117613,558952,676565,01/01/2019 12:00:00 AM,100,221,183
Northern,Arlington County,51013,1176,2824,4000,1396,5040,6436,263782,909284,1173066,05/01/2020 12:00:00 AM,224,322,293
Northern,Arlington County,51013,1179,3075,4254,1392,5748,7140,330154,1357558,1687712,05/01/2021 12:00:00 AM,280,441,397
Northern,Arlington County,51013,1187,2915,4102,1415,5406,6821,279698,1020068,1299766,10/01/2020 12:00:00 AM,236,350,317
Northern,Arlington County,51013,1191,2928,4119,1421,5382,6803,267546,962917,1230463,09/01/2020 12:00:00 AM,225,329,299
Northern,Arlington County,51013,1191,2950,4141,1415,5365,6780,266338,952079,1218417,08/01/2020 12:00:00 AM,224,323,294
Northern,Arlington County,51013,1193,2501,3694,1446,4594,6040,123230,522999,646229,12/01/2018 12:00:00 AM,103,209,175
Northern,Arlington County,51013,1194,2860,4054,1428,5071,6499,268569,916240,1184809,06/01/2020 12:00:00 AM,225,320,292
Northern,Arlington County,51013,1196,2632,3828,1432,4910,6342,116454,571589,688043,07/01/2018 12:00:00 AM,97,217,180
Northern,Arlington County,51013,1196,2646,3842,1439,4909,6348,117487,564534,682021,06/01/2018 12:00:00 AM,98,213,178
Northern,Arlington County,51013,1196,3084,4280,1419,5710,7129,334429,1347893,1682322,06/01/2021 12:00:00 AM,280,437,393
Northern,Arlington County,51013,1199,2528,3727,1449,4655,6104,124041,529519,653560,11/01/2018 12:00:00 AM,103,209,175
Northern,Arlington County,51013,1201,2900,4101,1426,5181,6607,270522,915539,1186061,07/01/2020 12:00:00 AM,225,316,289
Northern,Arlington County,51013,1205,2670,3875,1449,4967,6416,116512,575102,691614,05/01/2018 12:00:00 AM,97,215,178
Northern,Arlington County,51013,1206,2584,3790,1469,4781,6250,120948,545818,666766,09/01/2018 12:00:00 AM,100,211,176
Northern,Arlington County,51013,1208,2607,3815,1467,4828,6295,122263,556418,678681,08/01/2018 12:00:00 AM,101,213,178
Northern,Arlington County,51013,1214,2695,3909,1459,5038,6497,118175,585747,703922,04/01/2018 12:00:00 AM,97,217,180
Northern,Arlington County,51013,1215,2538,3753,1479,4702,6181,125406,539670,665076,10/01/2018 12:00:00 AM,103,213,177
Northern,Arlington County,51013,1239,2729,3968,1512,5095,6607,125370,593713,719083,02/01/2018 12:00:00 AM,101,218,181
Northern,Arlington County,51013,1240,2680,3920,1505,4975,6480,123950,573969,697919,03/01/2018 12:00:00 AM,100,214,178
Northern,Arlington County,51013,1247,2790,4037,1517,5197,6714,128194,615333.14,743527.14,09/01/2017 12:00:00 AM,103,221,184
Northern,Arlington County,51013,1250,2736,3986,1528,5114,6642,127066,590834,717900,01/01/2018 12:00:00 AM,102,216,180
Northern,Arlington County,51013,1252,2800,4052,1529,5148,6677,132777,606733,739510,10/01/2017 12:00:00 AM,106,217,183
Northern,Arlington County,51013,1254,2720,3974,1533,5056,6589,133253,591980,725233,12/01/2017 12:00:00 AM,106,218,182
Northern,Arlington County,51013,1257,2852,4109,1527,5359,6886,129054,640380,769434,06/01/2017 12:00:00 AM,103,225,187
Northern,Arlington County,51013,1260,3286,4546,1666,5916,7582,160060,757519,917579,05/01/2012 12:00:00 AM,127,231,202
Northern,Arlington County,51013,1261,2859,4120,1523,5359,6882,128410,639170,767580,05/01/2017 12:00:00 AM,102,224,186
Northern,Arlington County,51013,1263,2902,4165,1527,5433,6960,126932,646178,773110,04/01/2017 12:00:00 AM,101,223,186
Northern,Arlington County,51013,1266,3254,4520,1666,5892,7558,160881,749117,909998,03/01/2012 12:00:00 AM,127,230,201
Northern,Arlington County,51013,1269,2743,4012,1555,5080,6635,137897,601391,739288,11/01/2017 12:00:00 AM,109,219,184
Northern,Arlington County,51013,1269,3186,4455,1539,5991,7530,125098,700866,825964,06/01/2016 12:00:00 AM,99,220,185
Northern,Arlington County,51013,1269,3259,4528,1665,5883,7548,159108,745974,905082,04/01/2012 12:00:00 AM,125,229,200
Northern,Arlington County,51013,1271,2825,4096,1543,5271,6814,132039,636782,768821,08/01/2017 12:00:00 AM,104,225,188
Northern,Arlington County,51013,1271,3351,4622,1667,6007,7674,162305,764418,926723,06/01/2012 12:00:00 AM,128,228,201
Northern,Arlington County,51013,1273,2845,4118,1541,5325,6866,129548,625970,755518,07/01/2017 12:00:00 AM,102,220,183
Northern,Arlington County,51013,1274,3099,4373,1534,5813,7347,125334,681727,807061,12/01/2016 12:00:00 AM,98,220,185
Northern,Arlington County,51013,1275,3429,4704,1647,6134,7781,158279,787630,945909,08/01/2012 12:00:00 AM,124,230,201
Northern,Arlington County,51013,1276,3147,4423,1557,5897,7454,128136,689854,817990,07/01/2016 12:00:00 AM,100,219,185
Northern,Arlington County,51013,1276,3374,4650,1657,6060,7717,165398,786462,951860,07/01/2012 12:00:00 AM,130,233,205
Northern,Arlington County,51013,1278,3220,4498,1547,6056,7603,126046,713000,839046,05/01/2016 12:00:00 AM,99,221,187
Northern,Arlington County,51013,1279,3448,4727,1664,6149,7813,162304,795745,958049,09/01/2012 12:00:00 AM,127,231,203
Northern,Arlington County,51013,1280,3060,4340,1548,5726,7274,126361,668224,794585,01/01/2017 12:00:00 AM,99,218,183
Northern,Arlington County,51013,1280,3282,4562,1567,6162,7729,125706,723488,849194,03/01/2016 12:00:00 AM,98,220,186
Northern,Arlington County,51013,1283,3159,4442,1570,5887,7457,129098,693194,822292,09/01/2016 12:00:00 AM,101,219,185
Northern,Arlington County,51013,1283,3217,4500,1719,5792,7511,169021,736486,905507,02/01/2012 12:00:00 AM,132,229,201
Northern,Arlington County,51013,1283,3379,4662,1567,6386,7953,124797,757159,881956,10/01/2015 12:00:00 AM,97,224,189
Northern,Arlington County,51013,1285,3140,4425,1582,5868,7450,131309,688057,819366,08/01/2016 12:00:00 AM,102,219,185
Northern,Arlington County,51013,1285,3251,4536,1563,6142,7705,124899,719041,843940,04/01/2016 12:00:00 AM,97,221,186
Northern,Arlington County,51013,1285,3282,4567,1583,6121,7704,125696,720636,846332,02/01/2016 12:00:00 AM,98,220,185
Northern,Arlington County,51013,1286,3168,4454,1719,5706,7425,167380,718608,885988,01/01/2012 12:00:00 AM,130,227,199
Northern,Arlington County,51013,1286,3309,4595,1596,6157,7753,127609,722762,850371,01/01/2016 12:00:00 AM,99,218,185
Northern,Arlington County,51013,1287,2980,4267,1555,5559,7114,127871,657864,785735,03/01/2017 12:00:00 AM,99,221,184
Northern,Arlington County,51013,1288,3386,4674,1581,6350,7931,126674,749622,876296,11/01/2015 12:00:00 AM,98,221,187
Northern,Arlington County,51013,1293,3099,4392,1566,5815,7381,127715,687798,815513,11/01/2016 12:00:00 AM,99,222,186
Northern,Arlington County,51013,1295,3546,4841,1700,6320,8020,165521,808901,974422,12/01/2012 12:00:00 AM,128,228,201
Northern,Arlington County,51013,1296,3404,4700,1586,6392,7978,127461,769794,897255,05/01/2015 12:00:00 AM,98,226,191
Northern,Arlington County,51013,1296,3580,4876,1689,6375,8064,158441,811778,970219,01/01/2013 12:00:00 AM,122,227,199
Northern,Arlington County,51013,1297,3396,4693,1579,6413,7992,127194,761448,888642,08/01/2015 12:00:00 AM,98,224,189
Northern,Arlington County,51013,1297,3400,4697,1593,6389,7982,128456,764172,892628,06/01/2015 12:00:00 AM,99,225,190
Northern,Arlington County,51013,1298,3393,4691,1621,6404,8025,132661,768330,900991,02/01/2015 12:00:00 AM,102,226,192
Northern,Arlington County,51013,1298,3416,4714,1601,6425,8026,128664,771879,900543,04/01/2015 12:00:00 AM,99,226,191
Northern,Arlington County,51013,1299,3123,4422,1581,5828,7409,131101,690843,821944,10/01/2016 12:00:00 AM,101,221,186
Northern,Arlington County,51013,1299,3404,4703,1608,6418,8026,128518,774190,902708,03/01/2015 12:00:00 AM,99,227,192
Northern,Arlington County,51013,1300,3074,4374,1569,5757,7326,127310,679188,806498,02/01/2017 12:00:00 AM,98,221,184
Northern,Arlington County,51013,1300,3357,4657,1605,6260,7865,128415,736230,864645,12/01/2015 12:00:00 AM,99,219,186
Northern,Arlington County,51013,1303,3386,4689,1591,6372,7963,129320,756126,885446,09/01/2015 12:00:00 AM,99,223,189
Northern,Arlington County,51013,1305,3547,4852,1725,6316,8041,170617,813906,984523,11/01/2012 12:00:00 AM,131,229,203
Northern,Arlington County,51013,1306,3506,4812,1717,6245,7962,170667,809393,980060,10/01/2012 12:00:00 AM,131,231,204
Northern,Arlington County,51013,1306,3608,4914,1709,6412,8121,162601,823114,985715,02/01/2013 12:00:00 AM,125,228,201
Northern,Arlington County,51013,1309,3428,4737,1610,6426,8036,129966,763284,893250,07/01/2015 12:00:00 AM,99,223,189
Northern,Arlington County,51013,1310,3636,4946,1704,6489,8193,158720,828655,987375,03/01/2013 12:00:00 AM,121,228,200
Northern,Arlington County,51013,1314,3752,5066,1644,6746,8390,132030,805189,937219,11/01/2013 12:00:00 AM,100,215,185
Northern,Arlington County,51013,1315,3731,5046,1646,6745,8391,131618,797925,929543,12/01/2013 12:00:00 AM,100,214,184
Northern,Arlington County,51013,1317,3424,4741,1660,6415,8075,135683,766506,902189,01/01/2015 12:00:00 AM,103,224,190
Northern,Arlington County,51013,1320,3633,4953,1696,6633,8329,135899,784397,920296,08/01/2014 12:00:00 AM,103,216,186
Northern,Arlington County,51013,1320,3737,5057,1650,6731,8381,128243,789154,917397,01/01/2014 12:00:00 AM,97,211,181
Northern,Arlington County,51013,1323,3746,5069,1667,6715,8382,132997,801209,934206,02/01/2014 12:00:00 AM,101,214,184
Northern,Arlington County,51013,1327,3448,4775,1675,6458,8133,142758,780732,923490,12/01/2014 12:00:00 AM,108,226,193
Northern,Arlington County,51013,1327,3510,4837,1698,6511,8209,146482,794579,941061,10/01/2014 12:00:00 AM,110,226,195
Northern,Arlington County,51013,1329,3460,4789,1679,6439,8118,144462,779455,923917,11/01/2014 12:00:00 AM,109,225,193
Northern,Arlington County,51013,1329,3605,4934,1687,6603,8290,134550,779915,914465,09/01/2014 12:00:00 AM,101,216,185
Northern,Arlington County,51013,1329,3643,4972,1728,6493,8221,162299,827556,989855,04/01/2013 12:00:00 AM,122,227,199
Northern,Arlington County,51013,1331,3649,4980,1712,6598,8310,140285,783640,923925,07/01/2014 12:00:00 AM,105,215,186
Northern,Arlington County,51013,1334,3716,5050,1706,6663,8369,136204,788053,924257,04/01/2014 12:00:00 AM,102,212,183
Northern,Arlington County,51013,1335,3688,5023,1726,6580,8306,162590,835274,997864,07/01/2013 12:00:00 AM,122,226,199
Northern,Arlington County,51013,1335,3707,5042,1710,6679,8389,138043,792980,931023,05/01/2014 12:00:00 AM,103,214,185
Northern,Arlington County,51013,1337,3725,5062,1720,6664,8384,139210,790637,929847,03/01/2014 12:00:00 AM,104,212,184
Northern,Arlington County,51013,1338,3768,5106,1708,6747,8455,160152,865434,1025586,10/01/2013 12:00:00 AM,120,230,201
Northern,Arlington County,51013,1339,3670,5009,1754,6520,8274,167349,830145,997494,05/01/2013 12:00:00 AM,125,226,199
Northern,Arlington County,51013,1341,3696,5037,1715,6656,8371,137029,786228,923257,06/01/2014 12:00:00 AM,102,213,183
Northern,Arlington County,51013,1342,3670,5012,1747,6543,8290,165581,832684,998265,06/01/2013 12:00:00 AM,123,227,199
Northern,Arlington County,51013,1348,3731,5079,1741,6644,8385,165529,846419,1011948,09/01/2013 12:00:00 AM,123,227,199
Northern,Arlington County,51013,1357,3696,5053,1761,6568,8329,167584,835623,1003207,08/01/2013 12:00:00 AM,123,226,199
Northern,Clarke County,51043,45,190,235,46,372,418,3915,43613,47528,05/01/2019 12:00:00 AM,87,230,202
Northern,Clarke County,51043,45,234,279,48,470,518,11927,109669,121596,05/01/2021 12:00:00 AM,265,469,436
Northern,Clarke County,51043,46,189,235,48,377,425,4219,44395,48614,07/01/2019 12:00:00 AM,92,235,207
Northern,Clarke County,51043,46,189,235,48,383,431,4234,43153,47387,08/01/2019 12:00:00 AM,92,228,202
Northern,Clarke County,51043,46,198,244,47,403,450,4059,47208,51267,09/01/2019 12:00:00 AM,88,238,210
Northern,Clarke County,51043,46,198,244,48,411,459,4588,47629,52217,09/01/2018 12:00:00 AM,100,241,214
Northern,Clarke County,51043,46,232,278,49,465,514,11868,106857,118725,06/01/2021 12:00:00 AM,258,461,427
Northern,Clarke County,51043,47,199,246,51,423,474,5287,51860,57147,11/01/2018 12:00:00 AM,112,261,232
Northern,Clarke County,51043,47,200,247,49,425,474,4954,51071,56025,10/01/2018 12:00:00 AM,105,255,227
Northern,Clarke County,51043,48,189,237,51,376,427,4747,43675,48422,06/01/2019 12:00:00 AM,99,231,204
Northern,Clarke County,51043,48,208,256,51,431,482,4060,46070,50130,06/01/2016 12:00:00 AM,85,221,196
Northern,Clarke County,51043,49,189,238,56,367,423,5545,42027,47572,03/01/2019 12:00:00 AM,113,222,200
Northern,Clarke County,51043,49,192,241,54,381,435,5140,43446,48586,04/01/2019 12:00:00 AM,105,226,202
Northern,Clarke County,51043,49,202,251,51,404,455,5123,45748,50871,08/01/2018 12:00:00 AM,105,226,203
Northern,Clarke County,51043,49,205,254,49,411,460,3946,45722,49668,02/01/2020 12:00:00 AM,81,223,196
Northern,Clarke County,51043,49,206,255,51,401,452,4354,44311,48665,01/01/2020 12:00:00 AM,89,215,191
Northern,Clarke County,51043,49,221,270,52,464,516,4154,49584,53738,05/01/2016 12:00:00 AM,85,224,199
Northern,Clarke County,51043,49,241,290,50,504,554,4157,52577,56734,09/01/2015 12:00:00 AM,85,218,196
Northern,Clarke County,51043,49,295,344,59,641,700,5192,73492,78684,05/01/2014 12:00:00 AM,106,249,229
Northern,Clarke County,51043,50,185,235,54,382,436,5608,45218,50826,12/01/2018 12:00:00 AM,112,244,216
Northern,Clarke County,51043,50,201,251,53,408,461,5000,46331,51331,10/01/2019 12:00:00 AM,100,231,205
Northern,Clarke County,51043,50,204,254,54,405,459,5259,46926,52185,06/01/2018 12:00:00 AM,105,230,205
Northern,Clarke County,51043,50,206,256,52,416,468,5040,48251,53291,07/01/2018 12:00:00 AM,101,234,208
Northern,Clarke County,51043,50,210,260,51,442,493,4482,50511,54993,10/01/2016 12:00:00 AM,90,241,212
Northern,Clarke County,51043,50,223,273,53,476,529,4309,53075,57384,04/01/2016 12:00:00 AM,86,238,210
Northern,Clarke County,51043,50,235,285,53,474,527,12645,109425,122070,04/01/2021 12:00:00 AM,253,466,428
Northern,Clarke County,51043,50,237,287,52,511,563,4309,53350,57659,10/01/2015 12:00:00 AM,86,225,201
Northern,Clarke County,51043,50,240,290,54,494,548,4735,52905,57640,08/01/2015 12:00:00 AM,95,220,199
Northern,Clarke County,51043,50,240,290,54,502,556,4741,55805,60546,06/01/2015 12:00:00 AM,95,233,209
Northern,Clarke County,51043,50,247,297,54,509,563,4864,54721,59585,07/01/2015 12:00:00 AM,97,222,201
Northern,Clarke County,51043,50,293,343,60,646,706,5013,72768,77781,06/01/2014 12:00:00 AM,100,248,227
Northern,Clarke County,51043,50,306,356,60,655,715,5103,74590,79693,04/01/2014 12:00:00 AM,102,244,224
Northern,Clarke County,51043,51,182,233,58,357,415,5826,41649,47475,02/01/2019 12:00:00 AM,114,229,204
Northern,Clarke County,51043,51,203,254,58,408,466,5854,46776,52630,12/01/2017 12:00:00 AM,115,230,207
Northern,Clarke County,51043,51,204,255,54,421,475,5316,48350,53666,03/01/2017 12:00:00 AM,104,237,210
Northern,Clarke County,51043,51,205,256,56,407,463,5720,45890,51610,04/01/2018 12:00:00 AM,112,224,202
Northern,Clarke County,51043,51,206,257,52,427,479,4370,47850,52220,11/01/2016 12:00:00 AM,86,232,203
Northern,Clarke County,51043,51,208,259,52,439,491,4482,48120,52602,09/01/2016 12:00:00 AM,88,231,203
Northern,Clarke County,51043,51,213,264,51,421,472,10115,71651,81766,03/01/2020 12:00:00 AM,198,336,310
Northern,Clarke County,51043,51,220,271,55,461,516,4638,50782,55420,03/01/2016 12:00:00 AM,91,231,205
Northern,Clarke County,51043,51,315,366,62,670,732,5268,77277,82545,03/01/2014 12:00:00 AM,103,245,226
Northern,Clarke County,51043,51,324,375,63,670,733,5440,77982,83422,12/01/2013 12:00:00 AM,107,241,222
Northern,Clarke County,51043,52,194,246,61,378,439,6370,45598,51968,01/01/2019 12:00:00 AM,123,235,211
Northern,Clarke County,51043,52,203,255,60,395,455,6006,45358,51364,03/01/2018 12:00:00 AM,116,223,201
Northern,Clarke County,51043,52,204,256,60,398,458,6006,44020,50026,12/01/2019 12:00:00 AM,116,216,195
Northern,Clarke County,51043,52,206,258,59,424,483,5679,46296,51975,10/01/2017 12:00:00 AM,109,225,201
Northern,Clarke County,51043,52,207,259,55,416,471,5144,46055,51199,11/01/2019 12:00:00 AM,99,222,198
Northern,Clarke County,51043,52,210,262,55,431,486,4899,48108,53007,12/01/2016 12:00:00 AM,94,229,202
Northern,Clarke County,51043,52,217,269,55,447,502,4467,46762,51229,07/01/2016 12:00:00 AM,86,215,190
Northern,Clarke County,51043,52,218,270,55,453,508,4623,48682,53305,08/01/2016 12:00:00 AM,89,223,197
Northern,Clarke County,51043,52,222,274,60,458,518,5382,50567,55949,02/01/2016 12:00:00 AM,104,228,204
Northern,Clarke County,51043,52,228,280,52,448,500,10147,78359,88506,04/01/2020 12:00:00 AM,195,344,316
Northern,Clarke County,51043,52,237,289,55,461,516,13219,96243,109462,03/01/2021 12:00:00 AM,254,406,379
Northern,Clarke County,51043,52,241,293,52,464,516,12168,99097,111265,02/01/2021 12:00:00 AM,234,411,380
Northern,Clarke County,51043,52,270,322,63,593,656,5135,66514,71649,09/01/2014 12:00:00 AM,99,246,223
Northern,Clarke County,51043,52,281,333,66,614,680,5884,69601,75485,07/01/2014 12:00:00 AM,113,248,227
Northern,Clarke County,51043,52,310,362,63,663,726,5672,76301,81973,02/01/2014 12:00:00 AM,109,246,226
Northern,Clarke County,51043,53,202,255,59,398,457,6111,46404,52515,05/01/2018 12:00:00 AM,115,230,206
Northern,Clarke County,51043,53,204,257,57,417,474,5238,47571,52809,01/01/2017 12:00:00 AM,99,233,205
Northern,Clarke County,51043,53,206,259,60,418,478,5808,47580,53388,11/01/2017 12:00:00 AM,110,231,206
Northern,Clarke County,51043,53,227,280,61,473,534,5291,50668,55959,01/01/2016 12:00:00 AM,100,223,200
Northern,Clarke County,51043,53,233,286,54,463,517,10829,85450,96279,11/01/2020 12:00:00 AM,204,367,337
Northern,Clarke County,51043,53,242,295,59,508,567,5278,57732,63010,04/01/2015 12:00:00 AM,100,239,214
Northern,Clarke County,51043,54,200,254,59,407,466,5855,47724,53579,04/01/2017 12:00:00 AM,108,239,211
Northern,Clarke County,51043,54,202,256,57,402,459,5306,47049,52355,05/01/2017 12:00:00 AM,98,233,205
Northern,Clarke County,51043,54,203,257,58,416,474,5399,47092,52491,07/01/2017 12:00:00 AM,100,232,204
Northern,Clarke County,51043,54,203,257,62,407,469,6534,44278,50812,02/01/2018 12:00:00 AM,121,218,198
Northern,Clarke County,51043,54,206,260,61,412,473,6312,46002,52314,01/01/2018 12:00:00 AM,117,223,201
Northern,Clarke County,51043,54,210,264,58,424,482,5438,50243,55681,08/01/2017 12:00:00 AM,101,239,211
Northern,Clarke County,51043,54,211,265,58,429,487,5708,48619,54327,09/01/2017 12:00:00 AM,106,230,205
Northern,Clarke County,51043,54,211,265,58,432,490,5432,50895,56327,02/01/2017 12:00:00 AM,101,241,213
Northern,Clarke County,51043,54,230,284,54,447,501,10933,78717,89650,05/01/2020 12:00:00 AM,202,342,316
Northern,Clarke County,51043,54,231,285,56,449,505,11356,84201,95557,12/01/2020 12:00:00 AM,210,365,335
Northern,Clarke County,51043,54,234,288,56,452,508,13028,94224,107252,01/01/2021 12:00:00 AM,241,403,372
Northern,Clarke County,51043,54,236,290,54,474,528,10670,81172,91842,09/01/2020 12:00:00 AM,198,344,317
Northern,Clarke County,51043,54,242,296,62,500,562,5497,56694,62191,05/01/2015 12:00:00 AM,102,234,210
Northern,Clarke County,51043,54,243,297,64,500,564,5736,57459,63195,03/01/2015 12:00:00 AM,106,236,213
Northern,Clarke County,51043,54,247,301,65,524,589,5962,59387,65349,02/01/2015 12:00:00 AM,110,240,217
Northern,Clarke County,51043,54,280,334,69,617,686,6523,70611,77134,08/01/2014 12:00:00 AM,121,252,231
Northern,Clarke County,51043,55,226,281,65,473,538,6240,50468,56708,11/01/2015 12:00:00 AM,113,223,202
Northern,Clarke County,51043,55,228,283,55,457,512,11025,78794,89819,06/01/2020 12:00:00 AM,200,346,317
Northern,Clarke County,51043,55,230,285,63,496,559,5689,53081,58770,12/01/2015 12:00:00 AM,103,231,206
Northern,Clarke County,51043,55,236,291,55,480,535,10831,82771,93602,08/01/2020 12:00:00 AM,197,351,322
Northern,Clarke County,51043,55,240,295,55,481,536,11373,88529,99902,10/01/2020 12:00:00 AM,207,369,339
Northern,Clarke County,51043,55,248,303,67,539,606,6250,60110,66360,01/01/2015 12:00:00 AM,114,242,219
Northern,Clarke County,51043,55,319,374,68,666,734,5831,77488,83319,01/01/2014 12:00:00 AM,106,243,223
Northern,Clarke County,51043,55,326,381,68,662,730,6032,77979,84011,11/01/2013 12:00:00 AM,110,239,221
Northern,Clarke County,51043,56,233,289,56,470,526,11025,81516,92541,07/01/2020 12:00:00 AM,197,350,320
Northern,Clarke County,51043,56,254,310,70,561,631,6474,63893,70367,11/01/2014 12:00:00 AM,116,252,227
Northern,Clarke County,51043,57,201,258,61,407,468,6019,46388,52407,06/01/2017 12:00:00 AM,106,231,203
Northern,Clarke County,51043,57,327,384,71,666,737,7044,84561,91605,10/01/2013 12:00:00 AM,124,259,239
Northern,Clarke County,51043,57,327,384,72,674,746,7392,86122,93514,09/01/2013 12:00:00 AM,130,263,244
Northern,Clarke County,51043,58,253,311,73,556,629,7024,64676,71700,12/01/2014 12:00:00 AM,121,256,231
Northern,Clarke County,51043,58,266,324,75,576,651,7193,67521,74714,10/01/2014 12:00:00 AM,124,254,231
Northern,Clarke County,51043,61,339,400,82,705,787,8931,90080,99011,08/01/2013 12:00:00 AM,146,266,248
Northern,Clarke County,51043,61,354,415,77,751,828,8106,97206,105312,04/01/2013 12:00:00 AM,133,275,254
Northern,Clarke County,51043,61,359,420,79,757,836,8024,97210,105234,03/01/2013 12:00:00 AM,132,271,251
Northern,Clarke County,51043,62,347,409,79,730,809,8490,92999,101489,05/01/2013 12:00:00 AM,137,268,248
Northern,Clarke County,51043,65,341,406,91,707,798,10036,88989,99025,01/01/2013 12:00:00 AM,154,261,244
Northern,Clarke County,51043,65,351,416,92,733,825,9699,93268,102967,02/01/2013 12:00:00 AM,149,266,248
Northern,Clarke County,51043,66,337,403,97,700,797,11019,88514,99533,12/01/2012 12:00:00 AM,167,263,247
Northern,Clarke County,51043,66,343,409,92,709,801,10275,90053,100328,07/01/2013 12:00:00 AM,156,263,245
Northern,Clarke County,51043,66,349,415,93,720,813,9820,91138,100958,06/01/2013 12:00:00 AM,149,261,243
Northern,Clarke County,51043,68,350,418,100,738,838,10821,92733,103554,11/01/2012 12:00:00 AM,159,265,248
Northern,Clarke County,51043,69,341,410,109,704,813,12317,87623,99940,08/01/2012 12:00:00 AM,179,257,244
Northern,Clarke County,51043,69,342,411,107,713,820,11988,89220,101208,09/01/2012 12:00:00 AM,174,261,246
Northern,Clarke County,51043,69,349,418,102,728,830,11259,91377,102636,10/01/2012 12:00:00 AM,163,262,246
Northern,Clarke County,51043,72,338,410,118,693,811,13060,84868,97928,07/01/2012 12:00:00 AM,181,251,239
Northern,Clarke County,51043,74,337,411,117,692,809,12803,85081,97884,06/01/2012 12:00:00 AM,173,252,238
Northern,Clarke County,51043,74,364,438,106,755,861,11123,93000,104123,02/01/2012 12:00:00 AM,150,255,238
Northern,Clarke County,51043,75,354,429,116,738,854,13067,90244,103311,01/01/2012 12:00:00 AM,174,255,241
Northern,Clarke County,51043,76,341,417,122,695,817,12994,86503,99497,05/01/2012 12:00:00 AM,171,254,239
Northern,Clarke County,51043,78,360,438,119,735,854,12809,92166,104975,03/01/2012 12:00:00 AM,164,256,240
Northern,Clarke County,51043,83,351,434,133,717,850,14356,90549,104905,04/01/2012 12:00:00 AM,173,258,242
Northern,Culpeper County,51047,323,1516,1839,429,3466,3895,99984,773193,873177,06/01/2021 12:00:00 AM,310,510,475
Northern,Culpeper County,51047,325,1505,1830,445,3477,3922,103445,769503,872948,05/01/2021 12:00:00 AM,318,511,477
Northern,Culpeper County,51047,325,1535,1860,437,3556,3993,96907,745986,842893,02/01/2021 12:00:00 AM,298,486,453
Northern,Culpeper County,51047,329,1513,1842,452,3484,3936,105171,773041,878212,04/01/2021 12:00:00 AM,320,511,477
Northern,Culpeper County,51047,334,1449,1783,464,3438,3902,45982,401910,447892,09/01/2019 12:00:00 AM,138,277,251
Northern,Culpeper County,51047,334,1452,1786,466,3404,3870,46916,399389,446305,08/01/2019 12:00:00 AM,140,275,250
Northern,Culpeper County,51047,335,1453,1788,473,3414,3887,47330,402116,449446,07/01/2019 12:00:00 AM,141,277,251
Northern,Culpeper County,51047,335,1455,1790,465,3388,3853,84610,572882,657492,03/01/2020 12:00:00 AM,253,394,367
Northern,Culpeper County,51047,336,1491,1827,461,3487,3948,100859,716720,817579,01/01/2021 12:00:00 AM,300,481,447
Northern,Culpeper County,51047,337,1442,1779,471,3420,3891,47930,395266,443196,10/01/2019 12:00:00 AM,142,274,249
Northern,Culpeper County,51047,337,1541,1878,458,3575,4033,101807,739329,841136,03/01/2021 12:00:00 AM,302,480,448
Northern,Culpeper County,51047,338,1520,1858,461,3566,4027,88823.99,640020,728843.99,12/01/2020 12:00:00 AM,263,421,392
Northern,Culpeper County,51047,339,1436,1775,473,3331,3804,46855,392497,439352,02/01/2020 12:00:00 AM,138,273,248
Northern,Culpeper County,51047,339,1489,1828,462,3479,3941,46552,410689,457241,06/01/2019 12:00:00 AM,137,276,250
Northern,Culpeper County,51047,340,1569,1909,459,3686,4145,83787,628546,712333,04/01/2020 12:00:00 AM,246,401,373
Northern,Culpeper County,51047,341,1464,1805,465,3459,3924,46973,399655,446628,05/01/2019 12:00:00 AM,138,273,247
Northern,Culpeper County,51047,342,1542,1884,464,3642,4106,90092,662152,752244,11/01/2020 12:00:00 AM,263,429,399
Northern,Culpeper County,51047,343,1563,1906,464,3666,4130,89359,659556,748915,10/01/2020 12:00:00 AM,261,422,393
Northern,Culpeper County,51047,344,1443,1787,474,3396,3870,47887,394519,442406,12/01/2019 12:00:00 AM,139,273,248
Northern,Culpeper County,51047,344,1481,1825,478,3496,3974,47313,404199,451512,02/01/2019 12:00:00 AM,138,273,247
Northern,Culpeper County,51047,345,1517,1862,474,3568,4042,47634,414504,462138,03/01/2019 12:00:00 AM,138,273,248
Northern,Culpeper County,51047,346,1425,1771,493,3289,3782,49460,381138,430598,01/01/2020 12:00:00 AM,143,267,243
Northern,Culpeper County,51047,346,1599,1945,473,3754,4227,86755,644356,731111,05/01/2020 12:00:00 AM,251,403,376
Northern,Culpeper County,51047,347,1446,1793,480,3425,3905,48920,401709,450629,11/01/2019 12:00:00 AM,141,278,251
Northern,Culpeper County,51047,348,1482,1830,479,3475,3954,48083,405888,453971,04/01/2019 12:00:00 AM,138,274,248
Northern,Culpeper County,51047,350,1636,1986,469,3850,4319,86508,656722,743230,08/01/2020 12:00:00 AM,247,401,374
Northern,Culpeper County,51047,351,1687,2038,505,4232,4737,53586,508711,562297,05/01/2017 12:00:00 AM,153,302,276
Northern,Culpeper County,51047,352,1626,1978,486,3809,4295,87986,645734,733720,06/01/2020 12:00:00 AM,250,397,371
Northern,Culpeper County,51047,353,1525,1878,509,3611,4120,52504,428949,481453,12/01/2018 12:00:00 AM,149,281,256
Northern,Culpeper County,51047,353,1643,1996,481,3868,4349,88426,659896,748322,07/01/2020 12:00:00 AM,250,402,375
Northern,Culpeper County,51047,354,1498,1852,503,3530,4033,50591,421589,472180,01/01/2019 12:00:00 AM,143,281,255
Northern,Culpeper County,51047,354,1595,1949,495,3957,4452,52610,478611,531221,08/01/2017 12:00:00 AM,149,300,273
Northern,Culpeper County,51047,355,1603,1958,478,3762,4240,86553,642494,729047,09/01/2020 12:00:00 AM,244,401,372
Northern,Culpeper County,51047,355,1608,1963,503,3975,4478,54780,486144,540924,07/01/2017 12:00:00 AM,154,302,276
Northern,Culpeper County,51047,355,1685,2040,517,4196,4713,54936,507302,562238,04/01/2017 12:00:00 AM,155,301,276
Northern,Culpeper County,51047,355,1824,2179,518,4632,5150,53365,554784,608149,04/01/2016 12:00:00 AM,150,304,279
Northern,Culpeper County,51047,358,1651,2009,515,4104,4619,54758,502851,557609,06/01/2017 12:00:00 AM,153,305,278
Northern,Culpeper County,51047,359,1718,2077,516,4288,4804,55372,517719,573091,03/01/2017 12:00:00 AM,154,301,276
Northern,Culpeper County,51047,360,1625,1985,506,3964,4470,52355,483699,536054,02/01/2018 12:00:00 AM,145,298,270
Northern,Culpeper County,51047,361,1548,1909,518,3651,4169,52332,430985,483317,11/01/2018 12:00:00 AM,145,278,253
Northern,Culpeper County,51047,361,1573,1934,511,3730,4241,50412,440769,491181,09/01/2018 12:00:00 AM,140,280,254
Northern,Culpeper County,51047,361,1812,2173,529,4593,5122,54976,552659,607635,05/01/2016 12:00:00 AM,152,305,280
Northern,Culpeper County,51047,361,1818,2179,530,4619,5149,55717,556616,612333,06/01/2016 12:00:00 AM,154,306,281
Northern,Culpeper County,51047,363,1593,1956,509,3820,4329,49471,449264,498735,07/01/2018 12:00:00 AM,136,282,255
Northern,Culpeper County,51047,363,1615,1978,517,4012,4529,57096,491407,548503,09/01/2017 12:00:00 AM,157,304,277
Northern,Culpeper County,51047,363,1645,2008,504,3966,4470,52188,480810,532998,03/01/2018 12:00:00 AM,144,292,265
Northern,Culpeper County,51047,364,1562,1926,524,3712,4236,53263,441783,495046,10/01/2018 12:00:00 AM,146,283,257
Northern,Culpeper County,51047,364,1596,1960,509,3816,4325,51164,444414,495578,08/01/2018 12:00:00 AM,141,278,253
Northern,Culpeper County,51047,364,1625,1989,523,3991,4514,56601,488028,544629,12/01/2017 12:00:00 AM,155,300,274
Northern,Culpeper County,51047,365,1621,1986,521,4039,4560,57228,488988,546216,11/01/2017 12:00:00 AM,157,302,275
Northern,Culpeper County,51047,365,1756,2121,530,4401,4931,55939,530663,586602,01/01/2017 12:00:00 AM,153,302,277
Northern,Culpeper County,51047,366,1740,2106,562,4347,4909,60457,521608,582065,11/01/2016 12:00:00 AM,165,300,276
Northern,Culpeper County,51047,367,1600,1967,524,3871,4395,54029,462683,516712,04/01/2018 12:00:00 AM,147,289,263
Northern,Culpeper County,51047,367,1643,2010,518,4027,4545,52789,487897,540686,01/01/2018 12:00:00 AM,144,297,269
Northern,Culpeper County,51047,367,1648,2015,518,4088,4606,56639,504086,560725,10/01/2017 12:00:00 AM,154,306,278
Northern,Culpeper County,51047,367,1766,2133,531,4490,5021,56411,543338,599749,07/01/2016 12:00:00 AM,154,308,281
Northern,Culpeper County,51047,368,1575,1943,527,3804,4331,54837.55,453505,508342.55,05/01/2018 12:00:00 AM,149,288,262
Northern,Culpeper County,51047,368,1838,2206,539,4649,5188,56962,551570,608532,03/01/2016 12:00:00 AM,155,300,276
Northern,Culpeper County,51047,369,1567,1936,521,3757,4278,53984,445085,499069,06/01/2018 12:00:00 AM,146,284,258
Northern,Culpeper County,51047,370,1743,2113,538,4388,4926,57210,527673,584883,02/01/2017 12:00:00 AM,155,303,277
Northern,Culpeper County,51047,370,1755,2125,562,4382,4944,59838,526949,586787,12/01/2016 12:00:00 AM,162,300,276
Northern,Culpeper County,51047,371,1746,2117,553,4430,4983,58550,535375,593925,08/01/2016 12:00:00 AM,158,307,281
Northern,Culpeper County,51047,372,1852,2224,548,4681,5229,57628,556199,613827,02/01/2016 12:00:00 AM,155,300,276
Northern,Culpeper County,51047,377,1731,2108,577,4316,4893,63026,521433,584459,10/01/2016 12:00:00 AM,167,301,277
Northern,Culpeper County,51047,378,1752,2130,573,4389,4962,60870,531370,592240,09/01/2016 12:00:00 AM,161,303,278
Northern,Culpeper County,51047,379,1961,2340,554,4840,5394,58314,581165,639479,06/01/2015 12:00:00 AM,154,296,273
Northern,Culpeper County,51047,381,1904,2285,562,4750,5312,58707,565988,624695,10/01/2015 12:00:00 AM,154,297,273
Northern,Culpeper County,51047,381,1991,2372,566,4902,5468,59169,587960,647129,05/01/2015 12:00:00 AM,155,295,273
Northern,Culpeper County,51047,381,2001,2382,572,4898,5470,60448,583984,644432,04/01/2015 12:00:00 AM,159,292,271
Northern,Culpeper County,51047,382,1935,2317,561,4800,5361,59560,575516,635076,08/01/2015 12:00:00 AM,156,297,274
Northern,Culpeper County,51047,383,1838,2221,576,4653,5229,61098,547806,608904,01/01/2016 12:00:00 AM,160,298,274
Northern,Culpeper County,51047,383,1915,2298,565,4743,5308,60307,570149,630456,09/01/2015 12:00:00 AM,157,298,274
Northern,Culpeper County,51047,384,1858,2242,566,4660,5226,58750,556947,615697,12/01/2015 12:00:00 AM,153,300,275
Northern,Culpeper County,51047,384,1998,2382,591,4879,5470,62849,585242,648091,02/01/2015 12:00:00 AM,164,293,272
Northern,Culpeper County,51047,387,1965,2352,578,4865,5443,61588,578957,640545,07/01/2015 12:00:00 AM,159,295,272
Northern,Culpeper County,51047,388,1854,2242,580,4606,5186,61706,550227,611933,11/01/2015 12:00:00 AM,159,297,273
Northern,Culpeper County,51047,388,2121,2509,660,5078,5738,79079,659467,738546,07/01/2012 12:00:00 AM,204,311,294
Northern,Culpeper County,51047,389,1990,2379,593,4874,5467,64576,583450,648026,03/01/2015 12:00:00 AM,166,293,272
Northern,Culpeper County,51047,392,2127,2519,675,5139,5814,79665,667298,746963,06/01/2012 12:00:00 AM,203,314,297
Northern,Culpeper County,51047,395,2205,2600,702,5242,5944,84561,687702,772263,02/01/2012 12:00:00 AM,214,312,297
Northern,Culpeper County,51047,397,2167,2564,706,5189,5895,83337,677669,761006,05/01/2012 12:00:00 AM,210,313,297
Northern,Culpeper County,51047,399,2011,2410,624,4892,5516,67149,583015,650164,01/01/2015 12:00:00 AM,168,290,270
Northern,Culpeper County,51047,399,2199,2598,706,5250,5956,85940,688287,774227,03/01/2012 12:00:00 AM,215,313,298
Northern,Culpeper County,51047,401,2198,2599,722,5233,5955,84787,684755,769542,04/01/2012 12:00:00 AM,211,312,296
Northern,Culpeper County,51047,403,2015,2418,639,4896,5535,71751,590126,661877,12/01/2014 12:00:00 AM,178,293,274
Northern,Culpeper County,51047,403,2183,2586,715,5191,5906,85615,671685,757300,01/01/2012 12:00:00 AM,212,308,293
Northern,Culpeper County,51047,404,2169,2573,696,5168,5864,81585,663805,745390,08/01/2012 12:00:00 AM,202,306,290
Northern,Culpeper County,51047,405,2180,2585,664,5287,5951,69950,633155,703105,03/01/2014 12:00:00 AM,173,290,272
Northern,Culpeper County,51047,406,2100,2506,662,5114,5776,69913,602506,672419,08/01/2014 12:00:00 AM,172,287,268
Northern,Culpeper County,51047,406,2104,2510,654,5111,5765,66362,608649,675011,07/01/2014 12:00:00 AM,163,289,269
Northern,Culpeper County,51047,407,2169,2576,674,5256,5930,72964,626438,699402,02/01/2014 12:00:00 AM,179,289,272
Northern,Culpeper County,51047,408,2160,2568,683,5238,5921,73485,620524,694009,01/01/2014 12:00:00 AM,180,287,270
Northern,Culpeper County,51047,413,2013,2426,672,4882,5554,74891,594026,668917,11/01/2014 12:00:00 AM,181,295,276
Northern,Culpeper County,51047,413,2074,2487,692,4985,5677,72575,589433,662008,09/01/2014 12:00:00 AM,176,284,266
Northern,Culpeper County,51047,413,2191,2604,679,5292,5971,70444,635192,705636,04/01/2014 12:00:00 AM,171,290,271
Northern,Culpeper County,51047,416,2132,2548,681,5138,5819,69086,616452,685538,06/01/2014 12:00:00 AM,166,289,269
Northern,Culpeper County,51047,417,2018,2435,685,4911,5596,76255,595965,672220,10/01/2014 12:00:00 AM,183,295,276
Northern,Culpeper County,51047,418,2165,2583,729,5152,5881,86685,672794,759479,09/01/2012 12:00:00 AM,207,311,294
Northern,Culpeper County,51047,419,2163,2582,691,5219,5910,72173,627338,699511,05/01/2014 12:00:00 AM,172,290,271
Northern,Culpeper County,51047,420,2149,2569,725,5136,5861,87084,671381,758465,10/01/2012 12:00:00 AM,207,312,295
Northern,Culpeper County,51047,420,2182,2602,726,5183,5909,88015,675062,763077,11/01/2012 12:00:00 AM,210,309,293
Northern,Culpeper County,51047,421,2144,2565,718,5181,5899,77781,621511,699292,12/01/2013 12:00:00 AM,185,290,273
Northern,Culpeper County,51047,421,2193,2614,737,5191,5928,88231,682156,770387,02/01/2013 12:00:00 AM,210,311,295
Northern,Culpeper County,51047,421,2213,2634,745,5240,5985,89242,686230,775472,01/01/2013 12:00:00 AM,212,310,294
Northern,Culpeper County,51047,423,2195,2618,722,5222,5944,89311,699085,788396,03/01/2013 12:00:00 AM,211,318,301
Northern,Culpeper County,51047,424,2179,2603,730,5254,5984,79598,630241,709839,11/01/2013 12:00:00 AM,188,289,273
Northern,Culpeper County,51047,426,2212,2638,747,5246,5993,89518,691309,780827,12/01/2012 12:00:00 AM,210,313,296
Northern,Culpeper County,51047,430,2203,2633,747,5237,5984,91374,690476,781850,04/01/2013 12:00:00 AM,212,313,297
Northern,Culpeper County,51047,431,2219,2650,748,5321,6069,88585,690841,779426,10/01/2013 12:00:00 AM,206,311,294
Northern,Culpeper County,51047,433,2217,2650,738,5303,6041,88983,684295,773278,08/01/2013 12:00:00 AM,206,309,292
Northern,Culpeper County,51047,434,2215,2649,753,5288,6041,91360,687452,778812,09/01/2013 12:00:00 AM,211,310,294
Northern,Culpeper County,51047,438,2207,2645,762,5257,6019,90748,689182,779930,07/01/2013 12:00:00 AM,207,312,295
Northern,Culpeper County,51047,442,2233,2675,777,5297,6074,94107,700398,794505,05/01/2013 12:00:00 AM,213,314,297
Northern,Culpeper County,51047,449,2217,2666,803,5238,6041,96275,694784,791059,06/01/2013 12:00:00 AM,214,313,297
Northern,Fairfax City,51600,32,155,187,40,321,361,3476,43571,47047,05/01/2013 12:00:00 AM,109,281,252
Northern,Fairfax City,51600,33,118,151,40,221,261,3635,31007,34642,08/01/2012 12:00:00 AM,110,263,229
Northern,Fairfax City,51600,33,153,186,39,315,354,3754,41696,45450,03/01/2013 12:00:00 AM,114,273,244
Northern,Fairfax City,51600,33,155,188,43,317,360,3771,43244,47015,06/01/2013 12:00:00 AM,114,279,250
Northern,Fairfax City,51600,33,157,190,41,324,365,3735,44251,47986,04/01/2013 12:00:00 AM,113,282,253
Northern,Fairfax City,51600,34,120,154,42,234,276,3839,32554,36393,10/01/2012 12:00:00 AM,113,271,236
Northern,Fairfax City,51600,34,151,185,45,314,359,4314,43652,47966,07/01/2013 12:00:00 AM,127,289,259
Northern,Fairfax City,51600,35,104,139,42,213,255,4023,29185,33208,03/01/2012 12:00:00 AM,115,281,239
Northern,Fairfax City,51600,35,105,140,42,216,258,4057,30111,34168,02/01/2012 12:00:00 AM,116,287,244
Northern,Fairfax City,51600,35,106,141,43,210,253,4263,28416,32679,05/01/2012 12:00:00 AM,122,268,232
Northern,Fairfax City,51600,35,115,150,44,224,268,4213,31802,36015,09/01/2012 12:00:00 AM,120,277,240
Northern,Fairfax City,51600,36,107,143,43,219,262,4150,30035,34185,01/01/2012 12:00:00 AM,115,281,239
Northern,Fairfax City,51600,36,107,143,44,198,242,4251,27698,31949,06/01/2012 12:00:00 AM,118,259,223
Northern,Fairfax City,51600,36,108,144,43,217,260,4215,29767,33982,04/01/2012 12:00:00 AM,117,276,236
Northern,Fairfax City,51600,37,111,148,45,212,257,4486,29019,33505,07/01/2012 12:00:00 AM,121,261,226
Northern,Fairfax City,51600,38,143,181,47,295,342,4583,40718,45301,02/01/2013 12:00:00 AM,121,285,250
Northern,Fairfax City,51600,40,121,161,52,243,295,4885,34027,38912,11/01/2012 12:00:00 AM,122,281,242
Northern,Fairfax City,51600,40,126,166,49,251,300,4447,34401,38848,12/01/2012 12:00:00 AM,111,273,234
Northern,Fairfax City,51600,40,135,175,49,268,317,4330,36732,41062,01/01/2013 12:00:00 AM,108,272,235
Northern,Fairfax City,51600,40,211,251,62,451,513,5628,60491,66119,08/01/2013 12:00:00 AM,141,287,263
Northern,Fairfax City,51600,52,205,257,67,475,542,7500,55990,63490,08/01/2016 12:00:00 AM,144,273,247
Northern,Fairfax City,51600,52,207,259,65,491,556,6932,59016,65948,07/01/2016 12:00:00 AM,133,285,255
Northern,Fairfax City,51600,53,214,267,68,489,557,7653,58350,66003,09/01/2016 12:00:00 AM,144,273,247
Northern,Fairfax City,51600,53,216,269,67,500,567,7680,60103,67783,10/01/2016 12:00:00 AM,145,278,252
Northern,Fairfax City,51600,55,204,259,72,470,542,7675,56134,63809,04/01/2016 12:00:00 AM,140,275,246
Northern,Fairfax City,51600,55,206,261,79,477,556,8975,57909,66884,12/01/2015 12:00:00 AM,163,281,256
Northern,Fairfax City,51600,55,207,262,69,484,553,7352,58946,66298,05/01/2016 12:00:00 AM,134,285,253
Northern,Fairfax City,51600,55,208,263,76,485,561,8504,58291,66795,02/01/2016 12:00:00 AM,155,280,254
Northern,Fairfax City,51600,55,210,265,73,496,569,7478,59674,67152,06/01/2016 12:00:00 AM,136,284,253
Northern,Fairfax City,51600,55,214,269,72,498,570,8057,61086,69143,03/01/2016 12:00:00 AM,146,285,257
Northern,Fairfax City,51600,56,197,253,80,469,549,8923,55626,64549,01/01/2016 12:00:00 AM,159,282,255
Northern,Fairfax City,51600,57,223,280,75,519,594,7490,67234,74724,03/01/2015 12:00:00 AM,131,301,267
Northern,Fairfax City,51600,57,230,287,71,533,604,7796,66314,74110,11/01/2016 12:00:00 AM,137,288,258
Northern,Fairfax City,51600,57,238,295,67,555,622,7263,67532,74795,12/01/2016 12:00:00 AM,127,284,254
Northern,Fairfax City,51600,57,246,303,80,567,647,8713,74031,82744,10/01/2014 12:00:00 AM,153,301,273
Northern,Fairfax City,51600,58,208,266,85,476,561,8939,57993,66932,11/01/2015 12:00:00 AM,154,279,252
Northern,Fairfax City,51600,58,209,267,85,482,567,9732,57878,67610,10/01/2015 12:00:00 AM,168,277,253
Northern,Fairfax City,51600,58,235,293,80,541,621,8422,69633,78055,11/01/2014 12:00:00 AM,145,296,266
Northern,Fairfax City,51600,59,214,273,81,495,576,8031,66557,74588,02/01/2015 12:00:00 AM,136,311,273
Northern,Fairfax City,51600,59,233,292,82,540,622,8792,69108,77900,12/01/2014 12:00:00 AM,149,297,267
Northern,Fairfax City,51600,60,231,291,76,532,608,7490,64854,72344,04/01/2015 12:00:00 AM,125,281,249
Northern,Fairfax City,51600,61,214,275,85,489,574,8796,58869,67665,09/01/2015 12:00:00 AM,144,275,246
Northern,Fairfax City,51600,61,223,284,84,521,605,8344,64339,72683,01/01/2015 12:00:00 AM,137,289,256
Northern,Fairfax City,51600,61,227,288,81,503,584,8361,62430,70791,06/01/2015 12:00:00 AM,137,275,246
Northern,Fairfax City,51600,61,282,343,93,656,749,9224,79398,88622,07/01/2014 12:00:00 AM,151,282,258
Northern,Fairfax City,51600,62,253,315,88,600,688,8147,73546,81693,09/01/2014 12:00:00 AM,131,291,259
Northern,Fairfax City,51600,62,279,341,92,646,738,8956,78428,87384,06/01/2014 12:00:00 AM,144,281,256
Northern,Fairfax City,51600,63,224,287,80,505,585,7782,61926,69708,05/01/2015 12:00:00 AM,124,276,243
Northern,Fairfax City,51600,63,258,321,78,578,656,8204,70939,79143,01/01/2017 12:00:00 AM,130,275,247
Northern,Fairfax City,51600,63,267,330,97,632,729,9518,75351,84869,08/01/2014 12:00:00 AM,151,282,257
Northern,Fairfax City,51600,63,279,342,70,621,691,6714,77721,84435,02/01/2017 12:00:00 AM,107,279,247
Northern,Fairfax City,51600,64,222,286,87,493,580,8532,59210,67742,07/01/2015 12:00:00 AM,133,267,237
Northern,Fairfax City,51600,65,279,344,97,640,737,10470,77476,87946,05/01/2014 12:00:00 AM,161,278,256
Northern,Fairfax City,51600,65,289,354,96,656,752,9374,80514,89888,04/01/2014 12:00:00 AM,144,279,254
Northern,Fairfax City,51600,66,218,284,95,496,591,9610,59761,69371,08/01/2015 12:00:00 AM,146,274,244
Northern,Fairfax City,51600,67,284,351,100,636,736,9888,77578,87466,03/01/2014 12:00:00 AM,148,273,249
Northern,Fairfax City,51600,69,295,364,100,663,763,9471,83341,92812,02/01/2014 12:00:00 AM,137,283,255
Northern,Fairfax City,51600,73,281,354,82,624,706,8022,81513,89535,03/01/2017 12:00:00 AM,110,290,253
Northern,Fairfax City,51600,73,283,356,84,624,708,8166,79790,87956,04/01/2017 12:00:00 AM,112,282,247
Northern,Fairfax City,51600,73,285,358,108,650,758,10492,80965,91457,01/01/2014 12:00:00 AM,144,284,255
Northern,Fairfax City,51600,75,288,363,86,634,720,8884,81243,90127,05/01/2017 12:00:00 AM,118,282,248
Northern,Fairfax City,51600,76,276,352,86,628,714,8639,79696,88335,06/01/2017 12:00:00 AM,114,289,251
Northern,Fairfax City,51600,76,313,389,116,663,779,11550,85701,97251,11/01/2013 12:00:00 AM,152,274,250
Northern,Fairfax City,51600,78,276,354,88,534,622,8513,73678,82191,02/01/2020 12:00:00 AM,109,267,232
Northern,Fairfax City,51600,78,282,360,90,540,630,17010,94727,111737,03/01/2020 12:00:00 AM,218,336,310
Northern,Fairfax City,51600,79,302,381,119,658,777,11477,84418,95895,12/01/2013 12:00:00 AM,145,280,252
Northern,Fairfax City,51600,79,326,405,91,650,741,17414,117666,135080,04/01/2020 12:00:00 AM,220,361,334
Northern,Fairfax City,51600,80,279,359,91,621,712,9305,78663,87968,07/01/2017 12:00:00 AM,116,282,245
Northern,Fairfax City,51600,80,281,361,94,616,710,10197,79155,89352,09/01/2017 12:00:00 AM,127,282,248
Northern,Fairfax City,51600,80,322,402,118,685,803,11955,93830,105785,10/01/2013 12:00:00 AM,149,291,263
Northern,Fairfax City,51600,80,349,429,92,666,758,17280,117724,135004,05/01/2020 12:00:00 AM,216,337,315
Northern,Fairfax City,51600,81,326,407,91,654,745,21080,139358,160438,01/01/2021 12:00:00 AM,260,427,394
Northern,Fairfax City,51600,81,329,410,89,653,742,20523,142541,163064,02/01/2021 12:00:00 AM,253,433,398
Northern,Fairfax City,51600,82,268,350,96,573,669,9161,69458.29,78619.29,10/01/2017 12:00:00 AM,112,259,225
Northern,Fairfax City,51600,82,273,355,102,516,618,10038,70913,80951,01/01/2020 12:00:00 AM,122,260,228
Northern,Fairfax City,51600,82,342,424,90,672,762,20723,140499,161222,03/01/2021 12:00:00 AM,253,411,380
Northern,Fairfax City,51600,83,278,361,103,530,633,9172,72498,81670,09/01/2019 12:00:00 AM,111,261,226
Northern,Fairfax City,51600,83,283,366,101,545,646,9499,71800,81299,08/01/2019 12:00:00 AM,114,254,222
Northern,Fairfax City,51600,83,331,414,98,649,747,19212,121808,141020,11/01/2020 12:00:00 AM,231,368,341
Northern,Fairfax City,51600,83,347,430,99,675,774,19465,124567,144032,10/01/2020 12:00:00 AM,235,359,335
Northern,Fairfax City,51600,84,275,359,108,554,662,11012,70719,81731,02/01/2019 12:00:00 AM,131,257,228
Northern,Fairfax City,51600,84,284,368,108,539,647,10278,69003,79281,07/01/2019 12:00:00 AM,122,243,215
Northern,Fairfax City,51600,84,299,383,106,576,682,10763,73741,84504,05/01/2019 12:00:00 AM,128,247,221
Northern,Fairfax City,51600,84,348,432,92,675,767,22918,157928,180846,04/01/2021 12:00:00 AM,273,454,419
Northern,Fairfax City,51600,84,356,440,97,688,785,23146,163693,186839,05/01/2021 12:00:00 AM,276,460,425
Northern,Fairfax City,51600,85,273,358,101,576,677,9408,68789,78197,07/01/2018 12:00:00 AM,111,252,218
Northern,Fairfax City,51600,85,273,358,99,607,706,11142,75600,86742,08/01/2017 12:00:00 AM,131,277,242
Northern,Fairfax City,51600,85,332,417,102,652,754,20143,121703,141846,12/01/2020 12:00:00 AM,237,367,340
Northern,Fairfax City,51600,85,353,438,104,682,786,19822,118451,138273,09/01/2020 12:00:00 AM,233,336,316
Northern,Fairfax City,51600,85,355,440,99,694,793,24575,162006,186581,06/01/2021 12:00:00 AM,289,456,424
Northern,Fairfax City,51600,85,356,441,107,679,786,19798,118871,138669,06/01/2020 12:00:00 AM,233,334,314
Northern,Fairfax City,51600,86,254,340,97,562,659,9444,65287,74731,04/01/2018 12:00:00 AM,110,257,220
Northern,Fairfax City,51600,86,262,348,96,580,676,8888,72456,81344,03/01/2018 12:00:00 AM,103,277,234
Northern,Fairfax City,51600,86,267,353,100,583,683,9524,70543,80067,05/01/2018 12:00:00 AM,111,264,227
Northern,Fairfax City,51600,86,269,355,101,576,677,9718,72135,81853,11/01/2017 12:00:00 AM,113,268,231
Northern,Fairfax City,51600,86,275,361,107,570,677,10556,70548,81104,09/01/2018 12:00:00 AM,123,257,225
Northern,Fairfax City,51600,86,280,366,110,549,659,11672,70279,81951,03/01/2019 12:00:00 AM,136,251,224
Northern,Fairfax City,51600,86,283,369,104,597,701,9939,73488,83427,08/01/2018 12:00:00 AM,116,260,226
Northern,Fairfax City,51600,86,283,369,107,588,695,11039,78104,89143,01/01/2019 12:00:00 AM,128,276,242
Northern,Fairfax City,51600,86,336,422,138,720,858,14719,97660,112379,09/01/2013 12:00:00 AM,171,291,266
Northern,Fairfax City,51600,86,355,441,104,676,780,19704,120818,140522,07/01/2020 12:00:00 AM,229,340,319
Northern,Fairfax City,51600,87,268,355,104,574,678,9885,68330,78215,06/01/2018 12:00:00 AM,114,255,220
Northern,Fairfax City,51600,87,276,363,112,511,623,11564,70434,81998,10/01/2019 12:00:00 AM,133,255,226
Northern,Fairfax City,51600,87,279,366,113,527,640,11531,72161,83692,11/01/2019 12:00:00 AM,133,259,229
Northern,Fairfax City,51600,87,280,367,111,540,651,11208,68573,79781,04/01/2019 12:00:00 AM,129,245,217
Northern,Fairfax City,51600,87,284,371,111,547,658,10738,69004,79742,06/01/2019 12:00:00 AM,123,243,215
Northern,Fairfax City,51600,87,360,447,107,693,800,19970,122087,142057,08/01/2020 12:00:00 AM,230,339,318
Northern,Fairfax City,51600,88,257,345,105,566,671,10126,69854,79980,01/01/2018 12:00:00 AM,115,272,232
Northern,Fairfax City,51600,88,266,354,102,579,681,9687,73840,83527,12/01/2017 12:00:00 AM,110,278,236
Northern,Fairfax City,51600,88,268,356,113,570,683,11604,71674,83278,12/01/2018 12:00:00 AM,132,267,234
Northern,Fairfax City,51600,89,279,368,116,522,638,12368,71162,83530,12/01/2019 12:00:00 AM,139,255,227
Northern,Fairfax City,51600,91,253,344,105,561,666,9714,68404,78118,02/01/2018 12:00:00 AM,107,270,227
Northern,Fairfax City,51600,91,281,372,119,590,709,12321,74264,86585,10/01/2018 12:00:00 AM,135,264,233
Northern,Fairfax City,51600,93,278,371,123,586,709,12878,72651,85529,11/01/2018 12:00:00 AM,138,261,231
Northern,Fairfax County,51059,4912,13112,18024,6531,29192,35723,584869,3585456,4170325,01/01/2020 12:00:00 AM,119,273,231
Northern,Fairfax County,51059,4938,13344,18282,6570,29577,36147,610999,3650707,4261706,12/01/2019 12:00:00 AM,124,274,233
Northern,Fairfax County,51059,4940,13115,18055,6586,29121,35707,1208912,5010797,6219709,03/01/2020 12:00:00 AM,245,382,344
Northern,Fairfax County,51059,4943,12922,17865,6596,28663,35259,600017,3534585,4134602,02/01/2020 12:00:00 AM,121,274,231
Northern,Fairfax County,51059,4956,13326,18282,6627,29572,36199,612815,3640713,4253528,11/01/2019 12:00:00 AM,124,273,233
Northern,Fairfax County,51059,4972,13805,18777,6646,30614,37260,594173,3737522,4331695,07/01/2019 12:00:00 AM,120,271,231
Northern,Fairfax County,51059,4980,13777,18757,6671,30449,37120,605145,3722138,4327283,08/01/2019 12:00:00 AM,122,270,231
Northern,Fairfax County,51059,4986,13544,18530,6664,30016,36680,617999,3718149,4336148,10/01/2019 12:00:00 AM,124,275,234
Northern,Fairfax County,51059,5008,13708,18716,6694,30380,37074,611964,3721299,4333263,09/01/2019 12:00:00 AM,122,271,232
Northern,Fairfax County,51059,5010,13565,18575,6763,30103,36866,621438,3695896,4317334,02/01/2019 12:00:00 AM,124,272,232
Northern,Fairfax County,51059,5011,16876,21887,6796,37796,44592,630707,4807159,5437866,02/01/2017 12:00:00 AM,126,285,248
Northern,Fairfax County,51059,5024,13946,18970,6773,30938,37711,607641,3774779,4382420,06/01/2019 12:00:00 AM,121,271,231
Northern,Fairfax County,51059,5042,15106,20148,6754,33505,40259,1245625,5809589,7055214,04/01/2020 12:00:00 AM,247,385,350
Northern,Fairfax County,51059,5057,14055,19112,6870,31210,38080,619872,3803235,4423107,05/01/2019 12:00:00 AM,123,271,231
Northern,Fairfax County,51059,5070,16212,21282,6982,36388,43370,661311,4629171,5290482,05/01/2017 12:00:00 AM,130,286,249
Northern,Fairfax County,51059,5071,16716,21787,6945,37445,44390,651299,4777967,5429266,03/01/2017 12:00:00 AM,128,286,249
Northern,Fairfax County,51059,5076,16494,21570,6600,36589,43189,1483199,7768274,9251473,02/01/2021 12:00:00 AM,292,471,429
Northern,Fairfax County,51059,5093,14115,19208,6899,31375,38274,621937,3832236,4454173,04/01/2019 12:00:00 AM,122,272,232
Northern,Fairfax County,51059,5096,16331,21427,7009,36586,43595,664299,4630783,5295082,04/01/2017 12:00:00 AM,130,284,247
Northern,Fairfax County,51059,5099,14224,19323,6918,31673,38591,629615,3888885,4518500,03/01/2019 12:00:00 AM,123,273,234
Northern,Fairfax County,51059,5116,15864,20980,6909,34821,41730,1269199,6043767,7312966,05/01/2020 12:00:00 AM,248,381,349
Northern,Fairfax County,51059,5127,14697,19824,7022,32714,39736,658747,4055204,4713951,10/01/2018 12:00:00 AM,128,276,238
Northern,Fairfax County,51059,5133,14308,19441,6984,31844,38828,652039,4100786,4752825,01/01/2019 12:00:00 AM,127,287,244
Northern,Fairfax County,51059,5143,16212,21355,6923,35953,42876,1539217,7532271,9071488,01/01/2021 12:00:00 AM,299,465,425
Northern,Fairfax County,51059,5145,14531,19676,7076,32372,39448,674625,4003637,4678262,11/01/2018 12:00:00 AM,131,276,238
Northern,Fairfax County,51059,5150,16647,21797,6779,36783,43562,1513977.2,7712357,9226334.2,03/01/2021 12:00:00 AM,294,463,423
Northern,Fairfax County,51059,5151,16087,21238,7119,36141,43260,681043.5,4595441.76,5276485.26,06/01/2017 12:00:00 AM,132,286,248
Northern,Fairfax County,51059,5155,14447,19602,7061,32132,39193,676746.65,3971647,4648393.65,12/01/2018 12:00:00 AM,131,275,237
Northern,Fairfax County,51059,5156,16085,21241,6931,35536,42467,1340559,6582892,7923451,11/01/2020 12:00:00 AM,260,409,373
Northern,Fairfax County,51059,5159,16220,21379,6923,35810,42733,1338417,6509439,7847856,12/01/2020 12:00:00 AM,259,401,367
Northern,Fairfax County,51059,5174,15857,21031,7178,35665,42843,688606,4499120,5187726,07/01/2017 12:00:00 AM,133,284,247
Northern,Fairfax County,51059,5177,14795,19972,7121,32994,40115,653660,4054059,4707719,09/01/2018 12:00:00 AM,126,274,236
Northern,Fairfax County,51059,5180,15904,21084,7212,35744,42956,701858,4512066,5213924,09/01/2017 12:00:00 AM,135,284,247
Northern,Fairfax County,51059,5187,16581,21768,6880,36563,43443,1604707,8347259,9951966,04/01/2021 12:00:00 AM,309,503,457
Northern,Fairfax County,51059,5194,16278,21472,6963,35864,42827,1347972,6552831,7900803,10/01/2020 12:00:00 AM,260,403,368
Northern,Fairfax County,51059,5195,16483,21678,6909,36391,43300,1614517,8349011,9963528,05/01/2021 12:00:00 AM,311,507,460
Northern,Fairfax County,51059,5196,15886,21082,7234,35648,42882,708089,4507683.26,5215772.26,08/01/2017 12:00:00 AM,136,284,247
Northern,Fairfax County,51059,5209,15112,20321,7213,33868,41081,661214.3,4161415,4822629.3,07/01/2018 12:00:00 AM,127,275,237
Northern,Fairfax County,51059,5213,15033,20246,7192,33476,40668,658878,4097985,4756863,08/01/2018 12:00:00 AM,126,273,235
Northern,Fairfax County,51059,5216,15717,20933,7247,35370,42617,700212,4407739.06,5107951.06,10/01/2017 12:00:00 AM,134,280,244
Northern,Fairfax County,51059,5219,15735,20954,7227,35503,42730,698390,4404704,5103094,12/01/2017 12:00:00 AM,134,280,244
Northern,Fairfax County,51059,5221,15555,20776,7238,34824,42062,666853,4301780.55,4968633.55,03/01/2018 12:00:00 AM,128,277,239
Northern,Fairfax County,51059,5224,17537,22761,7144,39565,46709,645758,4923613.02,5569371.02,01/01/2017 12:00:00 AM,124,281,245
Northern,Fairfax County,51059,5225,16208,21433,7077,35340,42417,1300070,6156238,7456308,06/01/2020 12:00:00 AM,249,380,348
Northern,Fairfax County,51059,5229,16625,21854,7016,36537,43553,1291270.25,6345151,7636421.25,09/01/2020 12:00:00 AM,247,382,349
Northern,Fairfax County,51059,5232,15299,20531,7244,34222,41466,657683,4192177,4849860,06/01/2018 12:00:00 AM,126,274,236
Northern,Fairfax County,51059,5235,15746,20981,7253,35439,42692,696802,4394811,5091613,11/01/2017 12:00:00 AM,133,279,243
Northern,Fairfax County,51059,5237,16460,21697,6984,36254,43238,1627442,8289786,9917228,06/01/2021 12:00:00 AM,311,504,457
Northern,Fairfax County,51059,5238,16688,21926,7071,36470,43541,1296402,6261483,7557885,08/01/2020 12:00:00 AM,247,375,345
Northern,Fairfax County,51059,5240,17479,22719,7211,39439,46650,664766,4916943,5581709,12/01/2016 12:00:00 AM,127,281,246
Northern,Fairfax County,51059,5245,17703,22948,7232,40088,47320,665248,4931402,5596650,08/01/2016 12:00:00 AM,127,279,244
Northern,Fairfax County,51059,5247,17721,22968,7272,40113,47385,670182,4937643,5607825,09/01/2016 12:00:00 AM,128,279,244
Northern,Fairfax County,51059,5248,17090,22338,7543,38474,46017,722779,4995799,5718578,03/01/2015 12:00:00 AM,138,292,256
Northern,Fairfax County,51059,5249,15578,20827,7276,34973,42249,673317,4323510,4996827,02/01/2018 12:00:00 AM,128,278,240
Northern,Fairfax County,51059,5252,15334,20586,7267,34263,41530,663769,4220008.56,4883777.56,05/01/2018 12:00:00 AM,126,275,237
Northern,Fairfax County,51059,5254,15445,20699,7287,34481,41768,671097,4265838,4936935,04/01/2018 12:00:00 AM,128,276,239
Northern,Fairfax County,51059,5255,15694,20949,7290,35251,42541,673855,4368232,5042087,01/01/2018 12:00:00 AM,128,278,241
Northern,Fairfax County,51059,5258,17875,23133,7266,40395,47661,674740,4983725,5658465,06/01/2016 12:00:00 AM,128,279,245
Northern,Fairfax County,51059,5270,17709,22979,7304,40036,47340,670068,4922629,5592697,07/01/2016 12:00:00 AM,127,278,243
Northern,Fairfax County,51059,5273,17379,22652,7322,39290,46612,680117,4892967,5573084,11/01/2016 12:00:00 AM,129,282,246
Northern,Fairfax County,51059,5275,16484,21759,7156,35881,43037,1319499,6198623,7518122,07/01/2020 12:00:00 AM,250,376,346
Northern,Fairfax County,51059,5277,16819,22096,7653,37797,45450,742317,4878204,5620521,02/01/2015 12:00:00 AM,141,290,254
Northern,Fairfax County,51059,5288,17550,22838,7329,39683,47012,685846,4948404,5634250,10/01/2016 12:00:00 AM,130,282,247
Northern,Fairfax County,51059,5295,17655,22950,7557,39674,47231,720589,5123670,5844259,04/01/2015 12:00:00 AM,136,290,255
Northern,Fairfax County,51059,5324,17835,23159,7365,40260,47625,686927,4971960,5658887,05/01/2016 12:00:00 AM,129,279,244
Northern,Fairfax County,51059,5349,17808,23157,7612,39932,47544,725322,5034950,5760272,05/01/2015 12:00:00 AM,136,283,249
Northern,Fairfax County,51059,5368,17282,22650,7767,38733,46500,758838,4987688,5746526,11/01/2014 12:00:00 AM,141,289,254
Northern,Fairfax County,51059,5369,17934,23303,7484,40405,47889,710508,4997705,5708213,04/01/2016 12:00:00 AM,132,279,245
Northern,Fairfax County,51059,5370,18022,23392,7632,40331,47963,725973,5069750,5795723,06/01/2015 12:00:00 AM,135,281,248
Northern,Fairfax County,51059,5377,17848,23225,7593,40197,47790,734182,5011742,5745924,02/01/2016 12:00:00 AM,137,281,247
Northern,Fairfax County,51059,5380,18028,23408,7534,40545,48079,726123,5042041,5768164,03/01/2016 12:00:00 AM,135,280,246
Northern,Fairfax County,51059,5381,17856,23237,7627,40139,47766,735318,4987633,5722951,01/01/2016 12:00:00 AM,137,279,246
Northern,Fairfax County,51059,5393,18384,23777,7781,40222,48003,723146,5108667,5831813,03/01/2014 12:00:00 AM,134,278,245
Northern,Fairfax County,51059,5396,17036,22432,7757,38148,45905,740420,4863682,5604102,01/01/2015 12:00:00 AM,137,285,250
Northern,Fairfax County,51059,5407,18168,23575,7719,40664,48383,738858,5091892,5830750,09/01/2015 12:00:00 AM,137,280,247
Northern,Fairfax County,51059,5411,17272,22683,7788,38749,46537,767997,5014193,5782190,12/01/2014 12:00:00 AM,142,290,255
Northern,Fairfax County,51059,5419,18034,23453,7713,40406,48119,731621,5067531,5799152,07/01/2015 12:00:00 AM,135,281,247
Northern,Fairfax County,51059,5423,17436,22859,7865,38932,46797,770092,5106564,5876656,10/01/2014 12:00:00 AM,142,293,257
Northern,Fairfax County,51059,5424,17299,22723,7917,38233,46150,732099,4762745,5494844,09/01/2014 12:00:00 AM,135,275,242
Northern,Fairfax County,51059,5426,18056,23482,7736,40403,48139,737182,5051920,5789102,08/01/2015 12:00:00 AM,136,280,247
Northern,Fairfax County,51059,5427,17981,23408,7937,39612,47549,732501,4929990,5662491,07/01/2014 12:00:00 AM,135,274,242
Northern,Fairfax County,51059,5431,17842,23273,7936,39394,47330,729426,4907231,5636657,08/01/2014 12:00:00 AM,134,275,242
Northern,Fairfax County,51059,5431,18086,23517,7721,40490,48211,746756,5062160,5808916,10/01/2015 12:00:00 AM,137,280,247
Northern,Fairfax County,51059,5434,18133,23567,7698,40751,48449,747279,5087964,5835243,11/01/2015 12:00:00 AM,138,281,248
Northern,Fairfax County,51059,5437,18184,23621,7896,39926,47822,731862,5005881,5737743,06/01/2014 12:00:00 AM,135,275,243
Northern,Fairfax County,51059,5444,18144,23588,7719,40819,48538,742755,5095838,5838593,12/01/2015 12:00:00 AM,136,281,248
Northern,Fairfax County,51059,5462,18340,23802,7932,40195,48127,739120,5059334,5798454,05/01/2014 12:00:00 AM,135,276,244
Northern,Fairfax County,51059,5465,18472,23937,7908,40367,48275,744653,5164226,5908879,04/01/2014 12:00:00 AM,136,280,247
Northern,Fairfax County,51059,5510,18507,24017,7999,40597,48596,741352,5088108,5829460,02/01/2014 12:00:00 AM,135,275,243
Northern,Fairfax County,51059,5561,18945,24506,8105,41398,49503,741990,5163289,5905279,01/01/2014 12:00:00 AM,133,273,241
Northern,Fairfax County,51059,5653,19145,24798,8236,41748,49984,773173,5227794,6000967,12/01/2013 12:00:00 AM,137,273,242
Northern,Fairfax County,51059,5670,19366,25036,8251,42228,50479,779809,5276018,6055827,11/01/2013 12:00:00 AM,138,272,242
Northern,Fairfax County,51059,5780,19684,25464,8535,42675,51210,884111,5628191,6512302,09/01/2013 12:00:00 AM,153,286,256
Northern,Fairfax County,51059,5808,19529,25337,8622,42364,50986,905042,5652582,6557624,10/01/2013 12:00:00 AM,156,289,259
Northern,Fairfax County,51059,5872,19912,25784,8689,43002,51691,902030,5682580,6584610,08/01/2013 12:00:00 AM,154,285,255
Northern,Fairfax County,51059,5972,19902,25874,8945,42818,51763,934762,5632222,6566984,07/01/2013 12:00:00 AM,157,283,254
Northern,Fairfax County,51059,5989,19898,25887,8957,42763,51720,936433,5658130,6594563,06/01/2013 12:00:00 AM,156,284,255
Northern,Fairfax County,51059,6001,19853,25854,8942,42556,51498,942003,5625742,6567745,05/01/2013 12:00:00 AM,157,283,254
Northern,Fairfax County,51059,6022,19673,25695,9068,42003,51071,957871,5578334,6536205,03/01/2013 12:00:00 AM,159,284,254
Northern,Fairfax County,51059,6039,19560,25599,9071,41794,50865,950540,5533991,6484531,02/01/2013 12:00:00 AM,157,283,253
Northern,Fairfax County,51059,6049,19159,25208,9057,41053,50110,964951,5457072,6422023,12/01/2012 12:00:00 AM,160,285,255
Northern,Fairfax County,51059,6051,19826,25877,9058,42433,51491,951612,5633933,6585545,04/01/2013 12:00:00 AM,157,284,254
Northern,Fairfax County,51059,6053,19440,25493,9096,41595,50691,952062,5496411,6448473,01/01/2013 12:00:00 AM,157,283,253
Northern,Fairfax County,51059,6077,19022,25099,9014,40708,49722,958625,5423091,6381716,10/01/2012 12:00:00 AM,158,285,254
Northern,Fairfax County,51059,6084,19169,25253,9109,41043,50152,971161,5462850,6434011,11/01/2012 12:00:00 AM,160,285,255
Northern,Fairfax County,51059,6090,18727,24817,9030,40143,49173,960935,5315898,6276833,09/01/2012 12:00:00 AM,158,284,253
Northern,Fairfax County,51059,6092,18742,24834,9057,40092,49149,959322,5317987,6277309,08/01/2012 12:00:00 AM,157,284,253
Northern,Fairfax County,51059,6112,17168,23280,9124,36837,45961,964281,4819205,5783486,01/01/2012 12:00:00 AM,158,281,248
Northern,Fairfax County,51059,6133,18427,24560,9196,39249,48445,971421,5182056,6153477,06/01/2012 12:00:00 AM,158,281,251
Northern,Fairfax County,51059,6134,17489,23623,9181,37504,46685,972383,4941874,5914257,02/01/2012 12:00:00 AM,159,283,250
Northern,Fairfax County,51059,6149,18475,24624,9189,39537,48726,983186,5280027,6263213,07/01/2012 12:00:00 AM,160,286,254
Northern,Fairfax County,51059,6152,18154,24306,9223,38694,47917,976649,5115973,6092622,05/01/2012 12:00:00 AM,159,282,251
Northern,Fairfax County,51059,6157,17808,23965,9219,38120,47339,976789,5012710,5989499,03/01/2012 12:00:00 AM,159,281,250
Northern,Fairfax County,51059,6180,17938,24118,9266,38335,47601,981865,5047925,6029790,04/01/2012 12:00:00 AM,159,281,250
Northern,Falls Church City,51610,10,65,75,15,146,161,695,19244,19939,01/01/2017 12:00:00 AM,70,296,266
Northern,Falls Church City,51610,15,70,85,17,150,167,1138,19017,20155,03/01/2017 12:00:00 AM,76,272,237
Northern,Falls Church City,51610,16,72,88,21,153,174,1846,20958,22804,02/01/2017 12:00:00 AM,115,291,259
Northern,Falls Church City,51610,17,66,83,20,148,168,1300,18773,20073,04/01/2017 12:00:00 AM,76,284,242
Northern,Falls Church City,51610,18,64,82,21,138,159,1515,18619,20134,05/01/2017 12:00:00 AM,84,291,246
Northern,Falls Church City,51610,19,66,85,21,150,171,1308,19246,20554,06/01/2017 12:00:00 AM,69,292,242
Northern,Falls Church City,51610,20,70,90,22,152,174,1696,19669,21365,08/01/2017 12:00:00 AM,85,281,237
Northern,Falls Church City,51610,21,66,87,23,145,168,1534,18261,19795,07/01/2017 12:00:00 AM,73,277,228
Northern,Falls Church City,51610,22,75,97,25,162,187,1863,20330,22193,09/01/2017 12:00:00 AM,85,271,229
Northern,Falls Church City,51610,25,70,95,28,154,182,2201,21077,23278,10/01/2017 12:00:00 AM,88,301,245
Northern,Falls Church City,51610,27,64,91,33,140,173,2887,18440,21327,11/01/2017 12:00:00 AM,107,288,234
Northern,Falls Church City,51610,28,74,102,36,167,203,2753,21716,24469,01/01/2018 12:00:00 AM,98,293,240
Northern,Falls Church City,51610,29,72,101,32,152,184,1942,18898,20840,06/01/2018 12:00:00 AM,67,262,206
Northern,Falls Church City,51610,29,78,107,32,164,196,1795,20698,22493,04/01/2018 12:00:00 AM,62,265,210
Northern,Falls Church City,51610,30,72,102,35,148,183,2401,18997,21398,08/01/2018 12:00:00 AM,80,264,210
Northern,Falls Church City,51610,30,74,104,33,153,186,2060,19765,21825,05/01/2018 12:00:00 AM,69,267,210
Northern,Falls Church City,51610,30,74,104,34,161,195,2248,20917,23165,03/01/2018 12:00:00 AM,75,283,223
Northern,Falls Church City,51610,30,74,104,35,153,188,2298,20150,22448,09/01/2018 12:00:00 AM,77,272,216
Northern,Falls Church City,51610,31,66,97,46,139,185,4517,18768,23285,12/01/2017 12:00:00 AM,146,284,240
Northern,Falls Church City,51610,31,74,105,39,164,203,2976,20814,23790,02/01/2018 12:00:00 AM,96,281,227
Northern,Falls Church City,51610,32,68,100,36,142,178,2216,17910,20126,12/01/2018 12:00:00 AM,69,263,201
Northern,Falls Church City,51610,32,70,102,37,147,184,2383,18241,20624,07/01/2018 12:00:00 AM,74,261,202
Northern,Falls Church City,51610,32,75,107,37,156,193,2497,20201,22698,10/01/2018 12:00:00 AM,78,269,212
Northern,Falls Church City,51610,33,58,91,37,124,161,2351,15881,18232,02/01/2019 12:00:00 AM,71,274,200
Northern,Falls Church City,51610,33,65,98,37,131,168,2300,16922,19222,01/01/2019 12:00:00 AM,70,260,196
Northern,Falls Church City,51610,33,72,105,38,153,191,2998,19765,22763,11/01/2018 12:00:00 AM,91,275,217
Northern,Falls Church City,51610,34,63,97,39,137,176,2780,17209,19989,04/01/2019 12:00:00 AM,82,273,206
Northern,Falls Church City,51610,35,65,100,40,147,187,2920,18019,20939,05/01/2019 12:00:00 AM,83,277,209
Northern,Falls Church City,51610,36,65,101,41,137,178,3120,18238,21358,03/01/2019 12:00:00 AM,87,281,211
Northern,Falls Church City,51610,37,65,102,46,151,197,3740,18426,22166,07/01/2019 12:00:00 AM,101,283,217
Northern,Falls Church City,51610,37,67,104,47,148,195,3980,19315,23295,06/01/2019 12:00:00 AM,108,288,224
Northern,Falls Church City,51610,38,64,102,46,139,185,3261,18334,21595,10/01/2019 12:00:00 AM,86,286,212
Northern,Falls Church City,51610,38,64,102,47,138,185,3745,16467,20212,08/01/2019 12:00:00 AM,99,257,198
Northern,Falls Church City,51610,38,65,103,46,136,182,3261,16965,20226,11/01/2019 12:00:00 AM,86,261,196
Northern,Falls Church City,51610,38,65,103,52,137,189,4243,17070,21313,09/01/2019 12:00:00 AM,112,263,207
Northern,Falls Church City,51610,41,61,102,50,134,184,4189,17613,21802,12/01/2019 12:00:00 AM,102,289,214
Northern,Falls Church City,51610,42,109,151,53,217,270,11806,44907,56713,02/01/2021 12:00:00 AM,281,412,376
Northern,Falls Church City,51610,42,59,101,51,135,186,3363,17046,20409,02/01/2020 12:00:00 AM,80,289,202
Northern,Falls Church City,51610,43,58,101,46,130,176,3509,15460,18969,01/01/2020 12:00:00 AM,82,267,188
Northern,Falls Church City,51610,44,102,146,60,207,267,11390,37556,48946,11/01/2020 12:00:00 AM,259,368,335
Northern,Falls Church City,51610,44,59,103,54,131,185,10122,21549,31671,03/01/2020 12:00:00 AM,230,365,307
Northern,Falls Church City,51610,44,98,142,56,206,262,10765,38612,49377,10/01/2020 12:00:00 AM,245,394,348
Northern,Falls Church City,51610,45,72,117,62,155,217,10997,26400,37397,04/01/2020 12:00:00 AM,244,367,320
Northern,Falls Church City,51610,45,84,129,62,179,241,10984,31618,42602,06/01/2020 12:00:00 AM,244,376,330
Northern,Falls Church City,51610,45,95,140,63,207,270,11503,36201,47704,09/01/2020 12:00:00 AM,256,381,341
Northern,Falls Church City,51610,45,97,142,63,200,263,11329,35868,47197,08/01/2020 12:00:00 AM,252,370,332
Northern,Falls Church City,51610,46,108,154,65,213,278,12386,39630,52016,12/01/2020 12:00:00 AM,269,367,338
Northern,Falls Church City,51610,46,78,124,64,170,234,11694,29672,41366,05/01/2020 12:00:00 AM,254,380,334
Northern,Falls Church City,51610,46,88,134,64,192,256,11901,33443,45344,07/01/2020 12:00:00 AM,259,380,338
Northern,Falls Church City,51610,47,99,146,67,197,264,14732,43473,58205,01/01/2021 12:00:00 AM,313,439,399
Northern,Falls Church City,51610,49,111,160,61,226,287,13424,50552,63976,03/01/2021 12:00:00 AM,274,455,400
Northern,Falls Church City,51610,51,113,164,63,232,295,14945,52625,67570,04/01/2021 12:00:00 AM,293,466,412
Northern,Falls Church City,51610,52,111,163,64,225,289,14639,52277,66916,05/01/2021 12:00:00 AM,282,471,411
Northern,Falls Church City,51610,52,111,163,64,225,289,14689,52379,67068,06/01/2021 12:00:00 AM,282,472,411
Northern,Falls Church City,51610,7,61,68,12,137,149,1162,16498,17660,08/01/2016 12:00:00 AM,166,270,260
Northern,Falls Church City,51610,7,62,69,7,134,141,299,16749,17048,07/01/2016 12:00:00 AM,43,270,247
Northern,Falls Church City,51610,9,57,66,17,129,146,1175,15976,17151,10/01/2016 12:00:00 AM,131,280,260
Northern,Falls Church City,51610,9,62,71,17,138,155,1144,17616,18760,11/01/2016 12:00:00 AM,127,284,264
Northern,Falls Church City,51610,9,62,71,17,138,155,823,18349,19172,12/01/2016 12:00:00 AM,91,296,270
Northern,Falls Church City,51610,9,63,72,17,140,157,1760,16488,18248,09/01/2016 12:00:00 AM,196,262,253
Northern,Falls Church,51610,1,18,19,1,41,42,29,5609,5638,12/01/2012 12:00:00 AM,29,312,297
Northern,Falls Church,51610,1,23,24,1,45,46,31,6361,6392,02/01/2013 12:00:00 AM,31,277,266
Northern,Falls Church,51610,1,29,30,1,51,52,47,7660,7707,07/01/2013 12:00:00 AM,47,264,257
Northern,Falls Church,51610,2,10,12,2,24,26,114,3509,3623,10/01/2012 12:00:00 AM,57,351,302
Northern,Falls Church,51610,2,13,15,2,33,35,114,4365,4479,11/01/2012 12:00:00 AM,57,336,299
Northern,Falls Church,51610,2,20,22,2,43,45,54,6267,6321,01/01/2013 12:00:00 AM,27,313,287
Northern,Falls Church,51610,2,24,26,2,43,45,56,5818,5874,03/01/2013 12:00:00 AM,28,242,226
Northern,Falls Church,51610,2,26,28,2,44,46,56,6548,6604,06/01/2013 12:00:00 AM,28,252,236
Northern,Falls Church,51610,2,26,28,2,47,49,56,7380,7436,04/01/2013 12:00:00 AM,28,284,266
Northern,Falls Church,51610,2,6,8,2,11,13,99,1264,1363,01/01/2012 12:00:00 AM,50,211,170
Northern,Falls Church,51610,2,7,9,2,14,16,99,1868,1967,03/01/2012 12:00:00 AM,50,267,219
Northern,Falls Church,51610,2,7,9,2,16,18,112,2331,2443,08/01/2012 12:00:00 AM,56,333,271
Northern,Falls Church,51610,2,8,10,2,18,20,109,2213,2322,04/01/2012 12:00:00 AM,55,277,232
Northern,Falls Church,51610,2,9,11,2,22,24,112,2735,2847,09/01/2012 12:00:00 AM,56,304,259
Northern,Falls Church,51610,3,25,28,3,41,44,56,6337,6393,05/01/2013 12:00:00 AM,19,253,228
Northern,Falls Church,51610,3,29,32,3,58,61,173,8800,8973,09/01/2013 12:00:00 AM,58,303,280
Northern,Falls Church,51610,3,30,33,3,57,60,173,8272,8445,08/01/2013 12:00:00 AM,58,276,256
Northern,Falls Church,51610,3,33,36,4,67,71,399,8529,8928,08/01/2014 12:00:00 AM,133,258,248
Northern,Falls Church,51610,3,4,7,5,8,13,550,902,1452,02/01/2012 12:00:00 AM,183,226,207
Northern,Falls Church,51610,3,8,11,3,23,26,112,3335,3447,05/01/2012 12:00:00 AM,37,417,313
Northern,Falls Church,51610,3,8,11,3,23,26,126,3362,3488,06/01/2012 12:00:00 AM,42,420,317
Northern,Falls Church,51610,3,9,12,3,24,27,126,4225,4351,07/01/2012 12:00:00 AM,42,469,363
Northern,Falls Church,51610,4,29,33,5,70,75,490,9459,9949,03/01/2015 12:00:00 AM,123,326,301
Northern,Falls Church,51610,4,31,35,5,72,77,490,9313,9803,04/01/2015 12:00:00 AM,123,300,280
Northern,Falls Church,51610,4,32,36,5,77,82,490,9517,10007,05/01/2015 12:00:00 AM,123,297,278
Northern,Falls Church,51610,4,33,37,5,59,64,417,7267,7684,07/01/2014 12:00:00 AM,104,220,208
Northern,Falls Church,51610,4,34,38,5,67,72,408,9205,9613,04/01/2014 12:00:00 AM,102,271,253
Northern,Falls Church,51610,5,26,31,8,52,60,867,7253,8120,05/01/2014 12:00:00 AM,173,279,262
Northern,Falls Church,51610,5,30,35,7,69,76,839,9842,10681,01/01/2015 12:00:00 AM,168,328,305
Northern,Falls Church,51610,5,31,36,10,55,65,1063,7098,8161,06/01/2014 12:00:00 AM,213,229,227
Northern,Falls Church,51610,5,32,37,6,62,68,515,8039,8554,11/01/2013 12:00:00 AM,103,251,231
Northern,Falls Church,51610,5,32,37,7,62,69,660,8121,8781,03/01/2014 12:00:00 AM,132,254,237
Northern,Falls Church,51610,5,32,37,7,67,74,764,8703,9467,09/01/2014 12:00:00 AM,153,272,256
Northern,Falls Church,51610,5,32,37,7,69,76,820,9457,10277,02/01/2015 12:00:00 AM,164,296,278
Northern,Falls Church,51610,5,35,40,6,68,74,515,9973,10488,12/01/2013 12:00:00 AM,103,285,262
Northern,Falls Church,51610,5,36,41,7,79,86,852,11241,12093,12/01/2014 12:00:00 AM,170,312,295
Northern,Falls Church,51610,5,37,42,6,78,84,501,10278,10779,01/01/2014 12:00:00 AM,100,278,257
Northern,Falls Church,51610,6,29,35,9,57,66,1092,8435,9527,10/01/2013 12:00:00 AM,182,291,272
Northern,Falls Church,51610,6,35,41,8,77,85,1036,10586,11622,11/01/2014 12:00:00 AM,173,302,283
Northern,Falls Church,51610,6,36,42,7,88,95,512,9795,10307,06/01/2015 12:00:00 AM,85,272,245
Northern,Falls Church,51610,6,39,45,9,81,90,1007,10900,11907,02/01/2014 12:00:00 AM,168,279,265
Northern,Falls Church,51610,7,35,42,11,78,89,1542,10475,12017,10/01/2014 12:00:00 AM,220,299,286
Northern,Falls Church,51610,7,47,54,10,117,127,716,13296,14012,07/01/2015 12:00:00 AM,102,283,259
Northern,Falls Church,51610,7,51,58,8,121,129,817,13494,14311,10/01/2015 12:00:00 AM,117,265,247
Northern,Falls Church,51610,7,58,65,7,128,135,542,15508,16050,05/01/2016 12:00:00 AM,77,267,247
Northern,Falls Church,51610,7,61,68,7,131,138,542,16009,16551,03/01/2016 12:00:00 AM,77,262,243
Northern,Falls Church,51610,7,62,69,7,134,141,542,16951,17493,04/01/2016 12:00:00 AM,77,273,254
Northern,Falls Church,51610,8,51,59,11,122,133,774,13917,14691,08/01/2015 12:00:00 AM,97,273,249
Northern,Falls Church,51610,8,51,59,9,121,130,878,14204,15082,11/01/2015 12:00:00 AM,110,279,256
Northern,Falls Church,51610,8,54,62,11,122,133,767,13782,14549,09/01/2015 12:00:00 AM,96,255,235
Northern,Falls Church,51610,8,58,66,9,126,135,558,15087,15645,02/01/2016 12:00:00 AM,70,260,237
Northern,Falls Church,51610,8,61,69,8,137,145,486,16305,16791,06/01/2016 12:00:00 AM,61,267,243
Northern,Falls Church,51610,9,57,66,10,125,135,633,14388,15021,01/01/2016 12:00:00 AM,70,252,228
Northern,Falls Church,51610,9,59,68,10,137,147,628,15853,16481,12/01/2015 12:00:00 AM,70,269,242
Northern,Fauquier County,51061,224,1046,1270,280,2301,2581,25286,274901,300187,10/01/2019 12:00:00 AM,113,263,236
Northern,Fauquier County,51061,226,1209,1435,314,2839,3153,30893,340584,371477,09/01/2016 12:00:00 AM,137,282,259
Northern,Fauquier County,51061,227,1276,1503,317,3041,3358,30663,361010,391673,02/01/2016 12:00:00 AM,135,283,261
Northern,Fauquier County,51061,229,1053,1282,289,2330,2619,26067,274862,300929,09/01/2019 12:00:00 AM,114,261,235
Northern,Fauquier County,51061,229,1205,1434,311,2827,3138,30684,337579,368263,10/01/2016 12:00:00 AM,134,280,257
Northern,Fauquier County,51061,229,1267,1496,315,3007,3322,29970,355597,385567,03/01/2016 12:00:00 AM,131,281,258
Northern,Fauquier County,51061,229,1279,1508,321,3065,3386,31548,363272,394820,01/01/2016 12:00:00 AM,138,284,262
Northern,Fauquier County,51061,230,1191,1421,314,2789,3103,32022,332416,364438,12/01/2016 12:00:00 AM,139,279,256
Northern,Fauquier County,51061,231,1010,1241,287,2220,2507,26219,263062,289281,11/01/2019 12:00:00 AM,114,260,233
Northern,Fauquier County,51061,231,1213,1444,335,2833,3168,33320,336879,370199,07/01/2016 12:00:00 AM,144,278,256
Northern,Fauquier County,51061,232,1261,1493,326,3021,3347,33104,357207,390311,04/01/2016 12:00:00 AM,143,283,261
Northern,Fauquier County,51061,232,990,1222,293,2137,2430,27142,252592,279734,02/01/2020 12:00:00 AM,117,255,229
Northern,Fauquier County,51061,233,1111,1344,319,2573,2892,31793,308802,340595,10/01/2017 12:00:00 AM,136,278,253
Northern,Fauquier County,51061,233,1132,1365,314,2628,2942,32442,318234,350676,04/01/2017 12:00:00 AM,139,281,257
Northern,Fauquier County,51061,233,1202,1435,324,2787,3111,33395,336307,369702,11/01/2016 12:00:00 AM,143,280,258
Northern,Fauquier County,51061,233,1209,1442,332,2811,3143,32601,330972,363573,08/01/2016 12:00:00 AM,140,274,252
Northern,Fauquier County,51061,233,1244,1477,335,2984,3319,34359,355465,389824,05/01/2016 12:00:00 AM,147,286,264
Northern,Fauquier County,51061,234,1020,1254,296,2205,2501,28112,258892,287004,12/01/2019 12:00:00 AM,120,254,229
Northern,Fauquier County,51061,234,1233,1467,341,2902,3243,35112,345445,380557,06/01/2016 12:00:00 AM,150,280,259
Northern,Fauquier County,51061,234,1514,1748,341,3453,3794,36067,415226,451293,08/01/2014 12:00:00 AM,154,274,258
Northern,Fauquier County,51061,235,1054,1289,292,2332,2624,25559,276283,301842,08/01/2019 12:00:00 AM,109,262,234
Northern,Fauquier County,51061,235,1281,1516,331,3062,3393,33398,363938,397336,12/01/2015 12:00:00 AM,142,284,262
Northern,Fauquier County,51061,236,1010,1246,298,2231,2529,27706,262702,290408,01/01/2020 12:00:00 AM,117,260,233
Northern,Fauquier County,51061,236,1123,1359,325,2580,2905,33106,317237,350343,05/01/2017 12:00:00 AM,140,282,258
Northern,Fauquier County,51061,236,1148,1384,320,2693,3013,33898,325634,359532,03/01/2017 12:00:00 AM,144,284,260
Northern,Fauquier County,51061,237,1052,1289,297,2385,2682,26513,281873,308386,07/01/2019 12:00:00 AM,112,268,239
Northern,Fauquier County,51061,237,1057,1294,303,2400,2703,27682,288585,316267,05/01/2019 12:00:00 AM,117,273,244
Northern,Fauquier County,51061,237,1197,1434,324,2774,3098,33345,331119,364464,01/01/2017 12:00:00 AM,141,277,254
Northern,Fauquier County,51061,239,1051,1290,298,2381,2679,26593,280027,306620,06/01/2019 12:00:00 AM,111,266,238
Northern,Fauquier County,51061,239,1063,1302,309,2404,2713,28321,293653,321974,04/01/2019 12:00:00 AM,118,276,247
Northern,Fauquier County,51061,239,1201,1440,325,2777,3102,32920,329787,362707,02/01/2017 12:00:00 AM,138,275,252
Northern,Fauquier County,51061,240,1412,1652,343,3362,3705,35599,400930,436529,01/01/2015 12:00:00 AM,148,284,264
Northern,Fauquier County,51061,241,1122,1363,330,2588,2918,32610,315692,348302,08/01/2017 12:00:00 AM,135,281,256
Northern,Fauquier County,51061,242,1021,1263,310,2211,2521,56663,380794,437457,03/01/2020 12:00:00 AM,234,373,346
Northern,Fauquier County,51061,242,1107,1349,331,2572,2903,32721,313497,346218,09/01/2017 12:00:00 AM,135,283,257
Northern,Fauquier County,51061,243,1115,1358,339,2545,2884,36118,302158,338276,11/01/2017 12:00:00 AM,149,271,249
Northern,Fauquier County,51061,243,1120,1363,331,2597,2928,33991,315886,349877,07/01/2017 12:00:00 AM,140,282,257
Northern,Fauquier County,51061,243,1122,1365,337,2537,2874,34085,304357,338442,12/01/2017 12:00:00 AM,140,271,248
Northern,Fauquier County,51061,243,1279,1522,350,3057,3407,35484,366400,401884,11/01/2015 12:00:00 AM,146,286,264
Northern,Fauquier County,51061,243,1568,1811,365,3568,3933,39412,426551,465963,06/01/2014 12:00:00 AM,162,272,257
Northern,Fauquier County,51061,244,1278,1522,347,3110,3457,36236,374450,410686,08/01/2015 12:00:00 AM,149,293,270
Northern,Fauquier County,51061,244,1492,1736,357,3436,3793,37942,412813,450755,09/01/2014 12:00:00 AM,156,277,260
Northern,Fauquier County,51061,244,1532,1776,364,3494,3858,38329,417382,455711,07/01/2014 12:00:00 AM,157,272,257
Northern,Fauquier County,51061,245,1004,1249,323,2272,2595,30033,269223,299256,02/01/2019 12:00:00 AM,123,268,240
Northern,Fauquier County,51061,245,1428,1673,359,3380,3739,38995,414083,453078,11/01/2014 12:00:00 AM,159,290,271
Northern,Fauquier County,51061,245,1439,1684,361,3407,3768,38598,418890,457488,10/01/2014 12:00:00 AM,158,291,272
Northern,Fauquier County,51061,246,1121,1367,338,2591,2929,33890,318100,351990,06/01/2017 12:00:00 AM,138,284,257
Northern,Fauquier County,51061,246,1713,1959,378,3838,4216,43731,502699,546430,08/01/2013 12:00:00 AM,178,293,279
Northern,Fauquier County,51061,247,1066,1313,327,2429,2756,29831,293379,323210,03/01/2019 12:00:00 AM,121,275,246
Northern,Fauquier County,51061,247,1112,1359,330,2514,2844,29998,300460,330458,06/01/2018 12:00:00 AM,121,270,243
Northern,Fauquier County,51061,247,1122,1369,328,2534,2862,30309,307516,337825,04/01/2018 12:00:00 AM,123,274,247
Northern,Fauquier County,51061,247,1302,1549,355,3153,3508,36784,380207,416991,07/01/2015 12:00:00 AM,149,292,269
Northern,Fauquier County,51061,247,1411,1658,360,3364,3724,38093,410722,448815,12/01/2014 12:00:00 AM,154,291,271
Northern,Fauquier County,51061,247,1703,1950,383,3807,4190,43596,501556,545152,09/01/2013 12:00:00 AM,177,295,280
Northern,Fauquier County,51061,248,1118,1366,330,2525,2855,30385,301273,331658,05/01/2018 12:00:00 AM,123,269,243
Northern,Fauquier County,51061,248,1142,1390,344,2583,2927,32409,308211,340620,01/01/2018 12:00:00 AM,131,270,245
Northern,Fauquier County,51061,248,1153,1401,309,2531,2840,71196,533692,604888,02/01/2021 12:00:00 AM,287,463,432
Northern,Fauquier County,51061,248,1158,1406,311,2493,2804,57612,436348,493960,06/01/2020 12:00:00 AM,232,377,351
Northern,Fauquier County,51061,248,1161,1409,313,2580,2893,61401,481027,542428,11/01/2020 12:00:00 AM,248,414,385
Northern,Fauquier County,51061,248,1620,1868,375,3657,4032,39860,442825,482685,04/01/2014 12:00:00 AM,161,273,258
Northern,Fauquier County,51061,249,1167,1416,313,2558,2871,69371,534622,603993,03/01/2021 12:00:00 AM,279,458,427
Northern,Fauquier County,51061,250,1292,1542,368,3113,3481,39169,373454,412623,09/01/2015 12:00:00 AM,157,289,268
Northern,Fauquier County,51061,250,1337,1587,362,3202,3564,38044,388170,426214,06/01/2015 12:00:00 AM,152,290,269
Northern,Fauquier County,51061,250,1396,1646,381,3307,3688,40808,402704,443512,02/01/2015 12:00:00 AM,163,288,269
Northern,Fauquier County,51061,250,1636,1886,382,3667,4049,41660,447910,489570,03/01/2014 12:00:00 AM,167,274,260
Northern,Fauquier County,51061,251,1070,1321,329,2392,2721,32183,301304,333487,01/01/2019 12:00:00 AM,128,282,252
Northern,Fauquier County,51061,251,1160,1411,324,2491,2815,60192,428273,488465,05/01/2020 12:00:00 AM,240,369,346
Northern,Fauquier County,51061,251,1581,1832,387,3575,3962,41816,430268,472084,05/01/2014 12:00:00 AM,167,272,258
Northern,Fauquier County,51061,251,1765,2016,401,4008,4409,47573,524786,572359,05/01/2012 12:00:00 AM,190,297,284
Northern,Fauquier County,51061,252,1131,1383,324,2458,2782,60488,428307,488795,04/01/2020 12:00:00 AM,240,379,353
Northern,Fauquier County,51061,252,1150,1402,343,2594,2937,31913,310302,342215,03/01/2018 12:00:00 AM,127,270,244
Northern,Fauquier County,51061,252,1156,1408,317,2566,2883,62161,458048,520209,12/01/2020 12:00:00 AM,247,396,369
Northern,Fauquier County,51061,252,1705,1957,384,3813,4197,44389,503111,547500,07/01/2013 12:00:00 AM,176,295,280
Northern,Fauquier County,51061,252,1738,1990,385,3943,4328,47448,517088,564536,11/01/2012 12:00:00 AM,188,298,284
Northern,Fauquier County,51061,252,1785,2037,399,4047,4446,46956,536648,583604,04/01/2012 12:00:00 AM,186,301,287
Northern,Fauquier County,51061,253,1111,1364,346,2520,2866,32101,304204,336305,07/01/2018 12:00:00 AM,127,274,247
Northern,Fauquier County,51061,253,1178,1431,321,2596,2917,62310,466416,528726,10/01/2020 12:00:00 AM,246,396,369
Northern,Fauquier County,51061,253,1679,1932,392,3750,4142,41754,459189,500943,11/01/2013 12:00:00 AM,165,273,259
Northern,Fauquier County,51061,253,1730,1983,368,3926,4294,39344,515182,554526,04/01/2013 12:00:00 AM,156,298,280
Northern,Fauquier County,51061,253,1797,2050,406,4045,4451,47714,538838,586552,03/01/2012 12:00:00 AM,189,300,286
Northern,Fauquier County,51061,254,1126,1380,347,2539,2886,32268,300733,333001,02/01/2018 12:00:00 AM,127,267,241
Northern,Fauquier County,51061,254,1153,1407,317,2473,2790,75069,557681,632750,05/01/2021 12:00:00 AM,296,484,450
Northern,Fauquier County,51061,254,1157,1411,315,2485,2800,74442,571997,646439,06/01/2021 12:00:00 AM,293,494,458
Northern,Fauquier County,51061,254,1164,1418,319,2498,2817,76219,567787,644006,04/01/2021 12:00:00 AM,300,488,454
Northern,Fauquier County,51061,254,1180,1434,322,2583,2905,60061,448255,508316,09/01/2020 12:00:00 AM,236,380,354
Northern,Fauquier County,51061,254,1721,1975,376,3927,4303,40775,518091,558866,03/01/2013 12:00:00 AM,161,301,283
Northern,Fauquier County,51061,255,1072,1327,344,2405,2749,34503,288726,323229,12/01/2018 12:00:00 AM,135,269,244
Northern,Fauquier County,51061,255,1083,1338,343,2406,2749,33090,288722,321812,10/01/2018 12:00:00 AM,130,267,241
Northern,Fauquier County,51061,255,1188,1443,326,2592,2918,60148,441330,501478,08/01/2020 12:00:00 AM,236,371,348
Northern,Fauquier County,51061,255,1289,1544,363,3081,3444,37840,368966,406806,10/01/2015 12:00:00 AM,148,286,263
Northern,Fauquier County,51061,255,1387,1642,402,3271,3673,44251,392792,437043,03/01/2015 12:00:00 AM,174,283,266
Northern,Fauquier County,51061,255,1639,1894,390,3675,4065,41176,448686,489862,02/01/2014 12:00:00 AM,161,274,259
Northern,Fauquier County,51061,255,1657,1912,388,3718,4106,40259,447832,488091,01/01/2014 12:00:00 AM,158,270,255
Northern,Fauquier County,51061,255,1668,1923,390,3728,4118,39962,452423,492385,12/01/2013 12:00:00 AM,157,271,256
Northern,Fauquier County,51061,255,1716,1971,385,3839,4224,45388,505351,550739,06/01/2013 12:00:00 AM,178,294,279
Northern,Fauquier County,51061,256,1181,1437,329,2565,2894,61066,442556,503622,07/01/2020 12:00:00 AM,239,375,350
Northern,Fauquier County,51061,256,1734,1990,370,3917,4287,41656,514643,556299,05/01/2013 12:00:00 AM,163,297,280
Northern,Fauquier County,51061,257,1695,1952,408,3773,4181,49092,494537,543629,10/01/2013 12:00:00 AM,191,292,278
Northern,Fauquier County,51061,257,1713,1970,393,3893,4286,46139,511976,558115,12/01/2012 12:00:00 AM,180,299,283
Northern,Fauquier County,51061,257,1720,1977,386,3920,4306,43168,517541,560709,02/01/2013 12:00:00 AM,168,301,284
Northern,Fauquier County,51061,258,1082,1340,364,2423,2787,34060,291600,325660,08/01/2018 12:00:00 AM,132,270,243
Northern,Fauquier County,51061,258,1758,2016,401,3992,4393,49752,529007,578759,10/01/2012 12:00:00 AM,193,301,287
Northern,Fauquier County,51061,259,1072,1331,351,2393,2744,33356,284092,317448,11/01/2018 12:00:00 AM,129,265,239
Northern,Fauquier County,51061,259,1809,2068,426,4073,4499,50996,546228,597224,02/01/2012 12:00:00 AM,197,302,289
Northern,Fauquier County,51061,260,1083,1343,362,2443,2805,34610,290173,324783,09/01/2018 12:00:00 AM,133,268,242
Northern,Fauquier County,51061,260,1737,1997,400,3959,4359,44976,514578,559554,01/01/2013 12:00:00 AM,173,296,280
Northern,Fauquier County,51061,261,1132,1393,336,2504,2840,74138,525986,600124,01/01/2021 12:00:00 AM,284,465,431
Northern,Fauquier County,51061,261,1742,2003,423,3981,4404,51268,518658,569926,06/01/2012 12:00:00 AM,196,298,285
Northern,Fauquier County,51061,261,1787,2048,414,4026,4440,50303,536691,586994,01/01/2012 12:00:00 AM,193,300,287
Northern,Fauquier County,51061,262,1357,1619,396,3217,3613,43008,390478,433486,05/01/2015 12:00:00 AM,164,288,268
Northern,Fauquier County,51061,264,1369,1633,402,3239,3641,42905,395957,438862,04/01/2015 12:00:00 AM,163,289,269
Northern,Fauquier County,51061,266,1724,1990,427,3955,4382,51818,514617,566435,07/01/2012 12:00:00 AM,195,299,285
Northern,Fauquier County,51061,268,1730,1998,430,3942,4372,53958,516219,570177,09/01/2012 12:00:00 AM,201,298,285
Northern,Fauquier County,51061,274,1735,2009,450,3958,4408,56300,516127,572427,08/01/2012 12:00:00 AM,205,297,285
Northern,Frederick County,51069,295,2353,2648,400,5782,6182,36831,683391,720222,08/01/2014 12:00:00 AM,125,290,272
Northern,Frederick County,51069,295,2434,2729,405,5915,6320,37704,705184,742888,06/01/2014 12:00:00 AM,128,290,272
Northern,Frederick County,51069,298,2402,2700,416,5877,6293,39988,695833,735821,07/01/2014 12:00:00 AM,134,290,273
Northern,Frederick County,51069,299,2459,2758,425,5922,6347,41195,702379,743574,05/01/2014 12:00:00 AM,138,286,270
Northern,Frederick County,51069,305,2355,2660,417,5800,6217,39677,679246,718923,09/01/2014 12:00:00 AM,130,288,270
Northern,Frederick County,51069,306,2360,2666,415,5823,6238,42496,700565,743061,10/01/2014 12:00:00 AM,139,297,279
Northern,Frederick County,51069,311,2551,2862,447,6118,6565,43942,723751,767693,03/01/2014 12:00:00 AM,141,284,268
Northern,Frederick County,51069,312,2517,2829,449,6038,6487,43789,720072,763861,04/01/2014 12:00:00 AM,140,286,270
Northern,Frederick County,51069,313,2108,2421,406,5189,5595,41640,618469,660109,10/01/2015 12:00:00 AM,133,293,273
Northern,Frederick County,51069,313,2333,2646,420,5765,6185,41811,694075,735886,11/01/2014 12:00:00 AM,134,298,278
Northern,Frederick County,51069,314,1690,2004,419,3921,4340,39047,470937,509984,02/01/2020 12:00:00 AM,124,279,254
Northern,Frederick County,51069,315,2093,2408,417,5091,5508,42106,604534,646640,12/01/2015 12:00:00 AM,134,289,269
Northern,Frederick County,51069,316,1977,2293,404,4880,5284,37939,579842,617781,07/01/2016 12:00:00 AM,120,293,269
Northern,Frederick County,51069,316,2340,2656,419,5754,6173,41230,694021,735251,12/01/2014 12:00:00 AM,130,297,277
Northern,Frederick County,51069,317,2123,2440,412,5193,5605,41405,616494,657899,11/01/2015 12:00:00 AM,131,290,270
Northern,Frederick County,51069,317,2604,2921,492,6252,6744,48621,739807,788428,11/01/2013 12:00:00 AM,153,284,270
Northern,Frederick County,51069,318,1877,2195,405,4614,5019,40364,542905,583269,01/01/2017 12:00:00 AM,127,289,266
Northern,Frederick County,51069,319,1672,1991,424,3907,4331,39304,462598,501902,01/01/2020 12:00:00 AM,123,277,252
Northern,Frederick County,51069,319,1687,2006,421,3926,4347,41033,468570,509603,12/01/2019 12:00:00 AM,129,278,254
Northern,Frederick County,51069,320,1703,2023,407,4003,4410,38450,487095,525545,04/01/2019 12:00:00 AM,120,286,260
Northern,Frederick County,51069,320,2043,2363,422,4995,5417,42716,587937,630653,01/01/2016 12:00:00 AM,133,288,267
Northern,Frederick County,51069,320,2062,2382,423,5065,5488,42833,602908,645741,02/01/2016 12:00:00 AM,134,292,271
Northern,Frederick County,51069,321,2578,2899,488,6151,6639,44713,720294,765007,01/01/2014 12:00:00 AM,139,279,264
Northern,Frederick County,51069,322,1658,1980,426,3908,4334,40301,463891,504192,11/01/2019 12:00:00 AM,125,280,255
Northern,Frederick County,51069,322,1707,2029,413,4039,4452,37804,492968,530772,03/01/2019 12:00:00 AM,117,289,262
Northern,Frederick County,51069,322,1722,2044,415,4060,4475,40339,495768,536107,05/01/2019 12:00:00 AM,125,288,262
Northern,Frederick County,51069,322,2010,2332,422,4942,5364,41930,580197,622127,06/01/2016 12:00:00 AM,130,289,267
Northern,Frederick County,51069,323,1859,2182,413,4517,4930,40661,534492,575153,12/01/2016 12:00:00 AM,126,288,264
Northern,Frederick County,51069,323,1878,2201,424,4561,4985,42388,543371,585759,11/01/2016 12:00:00 AM,131,289,266
Northern,Frederick County,51069,323,1920,2243,422,4644,5066,42051,551175,593226,10/01/2016 12:00:00 AM,130,287,264
Northern,Frederick County,51069,323,2065,2388,428,5087,5515,43871,603904,647775,03/01/2016 12:00:00 AM,136,292,271
Northern,Frederick County,51069,323,2285,2608,429,5609,6038,42632,666766,709398,01/01/2015 12:00:00 AM,132,292,272
Northern,Frederick County,51069,324,1737,2061,419,4089,4508,40223,497068.92,537291.92,06/01/2019 12:00:00 AM,124,286,261
Northern,Frederick County,51069,324,1947,2271,419,4762,5181,40339,566531,606870,08/01/2016 12:00:00 AM,125,291,267
Northern,Frederick County,51069,324,1998,2322,427,4914,5341,43170,581567,624737,05/01/2016 12:00:00 AM,133,291,269
Northern,Frederick County,51069,324,2059,2383,432,5066,5498,43415,597475,640890,04/01/2016 12:00:00 AM,134,290,269
Northern,Frederick County,51069,324,2091,2415,417,5196,5613,43802,613766,657568,09/01/2015 12:00:00 AM,135,294,272
Northern,Frederick County,51069,324,2567,2891,486,6158,6644,45272,726817,772089,02/01/2014 12:00:00 AM,140,283,267
Northern,Frederick County,51069,325,1861,2186,410,4567,4977,42841,542958,585799,03/01/2017 12:00:00 AM,132,292,268
Northern,Frederick County,51069,325,1923,2248,425,4654,5079,41789,549336,591125,09/01/2016 12:00:00 AM,129,286,263
Northern,Frederick County,51069,326,2182,2508,436,5403,5839,45165,644462,689627,06/01/2015 12:00:00 AM,139,295,275
Northern,Frederick County,51069,327,1701,2028,458,3949,4407,84428,669222,753650,03/01/2020 12:00:00 AM,258,393,372
Northern,Frederick County,51069,327,2263,2590,426,5611,6037,43836,671166,715002,03/01/2015 12:00:00 AM,134,297,276
Northern,Frederick County,51069,327,2577,2904,514,6159,6673,49183,727785,776968,12/01/2013 12:00:00 AM,150,282,268
Northern,Frederick County,51069,328,2131,2459,425,5278,5703,44188,623843,668031,08/01/2015 12:00:00 AM,135,293,272
Northern,Frederick County,51069,328,2146,2474,435,5319,5754,44979,631776,676755,07/01/2015 12:00:00 AM,137,294,274
Northern,Frederick County,51069,329,1693,2022,429,3999,4428,41592,484845,526437,07/01/2019 12:00:00 AM,126,286,260
Northern,Frederick County,51069,329,1973,2302,404,4625,5029,92884,976440,1069324,02/01/2021 12:00:00 AM,282,495,465
Northern,Frederick County,51069,330,1685,2015,430,3996,4426,39628,479372,519000,10/01/2019 12:00:00 AM,120,284,258
Northern,Frederick County,51069,330,1826,2156,418,4482,4900,41730,534401,576131,05/01/2017 12:00:00 AM,126,293,267
Northern,Frederick County,51069,330,1878,2208,424,4592,5016,42082,535656,577738,02/01/2017 12:00:00 AM,128,285,262
Northern,Frederick County,51069,330,2240,2570,447,5517,5964,45121,664393,709514,02/01/2015 12:00:00 AM,137,297,276
Northern,Frederick County,51069,331,1841,2172,417,4510,4927,41760,537908,579668,04/01/2017 12:00:00 AM,126,292,267
Northern,Frederick County,51069,332,1666,1998,428,3938,4366,40164,467313,507477,08/01/2019 12:00:00 AM,121,281,254
Northern,Frederick County,51069,332,1828,2160,425,4496,4921,43177,540313,583490,07/01/2017 12:00:00 AM,130,296,270
Northern,Frederick County,51069,332,1840,2172,422,4481,4903,42871,534680,577551,06/01/2017 12:00:00 AM,129,291,266
Northern,Frederick County,51069,332,2221,2553,445,5542,5987,46294,661707,708001,05/01/2015 12:00:00 AM,139,298,277
Northern,Frederick County,51069,332,2245,2577,440,5551,5991,46562,661115,707677,04/01/2015 12:00:00 AM,140,294,275
Northern,Frederick County,51069,332,2719,3051,553,6542,7095,65435,842062,907497,05/01/2013 12:00:00 AM,197,310,297
Northern,Frederick County,51069,334,1617,1951,426,3838,4264,39313,465117,504430,02/01/2019 12:00:00 AM,118,288,259
Northern,Frederick County,51069,336,2649,2985,569,6367,6936,68155,820843,888998,07/01/2013 12:00:00 AM,203,310,298
Northern,Frederick County,51069,337,1686,2023,445,3982,4427,41845,475169,517014,09/01/2019 12:00:00 AM,124,282,256
Northern,Frederick County,51069,337,1829,2166,436,4492,4928,45778,545821,591599,08/01/2017 12:00:00 AM,136,298,273
Northern,Frederick County,51069,337,1970,2307,440,4578,5018,98030,948522,1046552,01/01/2021 12:00:00 AM,291,481,454
Northern,Frederick County,51069,337,2630,2967,545,6294,6839,61825,798780,860605,10/01/2013 12:00:00 AM,183,304,290
Northern,Frederick County,51069,340,1672,2012,431,4062,4493,41685,494310,535995,09/01/2018 12:00:00 AM,123,296,266
Northern,Frederick County,51069,340,1967,2307,441,4575,5016,84866,832682,917548,12/01/2020 12:00:00 AM,250,423,398
Northern,Frederick County,51069,340,2655,2995,563,6386,6949,66095,818764,884859,08/01/2013 12:00:00 AM,194,308,295
Northern,Frederick County,51069,341,1767,2108,418,4314,4732,41100,522961,564061,03/01/2018 12:00:00 AM,121,296,268
Northern,Frederick County,51069,341,1795,2136,423,4442,4865,44460,531416,575876,12/01/2017 12:00:00 AM,130,296,270
Northern,Frederick County,51069,341,1873,2214,481,4355,4836,88314,766349,854663,04/01/2020 12:00:00 AM,259,409,386
Northern,Frederick County,51069,341,1974,2315,426,4587,5013,94620,950653,1045273,03/01/2021 12:00:00 AM,277,482,452
Northern,Frederick County,51069,342,1809,2151,424,4471,4895,44034,533516,577550,11/01/2017 12:00:00 AM,129,295,269
Northern,Frederick County,51069,342,1830,2172,439,4476,4915,45236,549897,595133,09/01/2017 12:00:00 AM,132,300,274
Northern,Frederick County,51069,342,1968,2310,464,4577,5041,85443,794124,879567,09/01/2020 12:00:00 AM,250,404,381
Northern,Frederick County,51069,342,2679,3021,570,6457,7027,68596,830683,899279,06/01/2013 12:00:00 AM,201,310,298
Northern,Frederick County,51069,343,1667,2010,437,3990,4427,43097,496962,540059,01/01/2019 12:00:00 AM,126,298,269
Northern,Frederick County,51069,343,1677,2020,441,4033,4474,43776,482533.17,526309.17,11/01/2018 12:00:00 AM,128,288,261
Northern,Frederick County,51069,343,1727,2070,427,4211,4638,41056,513533,554589,07/01/2018 12:00:00 AM,120,297,268
Northern,Frederick County,51069,343,1765,2108,425,4300,4725,41582,525820,567402,04/01/2018 12:00:00 AM,121,298,269
Northern,Frederick County,51069,343,1766,2109,423,4314,4737,41642,521998,563640,02/01/2018 12:00:00 AM,121,296,267
Northern,Frederick County,51069,343,1965,2308,467,4572,5039,84741,784296,869037,08/01/2020 12:00:00 AM,247,399,377
Northern,Frederick County,51069,344,1816,2160,433,4457,4890,43804,532399,576203,10/01/2017 12:00:00 AM,127,293,267
Northern,Frederick County,51069,344,1957,2301,435,4528,4963,103167,1025415,1128582,04/01/2021 12:00:00 AM,300,524,490
Northern,Frederick County,51069,344,1958,2302,459,4545,5004,89741,834403,924144,11/01/2020 12:00:00 AM,261,426,401
Northern,Frederick County,51069,344,2638,2982,560,6337,6897,64186,814454,878640,09/01/2013 12:00:00 AM,187,309,295
Northern,Frederick County,51069,345,1688,2033,443,4028,4471,44402,486994,531396,12/01/2018 12:00:00 AM,129,289,261
Northern,Frederick County,51069,345,1925,2270,493,4463,4956,90059,767963,858022,05/01/2020 12:00:00 AM,261,399,378
Northern,Frederick County,51069,345,1937,2282,489,4490,4979,89362,769425,858787,06/01/2020 12:00:00 AM,259,397,376
Northern,Frederick County,51069,345,1953,2298,446,4490,4936,105047,1015310,1120357,05/01/2021 12:00:00 AM,304,520,488
Northern,Frederick County,51069,345,1954,2299,471,4569,5040,91793,828317,920110,10/01/2020 12:00:00 AM,266,424,400
Northern,Frederick County,51069,347,1692,2039,439,4083,4522,42943,494767,537710,10/01/2018 12:00:00 AM,124,292,264
Northern,Frederick County,51069,347,1787,2134,421,4370,4791,41335,527402,568737,01/01/2018 12:00:00 AM,119,295,267
Northern,Frederick County,51069,348,1704,2052,444,4130,4574,43595,501265,544860,08/01/2018 12:00:00 AM,125,294,266
Northern,Frederick County,51069,348,1986,2334,488,4637,5125,90581,797129,887710,07/01/2020 12:00:00 AM,260,401,380
Northern,Frederick County,51069,349,1962,2311,446,4512,4958,104573,1021719,1126292,06/01/2021 12:00:00 AM,300,521,487
Northern,Frederick County,51069,349,2731,3080,592,6506,7098,69411,838163,907574,04/01/2013 12:00:00 AM,199,307,295
Northern,Frederick County,51069,353,2771,3124,614,6612,7226,73320,852005,925325,12/01/2012 12:00:00 AM,208,307,296
Northern,Frederick County,51069,354,2756,3110,610,6534,7144,72893,844817,917710,03/01/2013 12:00:00 AM,206,307,295
Northern,Frederick County,51069,354,2811,3165,605,6707,7312,73673,863988,937661,11/01/2012 12:00:00 AM,208,307,296
Northern,Frederick County,51069,355,1723,2078,453,4166,4619,44210,509296,553506,06/01/2018 12:00:00 AM,125,296,266
Northern,Frederick County,51069,356,1748,2104,459,4264,4723,45262,520366,565628,05/01/2018 12:00:00 AM,127,298,269
Northern,Frederick County,51069,356,2751,3107,617,6571,7188,74041,841428,915469,01/01/2013 12:00:00 AM,208,306,295
Northern,Frederick County,51069,356,2760,3116,620,6609,7229,73721,844708,918429,02/01/2013 12:00:00 AM,207,306,295
Northern,Frederick County,51069,362,2781,3143,636,6651,7287,77887,854921,932808,10/01/2012 12:00:00 AM,215,307,297
Northern,Frederick County,51069,367,2787,3154,646,6688,7334,79836,870871,950707,09/01/2012 12:00:00 AM,218,312,301
Northern,Frederick County,51069,370,2739,3109,650,6671,7321,78774,866336,945110,01/01/2012 12:00:00 AM,213,316,304
Northern,Frederick County,51069,379,2788,3167,680,6711,7391,86875,866858,953733,08/01/2012 12:00:00 AM,229,311,301
Northern,Frederick County,51069,380,2757,3137,674,6687,7361,82179,874944,957123,03/01/2012 12:00:00 AM,216,317,305
Northern,Frederick County,51069,380,2776,3156,679,6735,7414,85608,877006,962614,02/01/2012 12:00:00 AM,225,316,305
Northern,Frederick County,51069,383,2779,3162,685,6769,7454,86802,882653,969455,04/01/2012 12:00:00 AM,227,318,307
Northern,Frederick County,51069,385,2798,3183,694,6790,7484,86392,877027,963419,06/01/2012 12:00:00 AM,224,313,303
Northern,Frederick County,51069,386,2789,3175,704,6777,7481,87907,880302,968209,05/01/2012 12:00:00 AM,228,316,305
Northern,Frederick County,51069,388,2794,3182,703,6762,7465,87962,873058,961020,07/01/2012 12:00:00 AM,227,312,302
Northern,Fredericksburg City,51630,305,1462,1767,490,3208,3698,51934,387443,439377,06/01/2016 12:00:00 AM,170,265,249
Northern,Fredericksburg City,51630,306,1577,1883,498,3379,3877,49738,421832,471570,08/01/2015 12:00:00 AM,163,267,250
Northern,Fredericksburg City,51630,309,1439,1748,510,3161,3671,55489,381293,436782,07/01/2016 12:00:00 AM,180,265,250
Northern,Fredericksburg City,51630,310,1456,1766,532,3238,3770,52199,391191,443390,12/01/2016 12:00:00 AM,168,269,251
Northern,Fredericksburg City,51630,310,1464,1774,533,3225,3758,53088,393559,446647,11/01/2016 12:00:00 AM,171,269,252
Northern,Fredericksburg City,51630,313,1575,1888,535,3365,3900,52990,420516,473506,07/01/2015 12:00:00 AM,169,267,251
Northern,Fredericksburg City,51630,314,1450,1764,524,3143,3667,56322,377774,434096,08/01/2016 12:00:00 AM,179,261,246
Northern,Fredericksburg City,51630,314,1472,1786,509,3198,3707,53082,388502,441584,05/01/2016 12:00:00 AM,169,264,247
Northern,Fredericksburg City,51630,314,1529,1843,534,3262,3796,56210,400279,456489,03/01/2016 12:00:00 AM,179,262,248
Northern,Fredericksburg City,51630,315,1449,1764,545,3140,3685,58384,375879,434263,09/01/2016 12:00:00 AM,185,259,246
Northern,Fredericksburg City,51630,316,1509,1825,511,3267,3778,52386,403182,455568,04/01/2016 12:00:00 AM,166,267,250
Northern,Fredericksburg City,51630,317,1453,1770,536,3214,3750,54230,387036,441266,01/01/2017 12:00:00 AM,171,266,249
Northern,Fredericksburg City,51630,317,1600,1917,539,3389,3928,55515,424866,480381,06/01/2015 12:00:00 AM,175,266,251
Northern,Fredericksburg City,51630,320,1435,1755,559,3144,3703,56552,381667,438219,10/01/2016 12:00:00 AM,177,266,250
Northern,Fredericksburg City,51630,321,1571,1892,554,3337,3891,57721,413230,470951,09/01/2015 12:00:00 AM,180,263,249
Northern,Fredericksburg City,51630,322,1557,1879,544,3330,3874,56543,412541,469084,11/01/2015 12:00:00 AM,176,265,250
Northern,Fredericksburg City,51630,323,1537,1860,543,3257,3800,55906,404829,460735,02/01/2016 12:00:00 AM,173,263,248
Northern,Fredericksburg City,51630,324,1438,1762,548,3201,3749,57070,384454,441524,02/01/2017 12:00:00 AM,176,267,251
Northern,Fredericksburg City,51630,324,1628,1952,555,3420,3975,56523,431737,488260,05/01/2015 12:00:00 AM,174,265,250
Northern,Fredericksburg City,51630,324,1696,2020,524,3543,4067,119490,815945,935435,04/01/2021 12:00:00 AM,369,481,463
Northern,Fredericksburg City,51630,324,1708,2032,521,3594,4115,109801,763632,873433,03/01/2021 12:00:00 AM,339,447,430
Northern,Fredericksburg City,51630,325,1627,1952,560,3407,3967,57710,425347,483057,04/01/2015 12:00:00 AM,178,261,247
Northern,Fredericksburg City,51630,326,1553,1879,566,3313,3879,59960,407436,467396,10/01/2015 12:00:00 AM,184,262,249
Northern,Fredericksburg City,51630,328,1427,1755,553,3120,3673,61266,384822,446088,03/01/2017 12:00:00 AM,187,270,254
Northern,Fredericksburg City,51630,329,1390,1719,563,3036,3599,61953,371489,433442,05/01/2017 12:00:00 AM,188,267,252
Northern,Fredericksburg City,51630,329,1567,1896,568,3323,3891,61764,405894,467658,12/01/2015 12:00:00 AM,188,259,247
Northern,Fredericksburg City,51630,329,1716,2045,512,3622,4134,114799,775088,889887,02/01/2021 12:00:00 AM,349,452,435
Northern,Fredericksburg City,51630,330,1397,1727,563,3032,3595,61398,368332,429730,06/01/2017 12:00:00 AM,186,264,249
Northern,Fredericksburg City,51630,330,1404,1734,556,3061,3617,61962,374114,436076,04/01/2017 12:00:00 AM,188,266,251
Northern,Fredericksburg City,51630,331,1698,2029,530,3521,4051,119574,825993,945567,05/01/2021 12:00:00 AM,361,486,466
Northern,Fredericksburg City,51630,333,1544,1877,582,3258,3840,61654,396024,457678,01/01/2016 12:00:00 AM,185,256,244
Northern,Fredericksburg City,51630,335,1390,1725,565,3022,3587,61120,368808,429928,07/01/2017 12:00:00 AM,182,265,249
Northern,Fredericksburg City,51630,337,1637,1974,598,3407,4005,62611,432123,494734,03/01/2015 12:00:00 AM,186,264,251
Northern,Fredericksburg City,51630,340,1361,1701,566,2906,3472,61589,357002,418591,09/01/2017 12:00:00 AM,181,262,246
Northern,Fredericksburg City,51630,340,1433,1773,575,3095,3670,60441,380328,440769,02/01/2018 12:00:00 AM,178,265,249
Northern,Fredericksburg City,51630,340,2033,2373,574,3897,4471,63936,527062,590998,08/01/2013 12:00:00 AM,188,259,249
Northern,Fredericksburg City,51630,340,2043,2383,573,3927,4500,63866,534504,598370,09/01/2013 12:00:00 AM,188,262,251
Northern,Fredericksburg City,51630,342,1970,2312,568,3786,4354,54487,472801,527288,01/01/2014 12:00:00 AM,159,240,228
Northern,Fredericksburg City,51630,344,2037,2381,591,3897,4488,64350,527690,592040,10/01/2013 12:00:00 AM,187,259,249
Northern,Fredericksburg City,51630,345,1405,1750,579,3014,3593,64555,374002,438557,08/01/2017 12:00:00 AM,187,266,251
Northern,Fredericksburg City,51630,345,1711,2056,559,3536,4095,126085,814498,940583,06/01/2021 12:00:00 AM,365,476,457
Northern,Fredericksburg City,51630,346,1637,1983,613,3392,4005,64769,428100,492869,02/01/2015 12:00:00 AM,187,262,249
Northern,Fredericksburg City,51630,348,1376,1724,590,2921,3511,64651,359097,423748,10/01/2017 12:00:00 AM,186,261,246
Northern,Fredericksburg City,51630,348,1398,1746,580,2998,3578,61922,366608,428530,11/01/2017 12:00:00 AM,178,262,245
Northern,Fredericksburg City,51630,348,1671,2019,611,3452,4063,63925,427421,491346,01/01/2015 12:00:00 AM,184,256,243
Northern,Fredericksburg City,51630,348,1924,2272,599,3706,4305,60880,459267,520147,03/01/2014 12:00:00 AM,175,239,229
Northern,Fredericksburg City,51630,349,1403,1752,582,3008,3590,62822,364958,427780,01/01/2018 12:00:00 AM,180,260,244
Northern,Fredericksburg City,51630,350,1405,1755,587,3032,3619,61001,372774,433775,12/01/2017 12:00:00 AM,174,265,247
Northern,Fredericksburg City,51630,350,1415,1765,592,3033,3625,63711,375522,439233,03/01/2018 12:00:00 AM,182,265,249
Northern,Fredericksburg City,51630,350,1840,2190,613,3575,4188,61675,441758,503433,07/01/2014 12:00:00 AM,176,240,230
Northern,Fredericksburg City,51630,350,1954,2304,604,3751,4355,60285,469280,529565,02/01/2014 12:00:00 AM,172,240,230
Northern,Fredericksburg City,51630,350,1980,2330,607,3790,4397,70546,521844,592390,11/01/2012 12:00:00 AM,202,264,254
Northern,Fredericksburg City,51630,350,1982,2332,627,3778,4405,71523,524062,595585,10/01/2012 12:00:00 AM,204,264,255
Northern,Fredericksburg City,51630,350,1990,2340,580,3802,4382,56305,476344,532649,12/01/2013 12:00:00 AM,161,239,228
Northern,Fredericksburg City,51630,350,1999,2349,590,3839,4429,59714,485858,545572,11/01/2013 12:00:00 AM,171,243,232
Northern,Fredericksburg City,51630,351,1717,2068,608,3544,4152,64100,445028,509128,12/01/2014 12:00:00 AM,183,259,246
Northern,Fredericksburg City,51630,352,1505,1857,573,3261,3834,60515,409767,470282,02/01/2020 12:00:00 AM,172,272,253
Northern,Fredericksburg City,51630,352,1755,2107,618,3520,4138,65382,445717,511099,11/01/2014 12:00:00 AM,186,254,243
Northern,Fredericksburg City,51630,352,2014,2366,589,3798,4387,65810,522951,588761,05/01/2013 12:00:00 AM,187,260,249
Northern,Fredericksburg City,51630,353,1530,1883,570,3243,3813,59141,406224,465365,09/01/2019 12:00:00 AM,168,266,247
Northern,Fredericksburg City,51630,353,1778,2131,604,3711,4315,105517,639826,745343,09/01/2020 12:00:00 AM,299,360,350
Northern,Fredericksburg City,51630,353,1961,2314,661,3707,4368,74797,502316,577113,01/01/2012 12:00:00 AM,212,256,249
Northern,Fredericksburg City,51630,354,1869,2223,607,3636,4243,60548,448763,509311,06/01/2014 12:00:00 AM,171,240,229
Northern,Fredericksburg City,51630,354,1967,2321,659,3664,4323,74979,499543,574522,02/01/2012 12:00:00 AM,212,254,248
Northern,Fredericksburg City,51630,354,1987,2341,618,3783,4401,70115,511020,581135,01/01/2013 12:00:00 AM,198,257,248
Northern,Fredericksburg City,51630,354,1997,2351,624,3808,4432,71687,519230,590917,12/01/2012 12:00:00 AM,203,260,251
Northern,Fredericksburg City,51630,354,2025,2379,618,3842,4460,69208,525841,595049,02/01/2013 12:00:00 AM,196,260,250
Northern,Fredericksburg City,51630,355,1486,1841,592,3189,3781,63998,399223,463221,11/01/2019 12:00:00 AM,180,269,252
Northern,Fredericksburg City,51630,355,2026,2381,592,3806,4398,66242,522629,588871,04/01/2013 12:00:00 AM,187,258,247
Northern,Fredericksburg City,51630,355,2037,2392,592,3862,4454,66338,527300,593638,06/01/2013 12:00:00 AM,187,259,248
Northern,Fredericksburg City,51630,356,1674,2030,590,3479,4069,124407,731979,856386,01/01/2021 12:00:00 AM,349,437,422
Northern,Fredericksburg City,51630,356,2020,2376,584,3864,4448,66627,525338,591965,07/01/2013 12:00:00 AM,187,260,249
Northern,Fredericksburg City,51630,357,1931,2288,658,3652,4310,76218,495860,572078,04/01/2012 12:00:00 AM,213,257,250
Northern,Fredericksburg City,51630,357,1953,2310,638,3798,4436,72539,517113,589652,08/01/2012 12:00:00 AM,203,265,255
Northern,Fredericksburg City,51630,358,1379,1737,612,2947,3559,66773,365070,431843,04/01/2018 12:00:00 AM,187,265,249
Northern,Fredericksburg City,51630,358,1517,1875,588,3296,3884,61749,420821,482570,10/01/2019 12:00:00 AM,172,277,257
Northern,Fredericksburg City,51630,358,1976,2334,641,3795,4436,76279,519904,596183,07/01/2012 12:00:00 AM,213,263,255
Northern,Fredericksburg City,51630,359,1890,2249,639,3625,4264,64234,454089,518323,05/01/2014 12:00:00 AM,179,240,230
Northern,Fredericksburg City,51630,359,1947,2306,658,3743,4401,75462,512006,587468,05/01/2012 12:00:00 AM,210,263,255
Northern,Fredericksburg City,51630,359,1960,2319,690,3644,4334,81334,499714,581048,03/01/2012 12:00:00 AM,227,255,251
Northern,Fredericksburg City,51630,360,1381,1741,575,2929,3504,59551,362433,421984,02/01/2019 12:00:00 AM,165,262,242
Northern,Fredericksburg City,51630,360,1891,2251,635,3629,4264,64142,452907,517049,04/01/2014 12:00:00 AM,178,240,230
Northern,Fredericksburg City,51630,361,1728,2089,610,3597,4207,115067,680630,795697,11/01/2020 12:00:00 AM,319,394,381
Northern,Fredericksburg City,51630,361,1772,2133,661,3483,4144,71924,441841,513765,10/01/2014 12:00:00 AM,199,249,241
Northern,Fredericksburg City,51630,361,1945,2306,655,3732,4387,76692,510695,587387,09/01/2012 12:00:00 AM,212,263,255
Northern,Fredericksburg City,51630,363,1760,2123,623,3671,4294,115966,673875,789841,10/01/2020 12:00:00 AM,319,383,372
Northern,Fredericksburg City,51630,364,1525,1889,575,3231,3806,57597,399281,456878,08/01/2019 12:00:00 AM,158,262,242
Northern,Fredericksburg City,51630,364,1558,1922,593,3378,3971,104506,578134,682640,03/01/2020 12:00:00 AM,287,371,355
Northern,Fredericksburg City,51630,364,1707,2071,611,3563,4174,113545,650167,763712,12/01/2020 12:00:00 AM,312,381,369
Northern,Fredericksburg City,51630,364,1824,2188,662,3558,4220,67648,438257,505905,08/01/2014 12:00:00 AM,186,240,231
Northern,Fredericksburg City,51630,364,1944,2308,657,3743,4400,76098,506648,582746,06/01/2012 12:00:00 AM,209,261,252
Northern,Fredericksburg City,51630,365,1810,2175,623,3802,4425,109898,654547.91,764445.91,08/01/2020 12:00:00 AM,301,362,351
Northern,Fredericksburg City,51630,366,1400,1766,595,3032,3627,64790,381141,445931,09/01/2018 12:00:00 AM,177,272,253
Northern,Fredericksburg City,51630,366,1507,1873,572,3211,3783,56765,400365,457130,07/01/2019 12:00:00 AM,155,266,244
Northern,Fredericksburg City,51630,367,1372,1739,618,2954,3572,67439,370256,437695,05/01/2018 12:00:00 AM,184,270,252
Northern,Fredericksburg City,51630,368,1523,1891,610,3299,3909,63410,413296,476706,01/01/2020 12:00:00 AM,172,271,252
Northern,Fredericksburg City,51630,368,1526,1894,601,3284,3885,64587,411977,476564,12/01/2019 12:00:00 AM,176,270,252
Northern,Fredericksburg City,51630,368,2014,2382,634,3818,4452,72334,524384,596718,03/01/2013 12:00:00 AM,197,260,251
Northern,Fredericksburg City,51630,369,1806,2175,628,3811,4439,110639,662899,773538,06/01/2020 12:00:00 AM,300,367,356
Northern,Fredericksburg City,51630,370,1718,2088,625,3653,4278,110580,626667,737247,04/01/2020 12:00:00 AM,299,365,353
Northern,Fredericksburg City,51630,371,1410,1781,598,3037,3635,65927,383567,449494,10/01/2018 12:00:00 AM,178,272,252
Northern,Fredericksburg City,51630,371,1494,1865,601,3165,3766,61830,398428,460258,03/01/2019 12:00:00 AM,167,267,247
Northern,Fredericksburg City,51630,371,1778,2149,626,3755,4381,110745,651676,762421,05/01/2020 12:00:00 AM,299,367,355
Northern,Fredericksburg City,51630,372,1399,1771,637,2982,3619,68799,372219,441018,06/01/2018 12:00:00 AM,185,266,249
Northern,Fredericksburg City,51630,372,1502,1874,580,3180,3760,57359,400912,458271,06/01/2019 12:00:00 AM,154,267,245
Northern,Fredericksburg City,51630,372,1780,2152,676,3502,4178,70338,425511,495849,09/01/2014 12:00:00 AM,189,239,230
Northern,Fredericksburg City,51630,373,1816,2189,637,3828,4465,112203,659842,772045,07/01/2020 12:00:00 AM,301,363,353
Northern,Fredericksburg City,51630,374,1403,1777,626,3032,3658,68759,382607,451366,08/01/2018 12:00:00 AM,184,273,254
Northern,Fredericksburg City,51630,374,1431,1805,610,3095,3705,67196,387300,454496,11/01/2018 12:00:00 AM,180,271,252
Northern,Fredericksburg City,51630,375,1380,1755,638,2988,3626,70362,372539,442901,07/01/2018 12:00:00 AM,188,270,252
Northern,Fredericksburg City,51630,376,1426,1802,620,3079,3699,68618,378830,447448,12/01/2018 12:00:00 AM,182,266,248
Northern,Fredericksburg City,51630,377,1489,1866,615,3192,3807,67033,425963,492996,01/01/2019 12:00:00 AM,178,286,264
Northern,Fredericksburg City,51630,380,1488,1868,597,3146,3743,60111,398505,458616,05/01/2019 12:00:00 AM,158,268,246
Northern,Fredericksburg City,51630,381,1468,1849,598,3110,3708,61361,390472,451833,04/01/2019 12:00:00 AM,161,266,244
Northern,Greene County,51079,115,551,666,152,1368,1520,14706,162019.5,176725.5,02/01/2020 12:00:00 AM,128,294,265
Northern,Greene County,51079,116,580,696,156,1436,1592,27869,241553,269422,03/01/2020 12:00:00 AM,240,416,387
Northern,Greene County,51079,117,835,952,180,1965,2145,18206,223799,242005,02/01/2014 12:00:00 AM,156,268,254
Northern,Greene County,51079,118,571,689,154,1415,1569,14052,167221,181273,01/01/2020 12:00:00 AM,119,293,263
Northern,Greene County,51079,118,589,707,161,1445,1606,15535,171081,186616,11/01/2019 12:00:00 AM,132,290,264
Northern,Greene County,51079,118,594,712,160,1483,1643,16043,175506,191549,06/01/2019 12:00:00 AM,136,295,269
Northern,Greene County,51079,118,618,736,160,1525,1685,29331,259540,288871,04/01/2020 12:00:00 AM,249,420,392
Northern,Greene County,51079,118,657,775,158,1615,1773,36362,355953,392315,06/01/2021 12:00:00 AM,308,542,506
Northern,Greene County,51079,118,658,776,157,1625,1782,30196,293965,324161,11/01/2020 12:00:00 AM,256,447,418
Northern,Greene County,51079,118,681,799,157,1687,1844,34655,349095,383750,02/01/2021 12:00:00 AM,294,513,480
Northern,Greene County,51079,118,682,800,159,1685,1844,35430,348085.74,383515.74,03/01/2021 12:00:00 AM,300,510,479
Northern,Greene County,51079,118,795,913,190,1979,2169,21486,243555,265041,05/01/2012 12:00:00 AM,182,306,290
Northern,Greene County,51079,118,843,961,180,1990,2170,19191,244954,264145,10/01/2013 12:00:00 AM,163,291,275
Northern,Greene County,51079,118,844,962,179,1983,2162,17403,225280,242683,04/01/2014 12:00:00 AM,147,267,252
Northern,Greene County,51079,118,844,962,185,2009,2194,19960,248262,268222,09/01/2013 12:00:00 AM,169,294,279
Northern,Greene County,51079,118,846,964,180,2001,2181,17140,224103,241243,11/01/2013 12:00:00 AM,145,265,250
Northern,Greene County,51079,119,585,704,157,1455,1612,15103,173945,189048,12/01/2019 12:00:00 AM,127,297,269
Northern,Greene County,51079,119,635,754,161,1564,1725,29513,265754,295267,05/01/2020 12:00:00 AM,248,419,392
Northern,Greene County,51079,119,825,944,186,1942,2128,19477,225106,244583,05/01/2014 12:00:00 AM,164,273,259
Northern,Greene County,51079,119,840,959,184,1970,2154,18456,223960,242416,03/01/2014 12:00:00 AM,155,267,253
Northern,Greene County,51079,120,588,708,162,1460,1622,16006,172670,188676,07/01/2019 12:00:00 AM,133,294,266
Northern,Greene County,51079,120,596,716,165,1464,1629,16429,176761,193190,10/01/2019 12:00:00 AM,137,297,270
Northern,Greene County,51079,120,634,754,159,1562,1721,29496,267150,296646,06/01/2020 12:00:00 AM,246,421,393
Northern,Greene County,51079,120,666,786,160,1647,1807,37805,361481,399286,05/01/2021 12:00:00 AM,315,543,508
Northern,Greene County,51079,120,668,788,158,1656,1814,35618,340620,376238,01/01/2021 12:00:00 AM,297,510,477
Northern,Greene County,51079,120,780,900,196,1935,2131,21926,242402,264328,04/01/2012 12:00:00 AM,183,311,294
Northern,Greene County,51079,120,786,906,194,1944,2138,21524,245098,266622,03/01/2012 12:00:00 AM,179,312,294
Northern,Greene County,51079,120,839,959,182,2016,2198,19887,246985,266872,08/01/2013 12:00:00 AM,166,294,278
Northern,Greene County,51079,121,642,763,161,1568,1729,29886,268117,298003,07/01/2020 12:00:00 AM,247,418,391
Northern,Greene County,51079,121,664,785,162,1645,1807,31003,289999,321002,12/01/2020 12:00:00 AM,256,437,409
Northern,Greene County,51079,121,815,936,182,1929,2111,18560,214731,233291,01/01/2014 12:00:00 AM,153,263,249
Northern,Greene County,51079,121,849,970,185,2026,2211,19545,247307,266852,07/01/2013 12:00:00 AM,162,291,275
Northern,Greene County,51079,122,668,790,166,1661,1827,38636,361678,400314,04/01/2021 12:00:00 AM,317,541,507
Northern,Greene County,51079,122,669,791,186,1718,1904,20387,207373,227760,05/01/2017 12:00:00 AM,167,310,288
Northern,Greene County,51079,122,697,819,174,1796,1970,18937,220828,239765,04/01/2017 12:00:00 AM,155,317,293
Northern,Greene County,51079,122,698,820,182,1736,1918,20784,205701,226485,03/01/2017 12:00:00 AM,170,295,276
Northern,Greene County,51079,122,818,940,189,1953,2142,18765,217573,236338,12/01/2013 12:00:00 AM,154,266,251
Northern,Greene County,51079,123,585,708,174,1430,1604,17263,166124,183387,09/01/2019 12:00:00 AM,140,284,259
Northern,Greene County,51079,123,654,777,182,1659,1841,20147,199954,220101,09/01/2017 12:00:00 AM,164,306,283
Northern,Greene County,51079,124,573,697,173,1409,1582,18306,165681,183987,02/01/2019 12:00:00 AM,148,289,264
Northern,Greene County,51079,124,590,714,171,1437,1608,17395,167776,185171,08/01/2019 12:00:00 AM,140,284,259
Northern,Greene County,51079,124,600,724,175,1488,1663,18969,178273,197242,05/01/2019 12:00:00 AM,153,297,272
Northern,Greene County,51079,124,625,749,177,1551,1728,19077,188114.64,207191.64,07/01/2018 12:00:00 AM,154,301,277
Northern,Greene County,51079,124,641,765,169,1580,1749,30234,265931,296165,08/01/2020 12:00:00 AM,244,415,387
Northern,Greene County,51079,124,653,777,166,1621,1787,31920,289140,321060,10/01/2020 12:00:00 AM,257,443,413
Northern,Greene County,51079,124,799,923,203,1979,2182,23521,248998,272519,02/01/2012 12:00:00 AM,190,312,295
Northern,Greene County,51079,124,826,950,190,1968,2158,21245,243399,264644,05/01/2013 12:00:00 AM,171,295,279
Northern,Greene County,51079,125,625,750,174,1562,1736,18846,187750,206596,09/01/2018 12:00:00 AM,151,300,275
Northern,Greene County,51079,125,793,918,210,1943,2153,25591,240267,265858,08/01/2012 12:00:00 AM,205,303,290
Northern,Greene County,51079,125,851,976,190,2014,2204,20695,247200,267895,06/01/2013 12:00:00 AM,166,290,274
Northern,Greene County,51079,126,629,755,186,1582,1768,19833,191567,211400,04/01/2018 12:00:00 AM,157,305,280
Northern,Greene County,51079,126,632,758,182,1563,1745,20397,184626,205023,08/01/2018 12:00:00 AM,162,292,270
Northern,Greene County,51079,126,642,768,194,1635,1829,23032,194029,217061,07/01/2017 12:00:00 AM,183,302,283
Northern,Greene County,51079,126,645,771,184,1639,1823,20063,196266.5,216329.5,03/01/2018 12:00:00 AM,159,304,281
Northern,Greene County,51079,126,654,780,195,1651,1846,22321,198339,220660,06/01/2017 12:00:00 AM,177,303,283
Northern,Greene County,51079,126,658,784,187,1678,1865,20653,203345,223998,08/01/2017 12:00:00 AM,164,309,286
Northern,Greene County,51079,126,728,854,186,1834,2020,20435,213739,234174,01/01/2017 12:00:00 AM,162,294,274
Northern,Greene County,51079,126,740,866,176,1871,2047,18703,220976,239679,02/01/2017 12:00:00 AM,148,299,277
Northern,Greene County,51079,126,785,911,211,1947,2158,24194,239331,263525,06/01/2012 12:00:00 AM,192,305,289
Northern,Greene County,51079,127,618,745,181,1552,1733,19934,186955,206889,10/01/2018 12:00:00 AM,157,303,278
Northern,Greene County,51079,127,655,782,176,1652,1828,20142,194962,215104,12/01/2017 12:00:00 AM,159,298,275
Northern,Greene County,51079,127,667,794,186,1679,1865,20695,200314,221009,10/01/2017 12:00:00 AM,163,300,278
Northern,Greene County,51079,127,670,797,184,1703,1887,21194,206232,227426,11/01/2017 12:00:00 AM,167,308,285
Northern,Greene County,51079,127,809,936,209,1951,2160,22545,226211,248756,06/01/2014 12:00:00 AM,178,280,266
Northern,Greene County,51079,127,835,962,191,1991,2182,20965,249029,269994,04/01/2013 12:00:00 AM,165,298,281
Northern,Greene County,51079,128,600,728,180,1493,1673,19708,190180,209888,01/01/2019 12:00:00 AM,154,317,288
Northern,Greene County,51079,128,616,744,176,1542,1718,18469,186606,205075,12/01/2018 12:00:00 AM,144,303,276
Northern,Greene County,51079,128,616,744,188,1524,1712,20482,183974,204456,05/01/2018 12:00:00 AM,160,299,275
Northern,Greene County,51079,128,618,746,179,1542,1721,19164,185234.93,204398.93,11/01/2018 12:00:00 AM,150,300,274
Northern,Greene County,51079,128,635,763,176,1581,1757,32880,270709,303589,09/01/2020 12:00:00 AM,257,426,398
Northern,Greene County,51079,128,720,848,191,1851,2042,21275,215824,237099,12/01/2016 12:00:00 AM,166,300,280
Northern,Greene County,51079,128,802,930,197,2007,2204,20818,230926,251744,09/01/2014 12:00:00 AM,163,288,271
Northern,Greene County,51079,128,835,963,201,1987,2188,22412,251927,274339,02/01/2013 12:00:00 AM,175,302,285
Northern,Greene County,51079,128,841,969,195,1998,2193,23381,270547,293928,03/01/2013 12:00:00 AM,183,322,303
Northern,Greene County,51079,129,590,719,179,1454,1633,18472,173951,192423,04/01/2019 12:00:00 AM,143,295,268
Northern,Greene County,51079,129,629,758,189,1560,1749,20342,187475.5,207817.5,06/01/2018 12:00:00 AM,158,298,274
Northern,Greene County,51079,129,651,780,185,1662,1847,20711.5,192542,213253.5,01/01/2018 12:00:00 AM,161,296,273
Northern,Greene County,51079,129,787,916,219,1939,2158,28972,256636,285608,07/01/2012 12:00:00 AM,225,326,312
Northern,Greene County,51079,129,795,924,212,1943,2155,23092,224950,248042,07/01/2014 12:00:00 AM,179,283,268
Northern,Greene County,51079,129,800,929,214,1942,2156,25644,244197,269841,09/01/2012 12:00:00 AM,199,305,290
Northern,Greene County,51079,129,813,942,211,1957,2168,23766,247578,271344,12/01/2012 12:00:00 AM,184,305,288
Northern,Greene County,51079,129,819,948,214,1988,2202,25176,259354,284530,11/01/2012 12:00:00 AM,195,317,300
Northern,Greene County,51079,130,644,774,188,1657,1845,19937,196090.5,216027.5,02/01/2018 12:00:00 AM,153,304,279
Northern,Greene County,51079,130,749,879,211,1866,2077,24270,218433,242703,06/01/2015 12:00:00 AM,187,292,276
Northern,Greene County,51079,130,757,887,204,1897,2101,22145,220404,242549,08/01/2015 12:00:00 AM,170,291,273
Northern,Greene County,51079,130,758,888,217,1895,2112,24165,220310,244475,07/01/2015 12:00:00 AM,186,291,275
Northern,Greene County,51079,130,821,951,204,1959,2163,22651,246157,268808,01/01/2013 12:00:00 AM,174,300,283
Northern,Greene County,51079,131,603,734,181,1499,1680,18413,178330,196743,03/01/2019 12:00:00 AM,141,296,268
Northern,Greene County,51079,131,749,880,223,1868,2091,27537,222038,249575,05/01/2015 12:00:00 AM,210,296,284
Northern,Greene County,51079,131,802,933,220,1989,2209,25756,244532,270288,01/01/2012 12:00:00 AM,197,305,290
Northern,Greene County,51079,131,821,952,221,1988,2209,26120,251012,277132,10/01/2012 12:00:00 AM,199,306,291
Northern,Greene County,51079,132,725,857,203,1844,2047,22775,214332,237107,11/01/2016 12:00:00 AM,173,296,277
Northern,Greene County,51079,133,752,885,235,1899,2134,28198,225264,253462,02/01/2015 12:00:00 AM,212,300,286
Northern,Greene County,51079,133,785,918,220,1947,2167,23654,227432,251086,08/01/2014 12:00:00 AM,178,290,274
Northern,Greene County,51079,134,744,878,230,1869,2099,28270,223333,251603,04/01/2015 12:00:00 AM,211,300,287
Northern,Greene County,51079,134,752,886,207,1883,2090,22147,223376,245523,09/01/2015 12:00:00 AM,165,297,277
Northern,Greene County,51079,134,790,924,215,1984,2199,24563,238178,262741,10/01/2014 12:00:00 AM,183,301,284
Northern,Greene County,51079,135,748,883,217,1904,2121,25824,224811,250635,08/01/2016 12:00:00 AM,191,301,284
Northern,Greene County,51079,135,751,886,233,1906,2139,28475,226641,255116,03/01/2015 12:00:00 AM,211,302,288
Northern,Greene County,51079,136,740,876,211,1858,2069,23276,217791,241067,10/01/2015 12:00:00 AM,171,294,275
Northern,Greene County,51079,136,771,907,238,1957,2195,28538,229455,257993,01/01/2015 12:00:00 AM,210,298,284
Northern,Greene County,51079,137,728,865,214,1853,2067,25921,216948,242869,05/01/2016 12:00:00 AM,189,298,281
Northern,Greene County,51079,137,734,871,224,1851,2075,25123,217385,242508,10/01/2016 12:00:00 AM,183,296,278
Northern,Greene County,51079,138,735,873,221,1885,2106,26097,221143,247240,07/01/2016 12:00:00 AM,189,301,283
Northern,Greene County,51079,139,748,887,230,1900,2130,26151,226233,252384,09/01/2016 12:00:00 AM,188,302,285
Northern,Greene County,51079,140,723,863,232,1855,2087,26841,216463,243304,06/01/2016 12:00:00 AM,192,299,282
Northern,Greene County,51079,140,752,892,210,1910,2120,23769,221592,245361,11/01/2015 12:00:00 AM,170,295,275
Northern,Greene County,51079,140,783,923,230,1968,2198,26901,234739,261640,11/01/2014 12:00:00 AM,192,300,283
Northern,Greene County,51079,142,778,920,249,1933,2182,29440,228407,257847,12/01/2014 12:00:00 AM,207,294,280
Northern,Greene County,51079,143,721,864,238,1821,2059,27710,213912,241622,03/01/2016 12:00:00 AM,194,297,280
Northern,Greene County,51079,144,734,878,231,1879,2110,25991,216638,242629,12/01/2015 12:00:00 AM,180,295,276
Northern,Greene County,51079,144,737,881,225,1873,2098,25956,218608,244564,04/01/2016 12:00:00 AM,180,297,278
Northern,Greene County,51079,145,710,855,247,1806,2053,27600,207913,235513,01/01/2016 12:00:00 AM,190,293,275
Northern,Greene County,51079,148,715,863,246,1816,2062,28161,212714,240875,02/01/2016 12:00:00 AM,190,298,279
Northern,Harrisonburg City,51660,415,1312,1727,621,3070,3691,111889,518567,630456,03/01/2020 12:00:00 AM,270,395,365
Northern,Harrisonburg City,51660,415,1476,1891,578,3355,3933,130776,711486,842262,02/01/2021 12:00:00 AM,315,482,445
Northern,Harrisonburg City,51660,417,1319,1736,633,3112,3745,52415,347974,400389,12/01/2019 12:00:00 AM,126,264,231
Northern,Harrisonburg City,51660,418,1496,1914,580,3394,3974,126903,701050,827953,03/01/2021 12:00:00 AM,304,469,433
Northern,Harrisonburg City,51660,421,1416,1837,637,3270,3907,114642,554888,669530,04/01/2020 12:00:00 AM,272,392,364
Northern,Harrisonburg City,51660,421,1461,1882,628,3755,4383,53849,418220,472069,03/01/2017 12:00:00 AM,128,286,251
Northern,Harrisonburg City,51660,422,1469,1891,609,3332,3941,137154,751098,888252,04/01/2021 12:00:00 AM,325,511,470
Northern,Harrisonburg City,51660,423,1322,1745,658,3145,3803,56311,346958,403269,11/01/2019 12:00:00 AM,133,262,231
Northern,Harrisonburg City,51660,423,1350,1773,647,3283,3930,53546,365504,419050,05/01/2019 12:00:00 AM,127,271,236
Northern,Harrisonburg City,51660,424,1334,1758,678,3178,3856,60103,352554,412657,10/01/2019 12:00:00 AM,142,264,235
Northern,Harrisonburg City,51660,425,1308,1733,649,3063,3712,51856,344180,396036,01/01/2020 12:00:00 AM,122,263,229
Northern,Harrisonburg City,51660,426,1241,1667,653,3025,3678,53737,333062,386799,02/01/2019 12:00:00 AM,126,268,232
Northern,Harrisonburg City,51660,427,1295,1722,641,3024,3665,51195,343312,394507,02/01/2020 12:00:00 AM,120,265,229
Northern,Harrisonburg City,51660,427,1451,1878,650,3352,4002,116499,575266,691765,05/01/2020 12:00:00 AM,273,396,368
Northern,Harrisonburg City,51660,429,1344,1773,678,3232,3910,57057,365382,422439,09/01/2019 12:00:00 AM,133,272,238
Northern,Harrisonburg City,51660,430,1364,1794,668,3330,3998,57139,374691,431830,07/01/2019 12:00:00 AM,133,275,241
Northern,Harrisonburg City,51660,431,1336,1767,664,3248,3912,57185,362065,419250,08/01/2019 12:00:00 AM,133,271,237
Northern,Harrisonburg City,51660,431,1438,1869,643,3269,3912,140234,681024,821258,01/01/2021 12:00:00 AM,325,474,439
Northern,Harrisonburg City,51660,432,1451,1883,645,3283,3928,148924,735514,884438,05/01/2021 12:00:00 AM,345,507,470
Northern,Harrisonburg City,51660,433,1465,1898,650,3291,3941,146423,745278,891701,06/01/2021 12:00:00 AM,338,509,470
Northern,Harrisonburg City,51660,434,1384,1818,679,3375,4054,58366,377335,435701,06/01/2019 12:00:00 AM,134,273,240
Northern,Harrisonburg City,51660,434,1414,1848,658,3224,3882,124659,584609,709268,10/01/2020 12:00:00 AM,287,413,384
Northern,Harrisonburg City,51660,434,1415,1849,656,3639,4295,58316,401527,459843,04/01/2017 12:00:00 AM,134,284,249
Northern,Harrisonburg City,51660,434,1432,1866,654,3256,3910,125894,598540,724434,12/01/2020 12:00:00 AM,290,418,388
Northern,Harrisonburg City,51660,436,1426,1862,659,3668,4327,59076,408573,467649,05/01/2017 12:00:00 AM,135,287,251
Northern,Harrisonburg City,51660,436,1435,1871,660,3289,3949,120329,570362,690691,06/01/2020 12:00:00 AM,276,397,369
Northern,Harrisonburg City,51660,437,1290,1727,683,3211,3894,59002,356745,415747,12/01/2018 12:00:00 AM,135,277,241
Northern,Harrisonburg City,51660,437,1389,1826,686,3598,4284,62716,402350,465066,09/01/2017 12:00:00 AM,144,290,255
Northern,Harrisonburg City,51660,437,1426,1863,659,3252,3911,124863,601012,725875,11/01/2020 12:00:00 AM,286,421,390
Northern,Harrisonburg City,51660,439,1435,1874,670,3284,3954,121449,571274,692723,09/01/2020 12:00:00 AM,277,398,370
Northern,Harrisonburg City,51660,439,1524,1963,683,3941,4624,59150,427622,486772,02/01/2017 12:00:00 AM,135,281,248
Northern,Harrisonburg City,51660,440,1300,1740,685,3187,3872,60614,369969,430583,01/01/2019 12:00:00 AM,138,285,247
Northern,Harrisonburg City,51660,440,1436,1876,656,3281,3937,118301,564736,683037,07/01/2020 12:00:00 AM,269,393,364
Northern,Harrisonburg City,51660,440,1550,1990,677,3980,4657,60239,435472,495711,01/01/2017 12:00:00 AM,137,281,249
Northern,Harrisonburg City,51660,441,1317,1758,688,3261,3949,55964,360275,416239,03/01/2019 12:00:00 AM,127,274,237
Northern,Harrisonburg City,51660,441,1431,1872,666,3259,3925,118551,555304,673855,08/01/2020 12:00:00 AM,269,388,360
Northern,Harrisonburg City,51660,442,1320,1762,690,3249,3939,55364,357476,412840,04/01/2019 12:00:00 AM,125,271,234
Northern,Harrisonburg City,51660,444,1370,1814,699,3566,4265,63055,393611,456666,10/01/2017 12:00:00 AM,142,287,252
Northern,Harrisonburg City,51660,445,1407,1852,687,3670,4357,64370,411692,476062,06/01/2017 12:00:00 AM,145,293,257
Northern,Harrisonburg City,51660,445,1575,2020,693,4077,4770,59769,447781,507550,11/01/2016 12:00:00 AM,134,284,251
Northern,Harrisonburg City,51660,448,1560,2008,699,4020,4719,59587,439203,498790,12/01/2016 12:00:00 AM,133,282,248
Northern,Harrisonburg City,51660,448,1628,2076,728,4213,4941,66009,467723,533732,09/01/2016 12:00:00 AM,147,287,257
Northern,Harrisonburg City,51660,449,1306,1755,712,3257,3969,61485,361996,423481,11/01/2018 12:00:00 AM,137,277,241
Northern,Harrisonburg City,51660,449,1325,1774,701,3347,4048,58156,370612,428768,08/01/2018 12:00:00 AM,130,280,242
Northern,Harrisonburg City,51660,449,1619,2068,706,4193,4899,63353,466013,529366,10/01/2016 12:00:00 AM,141,288,256
Northern,Harrisonburg City,51660,450,1655,2105,733,4226,4959,66313,469273,535586,08/01/2016 12:00:00 AM,147,284,254
Northern,Harrisonburg City,51660,451,1313,1764,707,3304,4011,59091,365294,424385,07/01/2018 12:00:00 AM,131,278,241
Northern,Harrisonburg City,51660,452,1307,1759,720,3272,3992,60783,360325,421108,10/01/2018 12:00:00 AM,134,276,239
Northern,Harrisonburg City,51660,452,1378,1830,710,3604,4314,66352,399906,466258,07/01/2017 12:00:00 AM,147,290,255
Northern,Harrisonburg City,51660,453,1647,2100,735,4183,4918,67715,457404,525119,07/01/2016 12:00:00 AM,149,278,250
Northern,Harrisonburg City,51660,454,1325,1779,717,3355,4072,60167,373208,433375,09/01/2018 12:00:00 AM,133,282,244
Northern,Harrisonburg City,51660,454,1369,1823,708,3606,4314,66176,397504,463680,08/01/2017 12:00:00 AM,146,290,254
Northern,Harrisonburg City,51660,456,1366,1822,722,3546,4268,64876,388712,453588,11/01/2017 12:00:00 AM,142,285,249
Northern,Harrisonburg City,51660,457,1673,2130,734,4297,5031,66152,466517,532669,01/01/2016 12:00:00 AM,145,279,250
Northern,Harrisonburg City,51660,458,1673,2131,733,4231,4964,67224,459420,526644,06/01/2016 12:00:00 AM,147,275,247
Northern,Harrisonburg City,51660,458,1699,2157,739,4328,5067,67075,474437,541512,02/01/2016 12:00:00 AM,146,279,251
Northern,Harrisonburg City,51660,459,1661,2120,743,4188,4931,65980,452759,518739,04/01/2016 12:00:00 AM,144,273,245
Northern,Harrisonburg City,51660,460,1314,1774,745,3324,4069,63025,365680,428705,06/01/2018 12:00:00 AM,137,278,242
Northern,Harrisonburg City,51660,460,1752,2212,736,4447,5183,63290,495973,559263,10/01/2015 12:00:00 AM,138,283,253
Northern,Harrisonburg City,51660,462,1374,1836,734,3548,4282,64523,385032,449555,12/01/2017 12:00:00 AM,140,280,245
Northern,Harrisonburg City,51660,462,1684,2146,755,4292,5047,67472,464819,532291,03/01/2016 12:00:00 AM,146,276,248
Northern,Harrisonburg City,51660,463,1332,1795,761,3357,4118,65861,368438,434299,05/01/2018 12:00:00 AM,142,277,242
Northern,Harrisonburg City,51660,463,1370,1833,741,3498,4239,62813,382096,444909,02/01/2018 12:00:00 AM,136,279,243
Northern,Harrisonburg City,51660,463,1697,2160,737,4325,5062,64335,473541,537876,12/01/2015 12:00:00 AM,139,279,249
Northern,Harrisonburg City,51660,463,1751,2214,750,4425,5175,66400,492525,558925,09/01/2015 12:00:00 AM,143,281,252
Northern,Harrisonburg City,51660,464,1663,2127,749,4197,4946,66740,456287,523027,05/01/2016 12:00:00 AM,144,274,246
Northern,Harrisonburg City,51660,465,1843,2308,790,4500,5290,66427,508835,575262,01/01/2015 12:00:00 AM,143,276,249
Northern,Harrisonburg City,51660,465,1863,2328,789,4539,5328,65148,512440,577588,12/01/2014 12:00:00 AM,140,275,248
Northern,Harrisonburg City,51660,466,1714,2180,759,4381,5140,68634,482592,551226,11/01/2015 12:00:00 AM,147,282,253
Northern,Harrisonburg City,51660,467,1780,2247,760,4464,5224,66382,498147,564529,08/01/2015 12:00:00 AM,142,280,251
Northern,Harrisonburg City,51660,468,1380,1848,735,3509,4244,62568,385810,448378,01/01/2018 12:00:00 AM,134,280,243
Northern,Harrisonburg City,51660,469,1382,1851,751,3488,4239,65459,384227,449686,03/01/2018 12:00:00 AM,140,278,243
Northern,Harrisonburg City,51660,470,2115,2585,806,5010,5816,67789,559203,626992,05/01/2014 12:00:00 AM,144,264,243
Northern,Harrisonburg City,51660,471,1790,2261,799,4450,5249,71330,505883,577213,04/01/2015 12:00:00 AM,151,283,255
Northern,Harrisonburg City,51660,471,1818,2289,812,4482,5294,71477,512056,583533,02/01/2015 12:00:00 AM,152,282,255
Northern,Harrisonburg City,51660,472,1791,2263,822,4439,5261,74027,503888,577915,03/01/2015 12:00:00 AM,157,281,255
Northern,Harrisonburg City,51660,473,1799,2272,793,4487,5280,68944,510638,579582,05/01/2015 12:00:00 AM,146,284,255
Northern,Harrisonburg City,51660,473,2048,2521,837,4914,5751,73402,554092,627494,07/01/2014 12:00:00 AM,155,271,249
Northern,Harrisonburg City,51660,474,1358,1832,786,3415,4201,68188,377896,446084,04/01/2018 12:00:00 AM,144,278,243
Northern,Harrisonburg City,51660,474,2067,2541,819,4951,5770,69588,552460,622048,06/01/2014 12:00:00 AM,147,267,245
Northern,Harrisonburg City,51660,475,1891,2366,822,4625,5447,72630,533047,605677,10/01/2014 12:00:00 AM,153,282,256
Northern,Harrisonburg City,51660,476,1945,2421,818,4675,5493,70622,514727,585349,09/01/2014 12:00:00 AM,148,265,242
Northern,Harrisonburg City,51660,477,1806,2283,776,4503,5279,68515,509881,578396,07/01/2015 12:00:00 AM,144,282,253
Northern,Harrisonburg City,51660,477,2103,2580,812,4893,5705,72476,550496,622972,11/01/2013 12:00:00 AM,152,262,241
Northern,Harrisonburg City,51660,477,2106,2583,815,4906,5721,69937,546470,616407,12/01/2013 12:00:00 AM,147,259,239
Northern,Harrisonburg City,51660,478,1971,2449,820,4556,5376,76199,566333,642532,08/01/2012 12:00:00 AM,159,287,262
Northern,Harrisonburg City,51660,478,2002,2480,842,4814,5656,73145,540577,613722,08/01/2014 12:00:00 AM,153,270,247
Northern,Harrisonburg City,51660,478,2136,2614,835,5016,5851,71885,555200,627085,03/01/2014 12:00:00 AM,150,260,240
Northern,Harrisonburg City,51660,479,1841,2320,825,4515,5340,72092,513902,585994,11/01/2014 12:00:00 AM,151,279,253
Northern,Harrisonburg City,51660,479,2076,2555,819,4832,5651,81318,591420,672738,08/01/2013 12:00:00 AM,170,285,263
Northern,Harrisonburg City,51660,479,2110,2589,823,4987,5810,68961,557089,626050,04/01/2014 12:00:00 AM,144,264,242
Northern,Harrisonburg City,51660,480,2114,2594,829,4893,5722,81300,591947,673247,09/01/2013 12:00:00 AM,169,280,260
Northern,Harrisonburg City,51660,481,1789,2270,810,4472,5282,71646,509443,581089,06/01/2015 12:00:00 AM,149,285,256
Northern,Harrisonburg City,51660,484,2151,2635,831,5045,5876,70632,563941,634573,02/01/2014 12:00:00 AM,146,262,241
Northern,Harrisonburg City,51660,486,1967,2453,845,4583,5428,82816,568039,650855,09/01/2012 12:00:00 AM,170,289,265
Northern,Harrisonburg City,51660,487,1909,2396,865,4391,5256,84011,539876,623887,06/01/2012 12:00:00 AM,173,283,260
Northern,Harrisonburg City,51660,487,2137,2624,836,5006,5842,69419,558209,627628,01/01/2014 12:00:00 AM,143,261,239
Northern,Harrisonburg City,51660,489,2006,2495,857,4610,5467,88628,563423,652051,12/01/2012 12:00:00 AM,181,281,261
Northern,Harrisonburg City,51660,489,2050,2539,865,4688,5553,89665,582127,671792,02/01/2013 12:00:00 AM,183,284,265
Northern,Harrisonburg City,51660,490,1981,2471,866,4565,5431,87409,563992,651401,11/01/2012 12:00:00 AM,178,285,264
Northern,Harrisonburg City,51660,491,2025,2516,871,4611,5482,90960,569980,660940,03/01/2013 12:00:00 AM,185,281,263
Northern,Harrisonburg City,51660,493,2054,2547,879,4756,5635,86712,571535,658247,07/01/2013 12:00:00 AM,176,278,258
Northern,Harrisonburg City,51660,494,2037,2531,867,4654,5521,87904,570171,658075,01/01/2013 12:00:00 AM,178,280,260
Northern,Harrisonburg City,51660,495,2051,2546,894,4696,5590,94656,577202,671858,04/01/2013 12:00:00 AM,191,281,264
Northern,Harrisonburg City,51660,495,2122,2617,870,4910,5780,87554,594815,682369,10/01/2013 12:00:00 AM,177,280,261
Northern,Harrisonburg City,51660,496,1990,2486,872,4605,5477,89181,566996,656177,10/01/2012 12:00:00 AM,180,285,264
Northern,Harrisonburg City,51660,496,2076,2572,890,4798,5688,89642,586845,676487,06/01/2013 12:00:00 AM,181,283,263
Northern,Harrisonburg City,51660,498,1912,2410,901,4404,5305,87511,543834,631345,07/01/2012 12:00:00 AM,176,284,262
Northern,Harrisonburg City,51660,499,2079,2578,886,4792,5678,91866,586628,678494,05/01/2013 12:00:00 AM,184,282,263
Northern,Harrisonburg City,51660,504,1921,2425,909,4422,5331,91602,544878,636480,05/01/2012 12:00:00 AM,182,284,262
Northern,Harrisonburg City,51660,506,1947,2453,917,4469,5386,91261,555959,647220,03/01/2012 12:00:00 AM,180,286,264
Northern,Harrisonburg City,51660,507,1927,2434,918,4404,5322,90277,544440,634717,04/01/2012 12:00:00 AM,178,283,261
Northern,Harrisonburg City,51660,508,1967,2475,938,4472,5410,93025,555656,648681,02/01/2012 12:00:00 AM,183,282,262
Northern,Harrisonburg City,51660,508,1970,2478,957,4451,5408,94086,545265,639351,01/01/2012 12:00:00 AM,185,277,258
Northern,King George County,51099,100,1030,1130,144,2505,2649,15199,300739,315938,07/01/2015 12:00:00 AM,152,292,280
Northern,King George County,51099,100,1035,1135,146,2534,2680,16262,304454,320716,08/01/2015 12:00:00 AM,163,294,283
Northern,King George County,51099,100,1233,1333,200,2809,3009,21833,350259,372092,11/01/2013 12:00:00 AM,218,284,279
Northern,King George County,51099,100,1262,1362,188,2855,3043,19762,347088,366850,03/01/2014 12:00:00 AM,198,275,269
Northern,King George County,51099,100,829,929,149,1778,1927,32821,370224,403045,01/01/2021 12:00:00 AM,328,447,434
Northern,King George County,51099,101,1126,1227,180,2636,2816,19917,330385,350302,10/01/2014 12:00:00 AM,197,293,285
Northern,King George County,51099,101,1206,1307,192,2743,2935,24825,377013,401838,12/01/2012 12:00:00 AM,246,313,307
Northern,King George County,51099,101,1258,1359,204,2880,3084,21544,356312,377856,12/01/2013 12:00:00 AM,213,283,278
Northern,King George County,51099,101,1272,1373,199,2908,3107,23977,391036,415013,09/01/2013 12:00:00 AM,237,307,302
Northern,King George County,51099,101,844,945,158,1813,1971,29871,326118,355989,10/01/2020 12:00:00 AM,296,386,377
Northern,King George County,51099,101,848,949,160,1763,1923,36596,403419,440015,06/01/2021 12:00:00 AM,362,476,464
Northern,King George County,51099,102,1113,1215,177,2626,2803,18960,330706,349666,11/01/2014 12:00:00 AM,186,297,288
Northern,King George County,51099,102,841,943,156,1824,1980,29631,330462,360093,12/01/2020 12:00:00 AM,291,393,382
Northern,King George County,51099,102,979,1081,174,2361,2535,19848,282835,302683,04/01/2016 12:00:00 AM,195,289,280
Northern,King George County,51099,103,1032,1135,153,2480,2633,16288,297997,314285,06/01/2015 12:00:00 AM,158,289,277
Northern,King George County,51099,103,1258,1361,215,2846,3061,24979,384920,409899,06/01/2013 12:00:00 AM,243,306,301
Northern,King George County,51099,103,1260,1363,215,2858,3073,26963,381872,408835,08/01/2013 12:00:00 AM,262,303,300
Northern,King George County,51099,103,822,925,159,1763,1922,30115,321415,351530,11/01/2020 12:00:00 AM,292,391,380
Northern,King George County,51099,103,853,956,159,1807,1966,36009,411205,447214,04/01/2021 12:00:00 AM,350,482,468
Northern,King George County,51099,103,862,965,152,1826,1978,33777,384263,418040,03/01/2021 12:00:00 AM,328,446,433
Northern,King George County,51099,103,989,1092,175,2386,2561,19952,283269,303221,03/01/2016 12:00:00 AM,194,286,278
Northern,King George County,51099,104,1049,1153,173,2526,2699,18484,307423,325907,04/01/2015 12:00:00 AM,178,293,283
Northern,King George County,51099,104,1237,1341,204,2799,3003,26421,379621,406042,01/01/2013 12:00:00 AM,254,307,303
Northern,King George County,51099,104,1260,1364,218,2853,3071,25983,380399,406382,07/01/2013 12:00:00 AM,250,302,298
Northern,King George County,51099,104,844,948,149,1823,1972,33088,383312,416400,02/01/2021 12:00:00 AM,318,454,439
Northern,King George County,51099,105,1048,1153,166,2520,2686,18077,306780,324857,05/01/2015 12:00:00 AM,172,293,282
Northern,King George County,51099,105,1260,1365,211,2845,3056,25486,387543,413029,05/01/2013 12:00:00 AM,243,308,303
Northern,King George County,51099,105,1261,1366,203,2869,3072,21699,352133,373832,02/01/2014 12:00:00 AM,207,279,274
Northern,King George County,51099,105,854,959,165,1790,1955,38128,409365,447493,05/01/2021 12:00:00 AM,363,479,467
Northern,King George County,51099,105,986,1091,182,2394,2576,21304,284204,305508,01/01/2016 12:00:00 AM,203,288,280
Northern,King George County,51099,106,1090,1196,180,2602,2782,19231,325536,344767,12/01/2014 12:00:00 AM,181,299,288
Northern,King George County,51099,106,1214,1320,201,2779,2980,26044,378414,404458,02/01/2013 12:00:00 AM,246,312,306
Northern,King George County,51099,106,1250,1356,213,2855,3068,22640,350043,372683,01/01/2014 12:00:00 AM,214,280,275
Northern,King George County,51099,106,979,1085,187,2378,2565,21685,283812,305497,02/01/2016 12:00:00 AM,205,290,282
Northern,King George County,51099,106,989,1095,176,2426,2602,19671,291618,311289,10/01/2015 12:00:00 AM,186,295,284
Northern,King George County,51099,108,1218,1326,212,2795,3007,27885,376195,404080,03/01/2013 12:00:00 AM,258,309,305
Northern,King George County,51099,108,987,1095,185,2411,2596,21808,288211,310019,11/01/2015 12:00:00 AM,202,292,283
Northern,King George County,51099,109,1092,1201,184,2593,2777,18548,320775,339323,01/01/2015 12:00:00 AM,170,294,283
Northern,King George County,51099,110,993,1103,189,2421,2610,21931,289668,311599,12/01/2015 12:00:00 AM,199,292,283
Northern,King George County,51099,111,1061,1172,181,2547,2728,18728,309437,328165,03/01/2015 12:00:00 AM,169,292,280
Northern,King George County,51099,112,1240,1352,226,2807,3033,29576,382918,412494,04/01/2013 12:00:00 AM,264,309,305
Northern,King George County,51099,114,1061,1175,190,2551,2741,19858,312131,331989,02/01/2015 12:00:00 AM,174,294,283
Northern,King George County,51099,84,734,818,131,1650,1781,15210,192434,207644,11/01/2019 12:00:00 AM,181,262,254
Northern,King George County,51099,84,746,830,136,1703,1839,15477,206768,222245,09/01/2019 12:00:00 AM,184,277,268
Northern,King George County,51099,85,755,840,131,1693,1824,15714,199194,214908,12/01/2019 12:00:00 AM,185,264,256
Northern,King George County,51099,86,722,808,142,1608,1750,16568,183346,199914,01/01/2020 12:00:00 AM,193,254,247
Northern,King George County,51099,86,749,835,135,1678,1813,24157,284134,308291,03/01/2020 12:00:00 AM,281,379,369
Northern,King George County,51099,86,752,838,136,1748,1884,15940,214123,230063,10/01/2018 12:00:00 AM,185,285,275
Northern,King George County,51099,86,754,840,132,1708,1840,15098,202527,217625,08/01/2019 12:00:00 AM,176,269,259
Northern,King George County,51099,87,740,827,139,1678,1817,15349,204173,219522,10/01/2019 12:00:00 AM,176,276,265
Northern,King George County,51099,88,777,865,139,1884,2023,14827,223121,237948,06/01/2018 12:00:00 AM,168,287,275
Northern,King George County,51099,88,798,886,136,1936,2072,15754,235924,251678,05/01/2018 12:00:00 AM,179,296,284
Northern,King George County,51099,88,807,895,139,1936,2075,15543,232822,248365,04/01/2018 12:00:00 AM,177,289,278
Northern,King George County,51099,89,1191,1280,154,2774,2928,19412,378813,398225,07/01/2012 12:00:00 AM,218,318,311
Northern,King George County,51099,89,724,813,144,1596,1740,16385,183336,199721,02/01/2020 12:00:00 AM,184,253,246
Northern,King George County,51099,89,760,849,146,1816,1962,15958,215381,231339,08/01/2018 12:00:00 AM,179,283,272
Northern,King George County,51099,89,767,856,133,1717,1850,15159,204897,220056,06/01/2019 12:00:00 AM,170,267,257
Northern,King George County,51099,90,754,844,136,1706,1842,16523,203496,220019,05/01/2019 12:00:00 AM,184,270,261
Northern,King George County,51099,90,762,852,140,1729,1869,16005,207433,223438,07/01/2019 12:00:00 AM,178,272,262
Northern,King George County,51099,90,767,857,146,1789,1935,16912,215942,232854,12/01/2018 12:00:00 AM,188,282,272
Northern,King George County,51099,90,915,1005,141,2179,2320,16518,260795,277313,11/01/2016 12:00:00 AM,184,285,276
Northern,King George County,51099,91,1208,1299,163,2771,2934,20958,378325,399283,09/01/2012 12:00:00 AM,230,313,307
Northern,King George County,51099,91,1210,1301,161,2776,2937,20873,376706,397579,08/01/2012 12:00:00 AM,229,311,306
Northern,King George County,51099,91,748,839,142,1764,1906,16963,214304,231267,09/01/2018 12:00:00 AM,186,287,276
Northern,King George County,51099,91,768,859,143,1797,1940,16481,215857,232338,11/01/2018 12:00:00 AM,181,281,270
Northern,King George County,51099,91,770,861,150,1857,2007,16248,222856,239104,07/01/2018 12:00:00 AM,179,289,278
Northern,King George County,51099,91,802,893,134,1778,1912,23597,306962,330559,04/01/2020 12:00:00 AM,259,383,370
Northern,King George County,51099,91,815,906,144,1948,2092,14696,234352,249048,03/01/2018 12:00:00 AM,161,288,275
Northern,King George County,51099,91,869,960,138,2061,2199,15751,252809,268560,04/01/2017 12:00:00 AM,173,291,280
Northern,King George County,51099,91,903,994,139,2162,2301,16041,257528,273569,12/01/2016 12:00:00 AM,176,285,275
Northern,King George County,51099,91,921,1012,137,2170,2307,15437,265248,280685,02/01/2017 12:00:00 AM,170,288,277
Northern,King George County,51099,92,755,847,146,1707,1853,17453,206799,224252,04/01/2019 12:00:00 AM,190,274,265
Northern,King George County,51099,92,763,855,141,1773,1914,16153,223833,239986,01/01/2019 12:00:00 AM,176,293,281
Northern,King George County,51099,92,817,909,140,1955,2095,13780,236648,250428,02/01/2018 12:00:00 AM,150,290,275
Northern,King George County,51099,92,820,912,147,1976,2123,15941,243839,259780,11/01/2017 12:00:00 AM,173,297,285
Northern,King George County,51099,93,729,822,149,1679,1828,17544,198325,215869,02/01/2019 12:00:00 AM,189,272,263
Northern,King George County,51099,93,818,911,145,1940,2085,14695,235592,250287,12/01/2017 12:00:00 AM,158,288,275
Northern,King George County,51099,93,834,927,138,1843,1981,25184,315872,341056,05/01/2020 12:00:00 AM,271,379,368
Northern,King George County,51099,93,836,929,152,1988,2140,17410,240547,257957,10/01/2017 12:00:00 AM,187,288,278
Northern,King George County,51099,93,911,1004,144,2170,2314,16766,255874,272640,10/01/2016 12:00:00 AM,180,281,272
Northern,King George County,51099,94,1197,1291,164,2792,2956,20996,379123,400119,06/01/2012 12:00:00 AM,223,317,310
Northern,King George County,51099,94,806,900,146,1924,2070,14215,231832,246047,01/01/2018 12:00:00 AM,151,288,273
Northern,King George County,51099,94,834,928,152,1970,2122,17246,239364,256610,09/01/2017 12:00:00 AM,183,287,277
Northern,King George County,51099,94,900,994,140,2129,2269,16268,262498,278766,03/01/2017 12:00:00 AM,173,292,280
Northern,King George County,51099,95,1145,1240,161,2681,2842,20762,360663,381425,01/01/2012 12:00:00 AM,219,315,308
Northern,King George County,51099,95,1151,1246,162,2696,2858,17509,329943,347452,08/01/2014 12:00:00 AM,184,287,279
Northern,King George County,51099,95,775,870,156,1758,1914,18211,212583,230794,03/01/2019 12:00:00 AM,192,274,265
Northern,King George County,51099,96,1149,1245,174,2659,2833,22475,358802,381277,02/01/2012 12:00:00 AM,234,312,306
Northern,King George County,51099,96,1156,1252,168,2696,2864,21065,363701,384766,03/01/2012 12:00:00 AM,219,315,307
Northern,King George County,51099,96,1181,1277,161,2755,2916,20465,373502,393967,05/01/2012 12:00:00 AM,213,316,309
Northern,King George County,51099,96,830,926,151,1997,2148,17157,244314,261471,07/01/2017 12:00:00 AM,179,294,282
Northern,King George County,51099,96,845,941,155,2037,2192,17423,250905,268328,08/01/2017 12:00:00 AM,181,297,285
Northern,King George County,51099,96,850,946,143,1868,2011,25870,322258,348128,06/01/2020 12:00:00 AM,269,379,368
Northern,King George County,51099,96,869,965,143,2073,2216,16552,251986,268538,05/01/2017 12:00:00 AM,172,290,278
Northern,King George County,51099,96,922,1018,146,2197,2343,16971,263295,280266,01/01/2017 12:00:00 AM,177,286,275
Northern,King George County,51099,97,1173,1270,167,2748,2915,18008,332661,350669,07/01/2014 12:00:00 AM,186,284,276
Northern,King George County,51099,97,1211,1308,177,2820,2997,19682,345837,365519,06/01/2014 12:00:00 AM,203,286,279
Northern,King George County,51099,97,848,945,153,2025,2178,17357,249317,266674,06/01/2017 12:00:00 AM,179,294,282
Northern,King George County,51099,97,872,969,150,1877,2027,26360,323460,349820,09/01/2020 12:00:00 AM,272,371,361
Northern,King George County,51099,97,888,985,149,1939,2088,27638,331622,359260,08/01/2020 12:00:00 AM,285,373,365
Northern,King George County,51099,97,915,1012,160,2191,2351,18152,256222,274374,08/01/2016 12:00:00 AM,187,280,271
Northern,King George County,51099,98,1030,1128,145,2501,2646,16143,300782,316925,09/01/2015 12:00:00 AM,165,292,281
Northern,King George County,51099,98,1147,1245,165,2686,2851,17503,325696,343199,09/01/2014 12:00:00 AM,179,284,276
Northern,King George County,51099,98,1218,1316,185,2772,2957,24256,378867,403123,11/01/2012 12:00:00 AM,248,311,306
Northern,King George County,51099,98,875,973,151,1922,2073,27018,328334,355352,07/01/2020 12:00:00 AM,276,375,365
Northern,King George County,51099,98,941,1039,163,2264,2427,18058,266452,284510,06/01/2016 12:00:00 AM,184,283,274
Northern,King George County,51099,99,1178,1277,170,2738,2908,21682,367065,388747,04/01/2012 12:00:00 AM,219,312,304
Northern,King George County,51099,99,1208,1307,187,2762,2949,24686,376687,401373,10/01/2012 12:00:00 AM,249,312,307
Northern,King George County,51099,99,1245,1344,185,2896,3081,19788,353587,373375,05/01/2014 12:00:00 AM,200,284,278
Northern,King George County,51099,99,1261,1360,183,2895,3078,18688,353518,372206,04/01/2014 12:00:00 AM,189,280,274
Northern,King George County,51099,99,1264,1363,197,2877,3074,22965,387281,410246,10/01/2013 12:00:00 AM,232,306,301
Northern,King George County,51099,99,908,1007,164,2163,2327,18716,253389,272105,09/01/2016 12:00:00 AM,189,279,270
Northern,King George County,51099,99,926,1025,166,2199,2365,18937,255361,274298,07/01/2016 12:00:00 AM,191,276,268
Northern,King George County,51099,99,969,1068,165,2323,2488,18641,277801,296442,05/01/2016 12:00:00 AM,188,287,278
Northern,Loudoun County,51107,706,3496,4202,1106,8130,9236,116547,1014341,1130888,06/01/2015 12:00:00 AM,165,290,269
Northern,Loudoun County,51107,707,3606,4313,1088,8366,9454,112138,1040504,1152642,09/01/2015 12:00:00 AM,159,289,267
Northern,Loudoun County,51107,709,3510,4219,1092,8191,9283,113661,1010999,1124660,07/01/2015 12:00:00 AM,160,288,267
Northern,Loudoun County,51107,716,3511,4227,1107,8225,9332,116387,1020277,1136664,08/01/2015 12:00:00 AM,163,291,269
Northern,Loudoun County,51107,718,3520,4238,1129,8146,9275,119198,1015993,1135191,04/01/2015 12:00:00 AM,166,289,268
Northern,Loudoun County,51107,720,3499,4219,1134,8111,9245,120496,1008277,1128773,05/01/2015 12:00:00 AM,167,288,268
Northern,Loudoun County,51107,721,3821,4542,1190,8574,9764,119431,1053772,1173203,06/01/2014 12:00:00 AM,166,276,258
Northern,Loudoun County,51107,726,3820,4546,1169,8604,9773,114893,1054548,1169441,04/01/2014 12:00:00 AM,158,276,257
Northern,Loudoun County,51107,728,3581,4309,1099,8388,9487,111197,1040485,1151682,07/01/2016 12:00:00 AM,153,291,267
Northern,Loudoun County,51107,732,3566,4298,1189,8239,9428,127146,1027553,1154699,03/01/2015 12:00:00 AM,174,288,269
Northern,Loudoun County,51107,732,3780,4512,1188,8507,9695,119610,1039574,1159184,05/01/2014 12:00:00 AM,163,275,257
Northern,Loudoun County,51107,734,3564,4298,1128,8327,9455,118042,1036070,1154112,03/01/2016 12:00:00 AM,161,291,269
Northern,Loudoun County,51107,734,3602,4336,1123,8414,9537,117146,1050986,1168132,08/01/2016 12:00:00 AM,160,292,269
Northern,Loudoun County,51107,734,3610,4344,1136,8367,9503,117761,1039429,1157190,10/01/2015 12:00:00 AM,160,288,266
Northern,Loudoun County,51107,735,3582,4317,1127,8345,9472,114235,1039627,1153862,05/01/2016 12:00:00 AM,155,290,267
Northern,Loudoun County,51107,735,3614,4349,1146,8358,9504,116502,1043854,1160356,11/01/2015 12:00:00 AM,159,289,267
Northern,Loudoun County,51107,736,3596,4332,1140,8366,9506,120584,1044162,1164746,12/01/2015 12:00:00 AM,164,290,269
Northern,Loudoun County,51107,736,3668,4404,1215,8294,9509,125132,1008985,1134117,09/01/2014 12:00:00 AM,170,275,258
Northern,Loudoun County,51107,737,3780,4517,1184,8518,9702,117672,1035544,1153216,07/01/2014 12:00:00 AM,160,274,255
Northern,Loudoun County,51107,740,3667,4407,1224,8363,9587,131781,1057308,1189089,11/01/2014 12:00:00 AM,178,288,270
Northern,Loudoun County,51107,741,3549,4290,1141,8268,9409,121121,1031456,1152577,02/01/2016 12:00:00 AM,163,291,269
Northern,Loudoun County,51107,741,3560,4301,1146,8277,9423,120957,1031253,1152210,01/01/2016 12:00:00 AM,163,290,268
Northern,Loudoun County,51107,741,3734,4475,1216,8444,9660,124939,1024678,1149617,08/01/2014 12:00:00 AM,169,274,257
Northern,Loudoun County,51107,742,3607,4349,1130,8468,9598,114159,1055069,1169228,06/01/2016 12:00:00 AM,154,293,269
Northern,Loudoun County,51107,743,3554,4297,1137,8326,9463,115703,1037460,1153163,04/01/2016 12:00:00 AM,156,292,268
Northern,Loudoun County,51107,744,3531,4275,1214,8139,9353,128564,1024665,1153229,02/01/2015 12:00:00 AM,173,290,270
Northern,Loudoun County,51107,745,3656,4401,1232,8362,9594,132686,1062106,1194792,12/01/2014 12:00:00 AM,178,291,271
Northern,Loudoun County,51107,745,3761,4506,1207,8444,9651,120898,1035318,1156216,03/01/2014 12:00:00 AM,162,275,257
Northern,Loudoun County,51107,748,3604,4352,1219,8266,9485,129477,1026630,1156107,01/01/2015 12:00:00 AM,173,285,266
Northern,Loudoun County,51107,748,3609,4357,1134,8507,9641,118935,1053020,1171955,09/01/2016 12:00:00 AM,159,292,269
Northern,Loudoun County,51107,753,3634,4387,1276,8235,9511,137936,1042716,1180652,10/01/2014 12:00:00 AM,183,287,269
Northern,Loudoun County,51107,756,3789,4545,1219,8511,9730,120840,1036715,1157555,02/01/2014 12:00:00 AM,160,274,255
Northern,Loudoun County,51107,760,3827,4587,1233,8611,9844,122571,1028653,1151224,01/01/2014 12:00:00 AM,161,269,251
Northern,Loudoun County,51107,761,3806,4567,1227,8546,9773,123998,1035186,1159184,12/01/2013 12:00:00 AM,163,272,254
Northern,Loudoun County,51107,767,3820,4587,1227,8549,9776,124817,1033812,1158629,11/01/2013 12:00:00 AM,163,271,253
Northern,Loudoun County,51107,769,3571,4340,1149,8444,9593,117221,1057303,1174524,10/01/2016 12:00:00 AM,152,296,271
Northern,Loudoun County,51107,772,3434,4206,1250,7848,9098,139220,1023922,1163142,02/01/2012 12:00:00 AM,180,298,277
Northern,Loudoun County,51107,773,3391,4164,1264,7748,9012,142762,1012686,1155448,01/01/2012 12:00:00 AM,185,299,277
Northern,Loudoun County,51107,778,3476,4254,1256,7963,9219,136770,1047061,1183831,04/01/2012 12:00:00 AM,176,301,278
Northern,Loudoun County,51107,789,3473,4262,1298,7927,9225,143856,1037553,1181409,03/01/2012 12:00:00 AM,182,299,277
Northern,Loudoun County,51107,789,3563,4352,1136,8414,9550,116606,1048428,1165034,11/01/2016 12:00:00 AM,148,294,268
Northern,Loudoun County,51107,789,3867,4656,1286,8630,9916,143763,1125452,1269215,10/01/2013 12:00:00 AM,182,291,273
Northern,Loudoun County,51107,790,3609,4399,1290,8093,9383,146621,1057063,1203684,01/01/2013 12:00:00 AM,186,293,274
Northern,Loudoun County,51107,790,3615,4405,1273,8112,9385,144126,1067111,1211237,02/01/2013 12:00:00 AM,182,295,275
Northern,Loudoun County,51107,792,3465,4257,1296,7790,9086,143228,1027201,1170429,09/01/2012 12:00:00 AM,181,296,275
Northern,Loudoun County,51107,792,3482,4274,1279,7873,9152,142117,1030953,1173070,06/01/2012 12:00:00 AM,179,296,274
Northern,Loudoun County,51107,792,3526,4318,1267,7909,9176,142867,1043703,1186570,10/01/2012 12:00:00 AM,180,296,275
Northern,Loudoun County,51107,794,3667,4461,1281,8177,9458,144270,1064623,1208893,03/01/2013 12:00:00 AM,182,290,271
Northern,Loudoun County,51107,794,3891,4685,1287,8678,9965,141329,1123964,1265293,09/01/2013 12:00:00 AM,178,289,270
Northern,Loudoun County,51107,799,3466,4265,1116,8135,9251,114811,1017040,1131851,03/01/2017 12:00:00 AM,144,293,265
Northern,Loudoun County,51107,800,3482,4282,1302,7933,9235,144369,1041911,1186280,05/01/2012 12:00:00 AM,180,299,277
Northern,Loudoun County,51107,802,3374,4176,1112,7878,8990,115175,982539,1097714,04/01/2017 12:00:00 AM,144,291,263
Northern,Loudoun County,51107,803,3564,4367,1155,8424,9579,118436,1048724,1167160,12/01/2016 12:00:00 AM,147,294,267
Northern,Loudoun County,51107,805,3456,4261,1305,7814,9119,143829,1026728,1170557,07/01/2012 12:00:00 AM,179,297,275
Northern,Loudoun County,51107,805,3547,4352,1321,7904,9225,152582,1042738,1195320,12/01/2012 12:00:00 AM,190,294,275
Northern,Loudoun County,51107,808,3799,4607,1336,8437,9773,148060,1093017,1241077,08/01/2013 12:00:00 AM,183,288,269
Northern,Loudoun County,51107,811,3550,4361,1312,7955,9267,150601,1047949,1198550,11/01/2012 12:00:00 AM,186,295,275
Northern,Loudoun County,51107,812,3482,4294,1332,7857,9189,148641,1030535,1179176,08/01/2012 12:00:00 AM,183,296,275
Northern,Loudoun County,51107,812,3548,4360,1170,8340,9510,117672,1031881,1149553,01/01/2017 12:00:00 AM,145,291,264
Northern,Loudoun County,51107,812,3727,4539,1299,8324,9623,148123,1085784,1233907,04/01/2013 12:00:00 AM,182,291,272
Northern,Loudoun County,51107,816,3756,4572,1332,8362,9694,152102,1090355,1242457,05/01/2013 12:00:00 AM,186,290,272
Northern,Loudoun County,51107,817,3376,4193,1148,7911,9059,117610,1005334,1122944,05/01/2017 12:00:00 AM,144,298,268
Northern,Loudoun County,51107,817,3744,4561,1340,8333,9673,150753,1094186,1244939,06/01/2013 12:00:00 AM,185,292,273
Northern,Loudoun County,51107,819,3771,4590,1336,8329,9665,150702,1087539,1238241,07/01/2013 12:00:00 AM,184,288,270
Northern,Loudoun County,51107,821,3575,4396,1163,8353,9516,118516,1038012.76,1156528.76,02/01/2017 12:00:00 AM,144,290,263
Northern,Loudoun County,51107,831,3329,4160,1166,7776,8942,120964,980715,1101679,07/01/2017 12:00:00 AM,146,295,265
Northern,Loudoun County,51107,832,3334,4166,1163,7778,8941,117772,982907,1100679,06/01/2017 12:00:00 AM,142,295,264
Northern,Loudoun County,51107,841,3375,4216,1192,7890,9082,123083,990868,1113951,09/01/2017 12:00:00 AM,146,294,264
Northern,Loudoun County,51107,846,3355,4201,1192,7825,9017,122167,988702,1110869,08/01/2017 12:00:00 AM,144,295,264
Northern,Loudoun County,51107,854,3366,4220,1222,7798,9020,124806,973430,1098236,10/01/2017 12:00:00 AM,146,289,260
Northern,Loudoun County,51107,855,3403,4258,1236,7889,9125,127330,983386,1110716,11/01/2017 12:00:00 AM,149,289,261
Northern,Loudoun County,51107,859,3100,3959,1150,7174,8324,118121,879378,997499,11/01/2019 12:00:00 AM,138,284,252
Northern,Loudoun County,51107,859,3146,4005,1204,7234,8438,119737,893493,1013230,08/01/2019 12:00:00 AM,139,284,253
Northern,Loudoun County,51107,864,3111,3975,1182,7184,8366,119173,875443,994616,10/01/2019 12:00:00 AM,138,281,250
Northern,Loudoun County,51107,868,3164,4032,1212,7266,8478,120752,896677.44,1017429.44,09/01/2019 12:00:00 AM,139,283,252
Northern,Loudoun County,51107,870,3135,4005,1205,7258,8463,123667,923158,1046825,12/01/2018 12:00:00 AM,142,294,261
Northern,Loudoun County,51107,870,3190,4060,1253,7394,8647,121531,920174,1041705,07/01/2018 12:00:00 AM,140,288,257
Northern,Loudoun County,51107,871,3106,3977,1170,7168,8338,121486,883420,1004906,12/01/2019 12:00:00 AM,139,284,253
Northern,Loudoun County,51107,871,3150,4021,1200,7328,8528,124336,931655,1055991,11/01/2018 12:00:00 AM,143,296,263
Northern,Loudoun County,51107,871,3154,4025,1203,7256,8459,119661,902360,1022021,06/01/2019 12:00:00 AM,137,286,254
Northern,Loudoun County,51107,873,3161,4034,1224,7319,8543,123094,929588,1052682,10/01/2018 12:00:00 AM,141,294,261
Northern,Loudoun County,51107,874,2978,3852,1227,6841,8068,122064,851468,973532,02/01/2019 12:00:00 AM,140,286,253
Northern,Loudoun County,51107,874,3149,4023,1212,7247,8459,120165,896888,1017053,07/01/2019 12:00:00 AM,137,285,253
Northern,Loudoun County,51107,876,3234,4110,1250,7453,8703,122707,936724,1059431,06/01/2018 12:00:00 AM,140,290,258
Northern,Loudoun County,51107,876,3396,4272,1254,7880,9134,130879,976261,1107140,12/01/2017 12:00:00 AM,149,287,259
Northern,Loudoun County,51107,876,3405,4281,1264,7928,9192,126874,983764,1110638,01/01/2018 12:00:00 AM,145,289,259
Northern,Loudoun County,51107,878,3142,4020,1240,7251,8491,125001,947980,1072981,01/01/2019 12:00:00 AM,142,302,267
Northern,Loudoun County,51107,878,3174,4052,1213,7381,8594,118849,930734,1049583,09/01/2018 12:00:00 AM,135,293,259
Northern,Loudoun County,51107,879,3327,4206,1270,7586,8856,125423,950996,1076419,03/01/2018 12:00:00 AM,143,286,256
Northern,Loudoun County,51107,883,3233,4116,1243,7530,8773,120978,951014,1071992,08/01/2018 12:00:00 AM,137,294,260
Northern,Loudoun County,51107,884,3053,3937,1184,6992,8176,119493,851627,971120,01/01/2020 12:00:00 AM,135,279,247
Northern,Loudoun County,51107,884,3272,4156,1277,7552,8829,124744,948245,1072989,05/01/2018 12:00:00 AM,141,290,258
Northern,Loudoun County,51107,885,3318,4203,1283,7647,8930,126834,962198.32,1089032.32,04/01/2018 12:00:00 AM,143,290,259
Northern,Loudoun County,51107,886,3370,4256,1279,7778,9057,129057,969182,1098239,02/01/2018 12:00:00 AM,146,288,258
Northern,Loudoun County,51107,887,3158,4045,1229,7239,8468,121867,899726,1021593,05/01/2019 12:00:00 AM,137,285,253
Northern,Loudoun County,51107,892,3113,4005,1252,7160,8412,122960,890297,1013257,04/01/2019 12:00:00 AM,138,286,253
Northern,Loudoun County,51107,897,3131,4028,1258,7219,8477,126251,902536,1028787,03/01/2019 12:00:00 AM,141,288,255
Northern,Loudoun County,51107,905,3065,3970,1222,7038,8260,124075,869937,994012,02/01/2020 12:00:00 AM,137,284,250
Northern,Loudoun County,51107,913,3179,4092,1218,7294,8512,225647,1249333,1474980,03/01/2020 12:00:00 AM,247,393,360
Northern,Loudoun County,51107,941,3935,4876,1184,9157,10341,270741,1934820,2205561,02/01/2021 12:00:00 AM,288,492,452
Northern,Loudoun County,51107,942,3706,4648,1278,8547,9825,234254,1479831,1714085,04/01/2020 12:00:00 AM,249,399,369
Northern,Loudoun County,51107,957,3840,4797,1290,8870,10160,286252,1828083,2114335,01/01/2021 12:00:00 AM,299,476,441
Northern,Loudoun County,51107,960,3856,4816,1295,8952,10247,250200,1612541,1862741,12/01/2020 12:00:00 AM,261,418,387
Northern,Loudoun County,51107,967,3846,4813,1310,8901,10211,253265,1608165,1861430,10/01/2020 12:00:00 AM,262,418,387
Northern,Loudoun County,51107,968,3785,4753,1292,8635,9927,304961,1953940,2258901,05/01/2021 12:00:00 AM,315,516,475
Northern,Loudoun County,51107,968,3887,4855,1260,8979,10239,284280,1855113,2139393,03/01/2021 12:00:00 AM,294,477,441
Northern,Loudoun County,51107,971,3817,4788,1321,8875,10196,258502,1637494,1895996,11/01/2020 12:00:00 AM,266,429,396
Northern,Loudoun County,51107,974,3831,4805,1356,8819,10175,252067,1518614,1770681,05/01/2020 12:00:00 AM,259,396,369
Northern,Loudoun County,51107,978,3803,4781,1285,8683,9968,299751,1972937,2272688,04/01/2021 12:00:00 AM,306,519,475
Northern,Loudoun County,51107,986,3867,4853,1388,8839,10227,255560,1527149,1782709,06/01/2020 12:00:00 AM,259,395,367
Northern,Loudoun County,51107,989,3959,4948,1373,9148,10521,250546,1573807,1824353,09/01/2020 12:00:00 AM,253,398,369
Northern,Loudoun County,51107,991,3780,4771,1340,8605,9945,314417,1953637,2268054,06/01/2021 12:00:00 AM,317,517,475
Northern,Loudoun County,51107,994,3958,4952,1398,9096,10494,255811,1552775,1808586,08/01/2020 12:00:00 AM,257,392,365
Northern,Loudoun County,51107,998,3913,4911,1404,8974,10378,257402,1533505,1790907,07/01/2020 12:00:00 AM,258,392,365
Northern,Louisa County,51109,219,1278,1497,269,2839,3108,22974,322443,345417,09/01/2019 12:00:00 AM,105,252,231
Northern,Louisa County,51109,219,1283,1502,265,2874,3139,23599,328598,352197,08/01/2019 12:00:00 AM,108,256,234
Northern,Louisa County,51109,221,1272,1493,276,2840,3116,24420,318490,342910,11/01/2019 12:00:00 AM,110,250,230
Northern,Louisa County,51109,225,1282,1507,283,2856,3139,26013,327370,353383,10/01/2019 12:00:00 AM,116,255,234
Northern,Louisa County,51109,226,1284,1510,281,2792,3073,24005,320564,344569,01/01/2020 12:00:00 AM,106,250,228
Northern,Louisa County,51109,228,1273,1501,288,2792,3080,24919,318951,343870,02/01/2020 12:00:00 AM,109,251,229
Northern,Louisa County,51109,228,1278,1506,276,2845,3121,24653,321400,346053,07/01/2019 12:00:00 AM,108,251,230
Northern,Louisa County,51109,228,1288,1516,287,2835,3122,25887,320062,345949,12/01/2019 12:00:00 AM,114,248,228
Northern,Louisa County,51109,233,1281,1514,287,2851,3138,25337,323087,348424,05/01/2019 12:00:00 AM,109,252,230
Northern,Louisa County,51109,233,1283,1516,304,2817,3121,55141,484087,539228,03/01/2020 12:00:00 AM,237,377,356
Northern,Louisa County,51109,235,1286,1521,289,2866,3155,25092,321709,346801,04/01/2019 12:00:00 AM,107,250,228
Northern,Louisa County,51109,237,1272,1509,290,2849,3139,25748,321787,347535,06/01/2019 12:00:00 AM,109,253,230
Northern,Louisa County,51109,237,1278,1515,298,2862,3160,26421,324263,350684,03/01/2019 12:00:00 AM,111,254,231
Northern,Louisa County,51109,238,1266,1504,295,2835,3130,26021,324714,350735,02/01/2019 12:00:00 AM,109,256,233
Northern,Louisa County,51109,240,1306,1546,303,2944,3247,28182,337678,365860,11/01/2018 12:00:00 AM,117,259,237
Northern,Louisa County,51109,241,1327,1568,298,2986,3284,27764,344495,372259,12/01/2018 12:00:00 AM,115,260,237
Northern,Louisa County,51109,244,1282,1526,305,2893,3198,27767,333545,361312,10/01/2018 12:00:00 AM,114,260,237
Northern,Louisa County,51109,244,1294,1538,312,2919,3231,28896,344743,373639,01/01/2019 12:00:00 AM,118,266,243
Northern,Louisa County,51109,244,1297,1541,301,2940,3241,27220,342747,369967,08/01/2018 12:00:00 AM,112,264,240
Northern,Louisa County,51109,245,1286,1531,302,2928,3230,26829,341377,368206,07/01/2018 12:00:00 AM,110,265,241
Northern,Louisa County,51109,245,1380,1625,321,2986,3307,59163,513426,572589,04/01/2020 12:00:00 AM,241,372,352
Northern,Louisa County,51109,246,1303,1549,304,2936,3240,27310,342138,369448,09/01/2018 12:00:00 AM,111,263,239
Northern,Louisa County,51109,252,1425,1677,330,3082,3412,61107,534751,595858,05/01/2020 12:00:00 AM,242,375,355
Northern,Louisa County,51109,253,1460,1713,332,3151,3483,60810,544802,605612,06/01/2020 12:00:00 AM,240,373,354
Northern,Louisa County,51109,255,1427,1682,314,3065,3379,74980,692461,767441,05/01/2021 12:00:00 AM,294,485,456
Northern,Louisa County,51109,256,1342,1598,328,3046,3374,30098,351423,381521,04/01/2018 12:00:00 AM,118,262,239
Northern,Louisa County,51109,256,1442,1698,328,3127,3455,64700,575332,640032,11/01/2020 12:00:00 AM,253,399,377
Northern,Louisa County,51109,256,1457,1713,325,3141,3466,63751,573323,637074,10/01/2020 12:00:00 AM,249,393,372
Northern,Louisa County,51109,257,1308,1565,329,2978,3307,29506,345897,375403,06/01/2018 12:00:00 AM,115,264,240
Northern,Louisa County,51109,257,1438,1695,319,3068,3387,76051,695444,771495,06/01/2021 12:00:00 AM,296,484,455
Northern,Louisa County,51109,257,1460,1717,332,3167,3499,61676,548827,610503,07/01/2020 12:00:00 AM,240,376,356
Northern,Louisa County,51109,258,1323,1581,329,3034,3363,29012,351178,380190,05/01/2018 12:00:00 AM,112,265,240
Northern,Louisa County,51109,258,1452,1710,326,3153,3479,62487,568579,631066,12/01/2020 12:00:00 AM,242,392,369
Northern,Louisa County,51109,258,1459,1717,318,3120,3438,75417,714284,789701,04/01/2021 12:00:00 AM,292,490,460
Northern,Louisa County,51109,259,1358,1617,328,3187,3515,30440,370822,401262,04/01/2017 12:00:00 AM,118,273,248
Northern,Louisa County,51109,259,1450,1709,328,3144,3472,60577,543658,604235,09/01/2020 12:00:00 AM,234,375,354
Northern,Louisa County,51109,259,1453,1712,338,3139,3477,76046,659183,735229,01/01/2021 12:00:00 AM,294,454,429
Northern,Louisa County,51109,259,1458,1717,332,3163,3495,73989,667569,741558,02/01/2021 12:00:00 AM,286,458,432
Northern,Louisa County,51109,259,1464,1723,323,3147,3470,72709,659349,732058,03/01/2021 12:00:00 AM,281,450,425
Northern,Louisa County,51109,260,1450,1710,331,3162,3493,61442,539876,601318,08/01/2020 12:00:00 AM,236,372,352
Northern,Louisa County,51109,262,1343,1605,340,3086,3426,31672,359316.36,390988.36,03/01/2018 12:00:00 AM,121,268,244
Northern,Louisa County,51109,263,1315,1578,329,3101,3430,29914,361024.18,390938.18,07/01/2017 12:00:00 AM,114,275,248
Northern,Louisa County,51109,264,1326,1590,339,3135,3474,32133,365421,397554,05/01/2017 12:00:00 AM,122,276,250
Northern,Louisa County,51109,264,1348,1612,332,3178,3510,31324,372485,403809,06/01/2017 12:00:00 AM,119,276,251
Northern,Louisa County,51109,266,1338,1604,350,3111,3461,32147,363129,395276,09/01/2017 12:00:00 AM,121,271,246
Northern,Louisa County,51109,266,1377,1643,331,3278,3609,32133,376021,408154,03/01/2017 12:00:00 AM,121,273,248
Northern,Louisa County,51109,267,1324,1591,345,3026,3371,31144,351040,382184,01/01/2018 12:00:00 AM,117,265,240
Northern,Louisa County,51109,267,1413,1680,329,3342,3671,29095,380237,409332,02/01/2017 12:00:00 AM,109,269,244
Northern,Louisa County,51109,268,1334,1602,343,3062,3405,30599,353268,383867,10/01/2017 12:00:00 AM,114,265,240
Northern,Louisa County,51109,268,1362,1630,345,3124,3469,32089,362025,394114,02/01/2018 12:00:00 AM,120,266,242
Northern,Louisa County,51109,268,1420,1688,332,3373,3705,29529,380987,410516,01/01/2017 12:00:00 AM,110,268,243
Northern,Louisa County,51109,273,1438,1711,346,3410,3756,31366,390605,421971,11/01/2016 12:00:00 AM,115,272,247
Northern,Louisa County,51109,276,1362,1638,357,3188,3545,33452,380647,414099,08/01/2017 12:00:00 AM,121,279,253
Northern,Louisa County,51109,277,1332,1609,360,3044,3404,33982,350211,384193,11/01/2017 12:00:00 AM,123,263,239
Northern,Louisa County,51109,277,1442,1719,353,3427,3780,31870,393303,425173,12/01/2016 12:00:00 AM,115,273,247
Northern,Louisa County,51109,277,1472,1749,352,3505,3857,32708,400481,433189,10/01/2016 12:00:00 AM,118,272,248
Northern,Louisa County,51109,277,1478,1755,347,3493,3840,32359,396306,428665,09/01/2016 12:00:00 AM,117,268,244
Northern,Louisa County,51109,280,1343,1623,364,3089,3453,35508,362504,398012,12/01/2017 12:00:00 AM,127,270,245
Northern,Louisa County,51109,282,1480,1762,371,3491,3862,34698,403837,438535,08/01/2016 12:00:00 AM,123,273,249
Northern,Louisa County,51109,288,1455,1743,381,3449,3830,35726,395709,431435,07/01/2016 12:00:00 AM,124,272,248
Northern,Louisa County,51109,294,1781,2075,442,4106,4548,45157,520809,565966,04/01/2012 12:00:00 AM,154,292,273
Northern,Louisa County,51109,296,1789,2085,446,4086,4532,47936,523117,571053,03/01/2012 12:00:00 AM,162,292,274
Northern,Louisa County,51109,297,1460,1757,409,3447,3856,39756,396943,436699,06/01/2016 12:00:00 AM,134,272,249
Northern,Louisa County,51109,297,1758,2055,440,4016,4456,46371,513028,559399,01/01/2012 12:00:00 AM,156,292,272
Northern,Louisa County,51109,297,1765,2062,435,4029,4464,45765,512187,557952,02/01/2012 12:00:00 AM,154,290,271
Northern,Louisa County,51109,301,1499,1800,416,3527,3943,41847,405560,447407,05/01/2016 12:00:00 AM,139,271,249
Northern,Louisa County,51109,301,1516,1817,403,3586,3989,39575,417929,457504,02/01/2016 12:00:00 AM,131,276,252
Northern,Louisa County,51109,301,1595,1896,417,3745,4162,39384,449991,489375,08/01/2015 12:00:00 AM,131,282,258
Northern,Louisa County,51109,301,1757,2058,461,4046,4507,48905,513544,562449,05/01/2012 12:00:00 AM,162,292,273
Northern,Louisa County,51109,303,1533,1836,425,3620,4045,39546,418062,457608,12/01/2015 12:00:00 AM,131,273,249
Northern,Louisa County,51109,304,1520,1824,407,3620,4027,40433,417994,458427,04/01/2016 12:00:00 AM,133,275,251
Northern,Louisa County,51109,305,1513,1818,428,3561,3989,41538,406679,448217,01/01/2016 12:00:00 AM,136,269,247
Northern,Louisa County,51109,306,1608,1914,433,3753,4186,41001,447113,488114,06/01/2015 12:00:00 AM,134,278,255
Northern,Louisa County,51109,307,1513,1820,411,3592,4003,39170,416574,455744,03/01/2016 12:00:00 AM,128,275,250
Northern,Louisa County,51109,308,1582,1890,437,3709,4146,43258,437154,480412,09/01/2015 12:00:00 AM,140,276,254
Northern,Louisa County,51109,308,1799,2107,465,4122,4587,49268,522021,571289,06/01/2012 12:00:00 AM,160,290,271
Northern,Louisa County,51109,310,1548,1858,436,3664,4100,41111,428175,469286,11/01/2015 12:00:00 AM,133,277,253
Northern,Louisa County,51109,310,1559,1869,436,3682,4118,42747,429141,471888,10/01/2015 12:00:00 AM,138,275,252
Northern,Louisa County,51109,310,1593,1903,431,3744,4175,41033,446489,487522,07/01/2015 12:00:00 AM,132,280,256
Northern,Louisa County,51109,313,1843,2156,467,4191,4658,50181,540393,590574,08/01/2012 12:00:00 AM,160,293,274
Northern,Louisa County,51109,314,1608,1922,451,3747,4198,42774,447846,490620,05/01/2015 12:00:00 AM,136,279,255
Northern,Louisa County,51109,315,1810,2125,460,4168,4628,49391,534868,584259,07/01/2012 12:00:00 AM,157,296,275
Northern,Louisa County,51109,316,1822,2138,475,4139,4614,51709,539795,591504,09/01/2012 12:00:00 AM,164,296,277
Northern,Louisa County,51109,320,1825,2145,499,4138,4637,56882,534950,591832,10/01/2012 12:00:00 AM,178,293,276
Northern,Louisa County,51109,321,1645,1966,461,3835,4296,45761,458424,504185,02/01/2015 12:00:00 AM,143,279,256
Northern,Louisa County,51109,323,1656,1979,466,3876,4342,45882,467697,513579,03/01/2015 12:00:00 AM,142,282,260
Northern,Louisa County,51109,323,1660,1983,459,3876,4335,43587,466545,510132,04/01/2015 12:00:00 AM,135,281,257
Northern,Louisa County,51109,323,1703,2026,460,3918,4378,45779,463437,509216,10/01/2014 12:00:00 AM,142,272,251
Northern,Louisa County,51109,324,1857,2181,492,4207,4699,55001,539116,594117,11/01/2012 12:00:00 AM,170,290,272
Northern,Louisa County,51109,328,1697,2025,468,3931,4399,45987,469437,515424,11/01/2014 12:00:00 AM,140,277,255
Northern,Louisa County,51109,329,1760,2089,478,3961,4439,46040,456611,502651,09/01/2014 12:00:00 AM,140,259,241
Northern,Louisa County,51109,330,1836,2166,490,4082,4572,45981,476789,522770,06/01/2014 12:00:00 AM,139,260,241
Northern,Louisa County,51109,331,1672,2003,472,3900,4372,45224,464805,510029,01/01/2015 12:00:00 AM,137,278,255
Northern,Louisa County,51109,331,1682,2013,476,3900,4376,46260,466638,512898,12/01/2014 12:00:00 AM,140,277,255
Northern,Louisa County,51109,331,1824,2155,491,4087,4578,46022,471226,517248,07/01/2014 12:00:00 AM,139,258,240
Northern,Louisa County,51109,331,1834,2165,472,4108,4580,42557,484228,526785,04/01/2014 12:00:00 AM,129,264,243
Northern,Louisa County,51109,331,1839,2170,486,4124,4610,44882,484839,529721,05/01/2014 12:00:00 AM,136,264,244
Northern,Louisa County,51109,332,1899,2231,499,4324,4823,55909,551820,607729,02/01/2013 12:00:00 AM,168,291,272
Northern,Louisa County,51109,333,1877,2210,493,4275,4768,54445,545626,600071,04/01/2013 12:00:00 AM,163,291,272
Northern,Louisa County,51109,333,1889,2222,502,4299,4801,56760,546929,603689,01/01/2013 12:00:00 AM,170,290,272
Northern,Louisa County,51109,334,1846,2180,472,4132,4604,41900,486364,528264,03/01/2014 12:00:00 AM,125,263,242
Northern,Louisa County,51109,335,1866,2201,514,4233,4747,59323,543322,602645,12/01/2012 12:00:00 AM,177,291,274
Northern,Louisa County,51109,336,1870,2206,500,4252,4752,55948,541724,597672,05/01/2013 12:00:00 AM,167,290,271
Northern,Louisa County,51109,337,1864,2201,512,4215,4727,55278,537884,593162,06/01/2013 12:00:00 AM,164,289,269
Northern,Louisa County,51109,338,1803,2141,509,4043,4552,49146,466338,515484,08/01/2014 12:00:00 AM,145,259,241
Northern,Louisa County,51109,338,1879,2217,500,4270,4770,54910,542043,596953,07/01/2013 12:00:00 AM,162,288,269
Northern,Louisa County,51109,339,1876,2215,518,4277,4795,60501,554244,614745,03/01/2013 12:00:00 AM,178,295,278
Northern,Louisa County,51109,340,1853,2193,496,4141,4637,44765,486222,530987,02/01/2014 12:00:00 AM,132,262,242
Northern,Louisa County,51109,347,1880,2227,511,4239,4750,53908,535697,589605,08/01/2013 12:00:00 AM,155,285,265
Northern,Louisa County,51109,349,1844,2193,517,4154,4671,47573,481065,528638,01/01/2014 12:00:00 AM,136,261,241
Northern,Louisa County,51109,350,1886,2236,517,4235,4752,52936,530589,583525,10/01/2013 12:00:00 AM,151,281,261
Northern,Louisa County,51109,351,1864,2215,498,4201,4699,46346,490809,537155,11/01/2013 12:00:00 AM,132,263,243
Northern,Louisa County,51109,352,1889,2241,514,4252,4766,52958,536486,589444,09/01/2013 12:00:00 AM,150,284,263
Northern,Louisa County,51109,353,1849,2202,528,4162,4690,49869,485093,534962,12/01/2013 12:00:00 AM,141,262,243
Northern,Madison County,51113,70,471,541,85,1146,1231,8550,129454,138004,09/01/2016 12:00:00 AM,122,275,255
Northern,Madison County,51113,70,485,555,86,1185,1271,8188,133056,141244,07/01/2016 12:00:00 AM,117,274,254
Northern,Madison County,51113,71,337,408,83,821,904,6514,83799,90313,02/01/2020 12:00:00 AM,92,249,221
Northern,Madison County,51113,71,360,431,90,843,933,20978,185548,206526,06/01/2021 12:00:00 AM,295,515,479
Northern,Madison County,51113,71,486,557,87,1196,1283,8467,133068,141535,06/01/2016 12:00:00 AM,119,274,254
Northern,Madison County,51113,72,351,423,92,828,920,21339,183340,204679,05/01/2021 12:00:00 AM,296,522,484
Northern,Madison County,51113,72,364,436,89,868,957,20627,180663,201290,02/01/2021 12:00:00 AM,286,496,462
Northern,Madison County,51113,72,366,438,90,860,950,20335,176290,196625,03/01/2021 12:00:00 AM,282,482,449
Northern,Madison County,51113,72,412,484,94,1004,1098,9012,115468,124480,03/01/2017 12:00:00 AM,125,280,257
Northern,Madison County,51113,72,439,511,91,1076,1167,8959,119931,128890,11/01/2016 12:00:00 AM,124,273,252
Northern,Madison County,51113,72,451,523,87,1096,1183,8408,124449,132857,10/01/2016 12:00:00 AM,117,276,254
Northern,Madison County,51113,73,322,395,89,784,873,8150,84499,92649,10/01/2019 12:00:00 AM,112,262,235
Northern,Madison County,51113,73,339,412,86,830,916,7015,85145,92160,01/01/2020 12:00:00 AM,96,251,224
Northern,Madison County,51113,73,344,417,87,838,925,16339,140189,156528,03/01/2020 12:00:00 AM,224,408,375
Northern,Madison County,51113,73,349,422,93,826,919,18179,150208,168387,11/01/2020 12:00:00 AM,249,430,399
Northern,Madison County,51113,73,359,432,93,842,935,21370,184714,206084,04/01/2021 12:00:00 AM,293,515,477
Northern,Madison County,51113,73,364,437,94,869,963,18180,160112,178292,12/01/2020 12:00:00 AM,249,440,408
Northern,Madison County,51113,73,379,452,86,912,998,15991,155188,171179,04/01/2020 12:00:00 AM,219,409,379
Northern,Madison County,51113,73,472,545,95,1141,1236,9662,126501,136163,08/01/2016 12:00:00 AM,132,268,250
Northern,Madison County,51113,73,637,710,104,1565,1669,10949,208377,219326,03/01/2013 12:00:00 AM,150,327,309
Northern,Madison County,51113,74,325,399,88,790,878,7242,83593,90835,11/01/2019 12:00:00 AM,98,257,228
Northern,Madison County,51113,74,385,459,92,928,1020,17134,158178,175312,05/01/2020 12:00:00 AM,232,411,382
Northern,Madison County,51113,74,480,554,91,1182,1273,8589,133557,142146,05/01/2016 12:00:00 AM,116,278,257
Northern,Madison County,51113,75,378,453,95,909,1004,17520,153241,170761,06/01/2020 12:00:00 AM,234,405,377
Northern,Madison County,51113,75,393,468,104,986,1090,10771,110688,121459,07/01/2017 12:00:00 AM,144,282,260
Northern,Madison County,51113,75,405,480,105,1016,1121,10605,113924,124529,06/01/2017 12:00:00 AM,141,281,259
Northern,Madison County,51113,75,632,707,110,1577,1687,11372,196847,208219,09/01/2013 12:00:00 AM,152,311,295
Northern,Madison County,51113,75,633,708,101,1585,1686,9946,197160,207106,10/01/2013 12:00:00 AM,133,311,293
Northern,Madison County,51113,75,636,711,109,1575,1684,10916,204083,214999,04/01/2013 12:00:00 AM,146,321,302
Northern,Madison County,51113,75,639,714,112,1605,1717,11651,202342,213993,08/01/2013 12:00:00 AM,155,317,300
Northern,Madison County,51113,76,352,428,100,825,925,19595,149132,168727,10/01/2020 12:00:00 AM,258,424,394
Northern,Madison County,51113,76,364,440,97,871,968,21515,179395,200910,01/01/2021 12:00:00 AM,283,493,457
Northern,Madison County,51113,76,374,450,98,890,988,17799,149556,167355,08/01/2020 12:00:00 AM,234,400,372
Northern,Madison County,51113,76,376,452,98,895,993,18056,150666,168722,07/01/2020 12:00:00 AM,238,401,373
Northern,Madison County,51113,76,419,495,98,1022,1120,9808,113332,123140,12/01/2016 12:00:00 AM,129,270,249
Northern,Madison County,51113,76,622,698,103,1544,1647,9010,179121,188131,11/01/2013 12:00:00 AM,119,288,270
Northern,Madison County,51113,76,629,705,99,1569,1668,9573,194737,204310,09/01/2012 12:00:00 AM,126,310,290
Northern,Madison County,51113,76,633,709,110,1534,1644,11180,195120,206300,02/01/2013 12:00:00 AM,147,308,291
Northern,Madison County,51113,77,370,447,99,863,962,18005,146144,164149,09/01/2020 12:00:00 AM,234,395,367
Northern,Madison County,51113,77,398,475,104,982,1086,12027,112173,124200,05/01/2017 12:00:00 AM,156,282,261
Northern,Madison County,51113,77,491,568,95,1207,1302,9397,134966,144363,04/01/2016 12:00:00 AM,122,275,254
Northern,Madison County,51113,77,493,570,97,1227,1324,8868,139798,148666,03/01/2016 12:00:00 AM,115,284,261
Northern,Madison County,51113,77,501,578,99,1264,1363,9359,141262,150621,02/01/2016 12:00:00 AM,122,282,261
Northern,Madison County,51113,77,626,703,109,1541,1650,9832,188249,198081,01/01/2012 12:00:00 AM,128,301,282
Northern,Madison County,51113,77,629,706,104,1570,1674,9191,178415,187606,12/01/2013 12:00:00 AM,119,284,266
Northern,Madison County,51113,77,632,709,107,1556,1663,10774,196547,207321,10/01/2012 12:00:00 AM,140,311,292
Northern,Madison County,51113,77,634,711,114,1589,1703,12214,200444,212658,06/01/2013 12:00:00 AM,159,316,299
Northern,Madison County,51113,77,638,715,102,1575,1677,9478,181458,190936,03/01/2014 12:00:00 AM,123,284,267
Northern,Madison County,51113,77,639,716,112,1574,1686,12315,195199,207514,11/01/2012 12:00:00 AM,160,305,290
Northern,Madison County,51113,78,310,388,92,722,814,7689,73379,81068,08/01/2019 12:00:00 AM,99,237,209
Northern,Madison County,51113,78,311,389,93,739,832,7787,77166,84953,09/01/2019 12:00:00 AM,100,248,218
Northern,Madison County,51113,78,336,414,90,805,895,7401,84770,92171,06/01/2019 12:00:00 AM,95,252,223
Northern,Madison County,51113,78,341,419,87,814,901,6981,85709,92690,05/01/2019 12:00:00 AM,90,251,221
Northern,Madison County,51113,78,342,420,93,816,909,7661,85544,93205,04/01/2019 12:00:00 AM,98,250,222
Northern,Madison County,51113,78,347,425,97,835,932,9032,96209,105241,01/01/2019 12:00:00 AM,116,277,248
Northern,Madison County,51113,78,417,495,101,1013,1114,9995,115100,125095,01/01/2017 12:00:00 AM,128,276,253
Northern,Madison County,51113,78,604,682,104,1504,1608,10330,185699,196029,06/01/2012 12:00:00 AM,132,307,287
Northern,Madison County,51113,78,608,686,102,1509,1611,9818,187397,197215,05/01/2012 12:00:00 AM,126,308,287
Northern,Madison County,51113,78,626,704,104,1557,1661,9067,175273,184340,01/01/2014 12:00:00 AM,116,280,262
Northern,Madison County,51113,78,626,704,114,1592,1706,11502,201142,212644,07/01/2013 12:00:00 AM,147,321,302
Northern,Madison County,51113,78,639,717,114,1587,1701,11885,200665,212550,05/01/2013 12:00:00 AM,152,314,296
Northern,Madison County,51113,79,324,403,99,765,864,8811,82399,91210,02/01/2019 12:00:00 AM,112,254,226
Northern,Madison County,51113,79,325,404,92,757,849,7348,79998,87346,07/01/2019 12:00:00 AM,93,246,216
Northern,Madison County,51113,79,338,417,96,822,918,8020,88934,96954,12/01/2019 12:00:00 AM,102,263,233
Northern,Madison County,51113,79,407,486,103,1004,1107,10407,117679,128086,04/01/2017 12:00:00 AM,132,289,264
Northern,Madison County,51113,79,499,578,102,1264,1366,9420,142406,151826,12/01/2015 12:00:00 AM,119,285,263
Northern,Madison County,51113,79,520,599,112,1337,1449,11132,150503,161635,04/01/2015 12:00:00 AM,141,289,270
Northern,Madison County,51113,79,609,688,108,1526,1634,9773,177104,186877,05/01/2014 12:00:00 AM,124,291,272
Northern,Madison County,51113,79,622,701,110,1544,1654,10357,177827,188184,04/01/2014 12:00:00 AM,131,286,268
Northern,Madison County,51113,80,348,428,100,835,935,8513,88467,96980,03/01/2019 12:00:00 AM,106,254,227
Northern,Madison County,51113,80,393,473,108,962,1070,11436,105032,116468,08/01/2017 12:00:00 AM,143,267,246
Northern,Madison County,51113,80,539,619,115,1392,1507,11444,154493,165937,02/01/2015 12:00:00 AM,143,287,268
Northern,Madison County,51113,80,562,642,115,1411,1526,11596,158236,169832,01/01/2015 12:00:00 AM,145,282,265
Northern,Madison County,51113,80,608,688,109,1514,1623,11802,191513,203315,07/01/2012 12:00:00 AM,148,315,296
Northern,Madison County,51113,80,614,694,106,1527,1633,10569,187690,198259,08/01/2012 12:00:00 AM,132,306,286
Northern,Madison County,51113,80,616,696,110,1531,1641,9775,189532,199307,02/01/2012 12:00:00 AM,122,308,286
Northern,Madison County,51113,80,622,702,120,1527,1647,13249,191906,205155,12/01/2012 12:00:00 AM,166,309,292
Northern,Madison County,51113,81,342,423,104,834,938,10297,89874,100171,12/01/2018 12:00:00 AM,127,263,237
Northern,Madison County,51113,81,351,432,99,849,948,9926,93998,103924,05/01/2018 12:00:00 AM,123,268,241
Northern,Madison County,51113,81,377,458,101,886,987,10410,95637,106047,01/01/2018 12:00:00 AM,129,254,232
Northern,Madison County,51113,81,388,469,108,929,1037,12379,102502,114881,10/01/2017 12:00:00 AM,153,264,245
Northern,Madison County,51113,81,392,473,108,951,1059,11737,106207,117944,09/01/2017 12:00:00 AM,145,271,249
Northern,Madison County,51113,81,520,601,114,1359,1473,11416,149720,161136,05/01/2015 12:00:00 AM,141,288,268
Northern,Madison County,51113,81,617,698,112,1525,1637,10578,190433,201011,03/01/2012 12:00:00 AM,131,309,288
Northern,Madison County,51113,81,629,710,115,1553,1668,11065,176635,187700,02/01/2014 12:00:00 AM,137,281,264
Northern,Madison County,51113,82,429,511,107,1031,1138,10436,118402,128838,02/01/2017 12:00:00 AM,127,276,252
Northern,Madison County,51113,82,490,572,107,1252,1359,10157,143866,154023,11/01/2015 12:00:00 AM,124,294,269
Northern,Madison County,51113,82,527,609,121,1357,1478,12120,152551,164671,03/01/2015 12:00:00 AM,148,289,270
Northern,Madison County,51113,82,628,710,124,1529,1653,12867,188906,201773,01/01/2013 12:00:00 AM,157,301,284
Northern,Madison County,51113,83,350,433,105,857,962,9883,96447,106330,11/01/2018 12:00:00 AM,119,276,246
Northern,Madison County,51113,83,352,435,106,855,961,9524,94922,104446,07/01/2018 12:00:00 AM,115,270,240
Northern,Madison County,51113,83,359,442,107,868,975,10059,99751,109810,09/01/2018 12:00:00 AM,121,278,248
Northern,Madison County,51113,83,499,582,113,1265,1378,11138,139277,150415,01/01/2016 12:00:00 AM,134,279,258
Northern,Madison County,51113,83,514,597,117,1296,1413,11665,144602,156267,08/01/2015 12:00:00 AM,141,281,262
Northern,Madison County,51113,83,563,646,128,1417,1545,12150,153302,165452,09/01/2014 12:00:00 AM,146,272,256
Northern,Madison County,51113,83,571,654,122,1452,1574,11284,159070,170354,08/01/2014 12:00:00 AM,136,279,260
Northern,Madison County,51113,84,348,432,108,840,948,10838,91539,102377,10/01/2018 12:00:00 AM,129,263,237
Northern,Madison County,51113,84,368,452,106,869,975,11053,98331,109384,04/01/2018 12:00:00 AM,132,267,242
Northern,Madison County,51113,84,374,458,108,884,992,11574,96628,108202,11/01/2017 12:00:00 AM,138,258,236
Northern,Madison County,51113,84,592,676,126,1479,1605,12333,165161,177494,07/01/2014 12:00:00 AM,147,279,263
Northern,Madison County,51113,84,597,681,127,1486,1613,13084,169415,182499,06/01/2014 12:00:00 AM,156,284,268
Northern,Madison County,51113,84,606,690,110,1506,1616,10145,188140,198285,04/01/2012 12:00:00 AM,121,310,287
Northern,Madison County,51113,85,354,439,110,860,970,10665,96776,107441,06/01/2018 12:00:00 AM,125,273,245
Northern,Madison County,51113,85,386,471,107,901,1008,10936,101064,112000,12/01/2017 12:00:00 AM,129,262,238
Northern,Madison County,51113,85,496,581,115,1265,1380,11285,143505,154790,10/01/2015 12:00:00 AM,133,289,266
Northern,Madison County,51113,86,367,453,105,871,976,10326,99087,109413,03/01/2018 12:00:00 AM,120,270,242
Northern,Madison County,51113,86,370,456,108,870,978,11804,97180,108984,02/01/2018 12:00:00 AM,137,263,239
Northern,Madison County,51113,86,514,600,124,1297,1421,11975,144224,156199,07/01/2015 12:00:00 AM,139,281,260
Northern,Madison County,51113,86,551,637,133,1404,1537,13805,161861,175666,10/01/2014 12:00:00 AM,161,294,276
Northern,Madison County,51113,86,558,644,127,1391,1518,12812,158833,171645,12/01/2014 12:00:00 AM,149,285,267
Northern,Madison County,51113,87,343,430,117,836,953,10985,93124,104109,08/01/2018 12:00:00 AM,126,271,242
Northern,Madison County,51113,87,499,586,128,1262,1390,12839,144144,156983,09/01/2015 12:00:00 AM,148,289,268
Northern,Madison County,51113,87,548,635,135,1382,1517,14009,159568,173577,11/01/2014 12:00:00 AM,161,291,273
Northern,Madison County,51113,89,513,602,131,1331,1462,13164,146645,159809,06/01/2015 12:00:00 AM,148,286,265
Northern,Manassas City,51683,175,1181,1356,273,2811,3084,59242,586686,645928,02/01/2021 12:00:00 AM,339,497,476
Northern,Manassas City,51683,176,1259,1435,293,3346,3639,31379,416070,447449,03/01/2017 12:00:00 AM,178,330,312
Northern,Manassas City,51683,176,971,1147,273,2397,2670,29859,298132,327991,12/01/2019 12:00:00 AM,170,307,286
Northern,Manassas City,51683,177,974,1151,268,2370,2638,28881,295027,323908,02/01/2020 12:00:00 AM,163,303,281
Northern,Manassas City,51683,178,1104,1282,302,2845,3147,34450,343815,378265,06/01/2018 12:00:00 AM,194,311,295
Northern,Manassas City,51683,180,1053,1233,309,2737,3046,34326,335270,369596,10/01/2018 12:00:00 AM,191,318,300
Northern,Manassas City,51683,180,1178,1358,287,2827,3114,62683,588500,651183,03/01/2021 12:00:00 AM,348,500,480
Northern,Manassas City,51683,180,1219,1399,298,3281,3579,32828,415113,447941,06/01/2017 12:00:00 AM,182,341,320
Northern,Manassas City,51683,180,1233,1413,307,3272,3579,33783,405507,439290,05/01/2017 12:00:00 AM,188,329,311
Northern,Manassas City,51683,180,975,1155,288,2414,2702,31417,300348,331765,11/01/2019 12:00:00 AM,175,308,287
Northern,Manassas City,51683,181,1007,1188,310,2616,2926,34295,322518,356813,11/01/2018 12:00:00 AM,189,320,300
Northern,Manassas City,51683,181,1044,1225,319,2724,3043,35604,325649,361253,09/01/2018 12:00:00 AM,197,312,295
Northern,Manassas City,51683,181,1075,1256,308,2758,3066,35042,340088,375130,08/01/2018 12:00:00 AM,194,316,299
Northern,Manassas City,51683,181,976,1157,273,2382,2655,29067,302601,331668,01/01/2020 12:00:00 AM,161,310,287
Northern,Manassas City,51683,182,1075,1257,307,2790,3097,34391,340231,374622,07/01/2018 12:00:00 AM,189,316,298
Northern,Manassas City,51683,183,963,1146,293,2407,2700,32607,298636,331243,10/01/2019 12:00:00 AM,178,310,289
Northern,Manassas City,51683,184,1188,1372,299,3189,3488,32752,400166,432918,07/01/2017 12:00:00 AM,178,337,316
Northern,Manassas City,51683,184,956,1140,315,2423,2738,33650,307432,341082,02/01/2019 12:00:00 AM,183,322,299
Northern,Manassas City,51683,184,978,1162,295,2368,2663,51820,403845,455665,03/01/2020 12:00:00 AM,282,413,392
Northern,Manassas City,51683,185,1187,1372,305,3174,3479,34821,400922,435743,08/01/2017 12:00:00 AM,188,338,318
Northern,Manassas City,51683,185,1228,1413,319,3285,3604,35123,405214,440337,04/01/2017 12:00:00 AM,190,330,312
Northern,Manassas City,51683,185,1310,1495,302,3495,3797,31180,430933,462113,11/01/2016 12:00:00 AM,169,329,309
Northern,Manassas City,51683,185,1321,1506,320,3515,3835,33057,434051,467108,02/01/2017 12:00:00 AM,179,329,310
Northern,Manassas City,51683,186,1114,1300,319,2886,3205,35778,358025,393803,05/01/2018 12:00:00 AM,192,321,303
Northern,Manassas City,51683,186,1160,1346,291,3074,3365,33657,381075,414732,11/01/2017 12:00:00 AM,181,329,308
Northern,Manassas City,51683,186,1302,1488,320,3479,3799,33487,422923,456410,01/01/2017 12:00:00 AM,180,325,307
Northern,Manassas City,51683,187,1161,1348,300,3027,3327,34334,377007,411341,12/01/2017 12:00:00 AM,184,325,305
Northern,Manassas City,51683,188,1190,1378,309,3141,3450,35035,387600,422635,10/01/2017 12:00:00 AM,186,326,307
Northern,Manassas City,51683,188,1313,1501,310,3506,3816,31965,424593,456558,12/01/2016 12:00:00 AM,170,323,304
Northern,Manassas City,51683,189,1020,1209,320,2584,2904,34425,322153,356578,03/01/2019 12:00:00 AM,182,316,295
Northern,Manassas City,51683,189,1115,1304,300,2626,2926,53447,448209,501656,04/01/2020 12:00:00 AM,283,402,385
Northern,Manassas City,51683,189,1133,1322,321,2953,3274,35592,364697,400289,04/01/2018 12:00:00 AM,188,322,303
Northern,Manassas City,51683,189,1178,1367,312,3137,3449,35434,389059,424493,09/01/2017 12:00:00 AM,187,330,311
Northern,Manassas City,51683,189,997,1186,332,2589,2921,37054,322934,359988,12/01/2018 12:00:00 AM,196,324,304
Northern,Manassas City,51683,190,989,1179,330,2538,2868,35466,335385,370851,01/01/2019 12:00:00 AM,187,339,315
Northern,Manassas City,51683,191,1141,1332,323,2998,3321,37186,368223,405409,03/01/2018 12:00:00 AM,195,323,304
Northern,Manassas City,51683,191,1168,1359,319,2791,3110,72573,630230,702803,04/01/2021 12:00:00 AM,380,540,517
Northern,Manassas City,51683,192,1035,1227,317,2612,2929,33148,325694,358842,04/01/2019 12:00:00 AM,173,315,292
Northern,Manassas City,51683,192,1157,1349,318,3027,3345,35885,370839,406724,02/01/2018 12:00:00 AM,187,321,302
Northern,Manassas City,51683,192,975,1167,310,2461,2771,35037,303006,338043,08/01/2019 12:00:00 AM,182,311,290
Northern,Manassas City,51683,193,1144,1337,312,2675,2987,55702,457642,513344,05/01/2020 12:00:00 AM,289,400,384
Northern,Manassas City,51683,193,956,1149,312,2414,2726,35688,297162,332850,09/01/2019 12:00:00 AM,185,311,290
Northern,Manassas City,51683,194,1031,1225,316,2562,2878,32660,318356,351016,05/01/2019 12:00:00 AM,168,309,287
Northern,Manassas City,51683,194,1326,1520,329,3476,3805,33853,428810,462663,10/01/2016 12:00:00 AM,175,323,304
Northern,Manassas City,51683,195,1134,1329,328,2711,3039,70087,557988,628075,01/01/2021 12:00:00 AM,359,492,473
Northern,Manassas City,51683,195,1185,1380,315,2795,3110,56011,479547,535558,09/01/2020 12:00:00 AM,287,405,388
Northern,Manassas City,51683,196,1134,1330,323,2683,3006,59714,490039,549753,11/01/2020 12:00:00 AM,305,432,413
Northern,Manassas City,51683,196,1152,1348,326,2734,3060,61929,496560,558489,10/01/2020 12:00:00 AM,316,431,414
Northern,Manassas City,51683,196,1165,1361,332,3039,3371,37084,374344,411428,01/01/2018 12:00:00 AM,189,321,302
Northern,Manassas City,51683,197,1150,1347,315,2715,3030,56123,466333,522456,06/01/2020 12:00:00 AM,285,406,388
Northern,Manassas City,51683,197,1160,1357,328,2768,3096,74863,622597,697460,05/01/2021 12:00:00 AM,380,537,514
Northern,Manassas City,51683,197,1338,1535,327,3520,3847,33978,433790,467768,08/01/2016 12:00:00 AM,172,324,305
Northern,Manassas City,51683,198,1184,1382,320,2768,3088,57727,475880,533607,08/01/2020 12:00:00 AM,292,402,386
Northern,Manassas City,51683,199,1020,1219,321,2571,2892,33979,315352,349331,06/01/2019 12:00:00 AM,171,309,287
Northern,Manassas City,51683,199,1145,1344,335,2732,3067,64261,492603,556864,12/01/2020 12:00:00 AM,323,430,414
Northern,Manassas City,51683,199,1157,1356,343,2767,3110,77328,624684,702012,06/01/2021 12:00:00 AM,389,540,518
Northern,Manassas City,51683,199,1167,1366,313,2772,3085,55367,472688,528055,07/01/2020 12:00:00 AM,278,405,387
Northern,Manassas City,51683,199,986,1185,324,2484,2808,36201,303803,340004,07/01/2019 12:00:00 AM,182,308,287
Northern,Manassas City,51683,201,1337,1538,343,3492,3835,37890,430281,468171,03/01/2016 12:00:00 AM,189,322,304
Northern,Manassas City,51683,202,1339,1541,361,3463,3824,41322,430156,471478,02/01/2016 12:00:00 AM,205,321,306
Northern,Manassas City,51683,202,1364,1566,318,3559,3877,33466,439162,472628,06/01/2016 12:00:00 AM,166,322,302
Northern,Manassas City,51683,202,1366,1568,323,3552,3875,33427,441177,474604,05/01/2016 12:00:00 AM,165,323,303
Northern,Manassas City,51683,203,1336,1539,340,3491,3831,34718,427576,462294,09/01/2016 12:00:00 AM,171,320,300
Northern,Manassas City,51683,204,1358,1562,337,3534,3871,36067,437770,473837,04/01/2016 12:00:00 AM,177,322,303
Northern,Manassas City,51683,205,1338,1543,364,3466,3830,42309,427478,469787,01/01/2016 12:00:00 AM,206,319,304
Northern,Manassas City,51683,206,1337,1543,343,3504,3847,35782,431395,467177,07/01/2016 12:00:00 AM,174,323,303
Northern,Manassas City,51683,218,1378,1596,403,3552,3955,46537,437029,483566,12/01/2015 12:00:00 AM,213,317,303
Northern,Manassas City,51683,220,1386,1606,417,3586,4003,46884,442243,489127,11/01/2015 12:00:00 AM,213,319,305
Northern,Manassas City,51683,221,1448,1669,411,3664,4075,50073,460108,510181,11/01/2014 12:00:00 AM,227,318,306
Northern,Manassas City,51683,224,1452,1676,409,3687,4096,49275,459009,508284,12/01/2014 12:00:00 AM,220,316,303
Northern,Manassas City,51683,227,1439,1666,418,3654,4072,50061,455623,505684,01/01/2015 12:00:00 AM,221,317,304
Northern,Manassas City,51683,227,1442,1669,437,3648,4085,53346,452644,505990,04/01/2015 12:00:00 AM,235,314,303
Northern,Manassas City,51683,229,1450,1679,430,3699,4129,51398,461556,512954,03/01/2015 12:00:00 AM,224,318,306
Northern,Manassas City,51683,231,1432,1663,439,3657,4096,52495,458038,510533,06/01/2015 12:00:00 AM,227,320,307
Northern,Manassas City,51683,231,1451,1682,427,3701,4128,51482,466449,517931,10/01/2014 12:00:00 AM,223,321,308
Northern,Manassas City,51683,232,1418,1650,435,3652,4087,49342,459233,508575,08/01/2015 12:00:00 AM,213,324,308
Northern,Manassas City,51683,232,1429,1661,447,3655,4102,53262,454995,508257,05/01/2015 12:00:00 AM,230,318,306
Northern,Manassas City,51683,232,1482,1714,427,3731,4158,49779,455619,505398,09/01/2014 12:00:00 AM,215,307,295
Northern,Manassas City,51683,233,1353,1586,447,3521,3968,51355,439620,490975,10/01/2015 12:00:00 AM,220,325,310
Northern,Manassas City,51683,233,1391,1624,437,3584,4021,48957,450385,499342,09/01/2015 12:00:00 AM,210,324,307
Northern,Manassas City,51683,234,1437,1671,444,3678,4122,53835,460092,513927,07/01/2015 12:00:00 AM,230,320,308
Northern,Manassas City,51683,234,1439,1673,448,3658,4106,53559,458707,512266,02/01/2015 12:00:00 AM,229,319,306
Northern,Manassas City,51683,237,1477,1714,450,3704,4154,51588,454199,505787,08/01/2014 12:00:00 AM,218,308,295
Northern,Manassas City,51683,237,1515,1752,441,3799,4240,51037,464212,515249,07/01/2014 12:00:00 AM,215,306,294
Northern,Manassas City,51683,238,1547,1785,444,3895,4339,50486,476405,526891,06/01/2014 12:00:00 AM,212,308,295
Northern,Manassas City,51683,242,1617,1859,450,3915,4365,50534,476974,527508,11/01/2013 12:00:00 AM,209,295,284
Northern,Manassas City,51683,243,1630,1873,467,3937,4404,57986,515248,573234,09/01/2013 12:00:00 AM,239,316,306
Northern,Manassas City,51683,244,1564,1808,475,3948,4423,54769,482092,536861,05/01/2014 12:00:00 AM,224,308,297
Northern,Manassas City,51683,244,1616,1860,462,3924,4386,58601,509085,567686,08/01/2013 12:00:00 AM,240,315,305
Northern,Manassas City,51683,244,1648,1892,464,3989,4453,57984,520269,578253,10/01/2013 12:00:00 AM,238,316,306
Northern,Manassas City,51683,245,1569,1814,482,3926,4408,55625,484831,540456,04/01/2014 12:00:00 AM,227,309,298
Northern,Manassas City,51683,246,1602,1848,467,3922,4389,53425,477395,530820,12/01/2013 12:00:00 AM,217,298,287
Northern,Manassas City,51683,248,1581,1829,474,3947,4421,52952,484587,537539,03/01/2014 12:00:00 AM,214,307,294
Northern,Manassas City,51683,248,1595,1843,488,3859,4347,63213,505294,568507,06/01/2013 12:00:00 AM,255,317,308
Northern,Manassas City,51683,248,1597,1845,469,3921,4390,52687,476103,528790,01/01/2014 12:00:00 AM,212,298,287
Northern,Manassas City,51683,250,1605,1855,488,3886,4374,62422,504806,567228,07/01/2013 12:00:00 AM,250,315,306
Northern,Manassas City,51683,251,1599,1850,487,3955,4442,54609,483304,537913,02/01/2014 12:00:00 AM,218,302,291
Northern,Manassas City,51683,252,1543,1795,490,3805,4295,60973,505509,566482,11/01/2012 12:00:00 AM,242,328,316
Northern,Manassas City,51683,253,1595,1848,501,3866,4367,65063,508351,573414,05/01/2013 12:00:00 AM,257,319,310
Northern,Manassas City,51683,255,1513,1768,509,3689,4198,66017,495342,561359,07/01/2012 12:00:00 AM,259,327,318
Northern,Manassas City,51683,255,1549,1804,491,3814,4305,63626,510663,574289,03/01/2013 12:00:00 AM,250,330,318
Northern,Manassas City,51683,256,1540,1796,490,3773,4263,62284,502004,564288,09/01/2012 12:00:00 AM,243,326,314
Northern,Manassas City,51683,257,1523,1780,488,3759,4247,62329,497366,559695,12/01/2012 12:00:00 AM,243,327,314
Northern,Manassas City,51683,258,1534,1792,505,3760,4265,63466,497435,560901,10/01/2012 12:00:00 AM,246,324,313
Northern,Manassas City,51683,260,1524,1784,517,3777,4294,65251,499809,565060,01/01/2013 12:00:00 AM,251,328,317
Northern,Manassas City,51683,260,1555,1815,511,3825,4336,67597,505709,573306,04/01/2013 12:00:00 AM,260,325,316
Northern,Manassas City,51683,261,1537,1798,510,3796,4306,64578,508138,572716,02/01/2013 12:00:00 AM,247,331,319
Northern,Manassas City,51683,264,1524,1788,515,3710,4225,66715,495012,561727,08/01/2012 12:00:00 AM,253,325,314
Northern,Manassas City,51683,266,1503,1769,545,3694,4239,69982,493434,563416,06/01/2012 12:00:00 AM,263,328,318
Northern,Manassas City,51683,272,1522,1794,552,3746,4298,71548,505619,577167,05/01/2012 12:00:00 AM,263,332,322
Northern,Manassas City,51683,285,1496,1781,628,3604,4232,79538,483746,563284,01/01/2012 12:00:00 AM,279,323,316
Northern,Manassas City,51683,289,1517,1806,627,3689,4316,80533,498311,578844,02/01/2012 12:00:00 AM,279,328,321
Northern,Manassas City,51683,290,1490,1780,616,3666,4282,80719,490373,571092,04/01/2012 12:00:00 AM,278,329,321
Northern,Manassas City,51683,294,1491,1785,648,3636,4284,83724,486741,570465,03/01/2012 12:00:00 AM,285,326,320
Northern,Manassas Park City,51685,51,331,382,68,799,867,6720,101232,107952,07/01/2019 12:00:00 AM,132,306,283
Northern,Manassas Park City,51685,52,334,386,66,803,869,7085,103695,110780,05/01/2019 12:00:00 AM,136,310,287
Northern,Manassas Park City,51685,52,340,392,65,822,887,6988,106161,113149,06/01/2019 12:00:00 AM,134,312,289
Northern,Manassas Park City,51685,52,341,393,63,817,880,6597,102323,108920,03/01/2019 12:00:00 AM,127,300,277
Northern,Manassas Park City,51685,52,342,394,61,843,904,5924,111192,117116,01/01/2019 12:00:00 AM,114,325,297
Northern,Manassas Park City,51685,53,322,375,62,777,839,6706,94842,101548,10/01/2018 12:00:00 AM,127,295,271
Northern,Manassas Park City,51685,53,334,387,65,829,894,7810,103045,110855,12/01/2018 12:00:00 AM,147,309,286
Northern,Manassas Park City,51685,54,328,382,67,809,876,7664,99004,106668,11/01/2018 12:00:00 AM,142,302,279
Northern,Manassas Park City,51685,54,340,394,67,828,895,7083,105738,112821,04/01/2019 12:00:00 AM,131,311,286
Northern,Manassas Park City,51685,55,323,378,66,756,822,6785,96558,103343,02/01/2019 12:00:00 AM,123,299,273
Northern,Manassas Park City,51685,55,323,378,70,784,854,8094,94322,102416,09/01/2018 12:00:00 AM,147,292,271
Northern,Manassas Park City,51685,55,329,384,76,790,866,8054,103256,111310,08/01/2019 12:00:00 AM,146,314,290
Northern,Manassas Park City,51685,56,350,406,70,857,927,7703,105378,113081,06/01/2018 12:00:00 AM,138,301,279
Northern,Manassas Park City,51685,56,360,416,66,870,936,7257,110195,117452,04/01/2018 12:00:00 AM,130,306,282
Northern,Manassas Park City,51685,57,315,372,77,744,821,7775,93007,100782,01/01/2020 12:00:00 AM,136,295,271
Northern,Manassas Park City,51685,57,336,393,71,810,881,7747,99453,107200,07/01/2018 12:00:00 AM,136,296,273
Northern,Manassas Park City,51685,58,306,364,78,715,793,8295,90685,98980,02/01/2020 12:00:00 AM,143,296,272
Northern,Manassas Park City,51685,58,307,365,85,716,801,9141,94906,104047,10/01/2019 12:00:00 AM,158,309,285
Northern,Manassas Park City,51685,58,338,396,73,817,890,7909,98749,106658,08/01/2018 12:00:00 AM,136,292,269
Northern,Manassas Park City,51685,58,353,411,72,856,928,8083,105789,113872,05/01/2018 12:00:00 AM,139,300,277
Northern,Manassas Park City,51685,58,385,443,70,989,1059,7767,123535,131302,07/01/2017 12:00:00 AM,134,321,296
Northern,Manassas Park City,51685,59,302,361,87,711,798,9424,92069,101493,09/01/2019 12:00:00 AM,160,305,281
Northern,Manassas Park City,51685,59,311,370,79,721,800,14276,122413,136689,03/01/2020 12:00:00 AM,242,394,369
Northern,Manassas Park City,51685,59,380,439,71,938,1009,8411,116012,124423,03/01/2018 12:00:00 AM,143,305,283
Northern,Manassas Park City,51685,59,380,439,79,971,1050,8905,120942,129847,08/01/2017 12:00:00 AM,151,318,296
Northern,Manassas Park City,51685,59,384,443,70,944,1014,7706,118993,126699,02/01/2018 12:00:00 AM,131,310,286
Northern,Manassas Park City,51685,60,383,443,77,962,1039,8555,118727,127282,10/01/2017 12:00:00 AM,143,310,287
Northern,Manassas Park City,51685,60,390,450,70,947,1017,7819,116994,124813,01/01/2018 12:00:00 AM,130,300,277
Northern,Manassas Park City,51685,61,293,354,90,685,775,10238,85969,96207,11/01/2019 12:00:00 AM,168,293,272
Northern,Manassas Park City,51685,61,315,376,88,737,825,9237,92278,101515,12/01/2019 12:00:00 AM,151,293,270
Northern,Manassas Park City,51685,61,344,405,87,796,883,16059,134620,150679,04/01/2020 12:00:00 AM,263,391,372
Northern,Manassas Park City,51685,62,389,451,86,967,1053,10410,120608,131018,09/01/2017 12:00:00 AM,168,310,291
Northern,Manassas Park City,51685,62,394,456,83,982,1065,9548,119392,128940,11/01/2017 12:00:00 AM,154,303,283
Northern,Manassas Park City,51685,64,368,432,92,836,928,16362,143205,159567,05/01/2020 12:00:00 AM,256,389,369
Northern,Manassas Park City,51685,64,396,460,79,953,1032,9357,119451,128808,12/01/2017 12:00:00 AM,146,302,280
Northern,Manassas Park City,51685,65,378,443,93,860,953,17456,150828,168284,06/01/2020 12:00:00 AM,269,399,380
Northern,Manassas Park City,51685,65,399,464,106,1009,1115,12068,119508,131576,03/01/2017 12:00:00 AM,186,300,284
Northern,Manassas Park City,51685,65,407,472,92,1020,1112,9895,125619,135514,06/01/2016 12:00:00 AM,152,309,287
Northern,Manassas Park City,51685,65,426,491,102,1074,1176,11200,129101,140301,02/01/2017 12:00:00 AM,172,303,286
Northern,Manassas Park City,51685,66,381,447,89,995,1084,9778,120870,130648,06/01/2017 12:00:00 AM,148,317,292
Northern,Manassas Park City,51685,66,390,456,93,993,1086,9410,126751,136161,04/01/2016 12:00:00 AM,143,325,299
Northern,Manassas Park City,51685,66,393,459,93,1012,1105,10423,122449,132872,04/01/2017 12:00:00 AM,158,312,289
Northern,Manassas Park City,51685,66,396,462,95,922,1017,16967,156838,173805,09/01/2020 12:00:00 AM,257,396,376
Northern,Manassas Park City,51685,66,397,463,94,986,1080,9498,125186,134684,05/01/2016 12:00:00 AM,144,315,291
Northern,Manassas Park City,51685,66,402,468,96,1010,1106,10569,122040,132609,07/01/2016 12:00:00 AM,160,304,283
Northern,Manassas Park City,51685,67,375,442,98,975,1073,10976,117208,128184,05/01/2017 12:00:00 AM,164,313,290
Northern,Manassas Park City,51685,67,418,485,106,1053,1159,11918,129274,141192,12/01/2016 12:00:00 AM,178,309,291
Northern,Manassas Park City,51685,68,385,453,97,885,982,17540,152300,169840,07/01/2020 12:00:00 AM,258,396,375
Northern,Manassas Park City,51685,68,411,479,92,992,1084,21013,208865,229878,02/01/2021 12:00:00 AM,309,508,480
Northern,Manassas Park City,51685,68,412,480,99,956,1055,18886,161221,180107,08/01/2020 12:00:00 AM,278,391,375
Northern,Manassas Park City,51685,69,385,454,100,971,1071,10269,123995,134264,03/01/2016 12:00:00 AM,149,322,296
Northern,Manassas Park City,51685,69,390,459,99,926,1025,19494,170840,190334,10/01/2020 12:00:00 AM,283,438,415
Northern,Manassas Park City,51685,69,394,463,102,1013,1115,10509,125148,135657,01/01/2016 12:00:00 AM,152,318,293
Northern,Manassas Park City,51685,69,399,468,93,939,1032,21815,212079,233894,04/01/2021 12:00:00 AM,316,532,500
Northern,Manassas Park City,51685,69,405,474,103,1018,1121,11926,125031,136957,10/01/2016 12:00:00 AM,173,309,289
Northern,Manassas Park City,51685,69,413,482,109,1036,1145,12767,127842,140609,11/01/2016 12:00:00 AM,185,310,292
Northern,Manassas Park City,51685,69,415,484,112,1055,1167,12704,126580,139284,01/01/2017 12:00:00 AM,184,305,288
Northern,Manassas Park City,51685,69,444,513,95,1117,1212,10220,136048,146268,05/01/2015 12:00:00 AM,148,306,285
Northern,Manassas Park City,51685,69,448,517,101,1100,1201,10550,132918,143468,12/01/2014 12:00:00 AM,153,297,278
Northern,Manassas Park City,51685,70,392,462,101,988,1089,10360,125978,136338,02/01/2016 12:00:00 AM,148,321,295
Northern,Manassas Park City,51685,70,410,480,102,1029,1131,10887,129153,140040,12/01/2015 12:00:00 AM,156,315,292
Northern,Manassas Park City,51685,70,432,502,107,1074,1181,12480,128943,141423,10/01/2014 12:00:00 AM,178,298,282
Northern,Manassas Park City,51685,70,451,521,96,1105,1201,9873,134950,144823,01/01/2015 12:00:00 AM,141,299,278
Northern,Manassas Park City,51685,71,414,485,96,997,1093,21262,204417,225679,03/01/2021 12:00:00 AM,299,494,465
Northern,Manassas Park City,51685,71,416,487,101,1047,1148,10104,128462,138566,11/01/2015 12:00:00 AM,142,309,285
Northern,Manassas Park City,51685,71,444,515,111,1096,1207,12569,127851,140420,09/01/2014 12:00:00 AM,177,288,273
Northern,Manassas Park City,51685,72,398,470,99,936,1035,22295,211481,233776,05/01/2021 12:00:00 AM,310,531,497
Northern,Manassas Park City,51685,72,400,472,105,957,1062,20244,170650,190894,12/01/2020 12:00:00 AM,281,427,404
Northern,Manassas Park City,51685,72,408,480,100,973,1073,24333,223360,247693,06/01/2021 12:00:00 AM,338,547,516
Northern,Manassas Park City,51685,72,412,484,110,1039,1149,12542,127475,140017,08/01/2016 12:00:00 AM,174,309,289
Northern,Manassas Park City,51685,72,439,511,97,1117,1214,9806,133880,143686,07/01/2015 12:00:00 AM,136,305,281
Northern,Manassas Park City,51685,73,385,458,107,913,1020,20036,167155,187191,11/01/2020 12:00:00 AM,274,434,409
Northern,Manassas Park City,51685,73,407,480,109,959,1068,23169,200304,223473,01/01/2021 12:00:00 AM,317,492,466
Northern,Manassas Park City,51685,73,437,510,103,1119,1222,10385,135973,146358,08/01/2015 12:00:00 AM,142,311,287
Northern,Manassas Park City,51685,73,441,514,109,1102,1211,12080,127996,140076,08/01/2014 12:00:00 AM,165,290,273
Northern,Manassas Park City,51685,73,445,518,112,1108,1220,12689,135621,148310,11/01/2014 12:00:00 AM,174,305,286
Northern,Manassas Park City,51685,73,451,524,101,1124,1225,10371,139054,149425,02/01/2015 12:00:00 AM,142,308,285
Northern,Manassas Park City,51685,74,429,503,126,1044,1170,15029,133398,148427,01/01/2012 12:00:00 AM,203,311,295
Northern,Manassas Park City,51685,74,446,520,105,1114,1219,11480,127279,138759,07/01/2014 12:00:00 AM,155,285,267
Northern,Manassas Park City,51685,74,446,520,105,1121,1226,10531,134829,145360,06/01/2015 12:00:00 AM,142,302,280
Northern,Manassas Park City,51685,74,451,525,103,1116,1219,10558,138394,148952,03/01/2015 12:00:00 AM,143,307,284
Northern,Manassas Park City,51685,75,412,487,115,1025,1140,14467,123420,137887,09/01/2016 12:00:00 AM,193,300,283
Northern,Manassas Park City,51685,75,413,488,110,1052,1162,11325,127350,138675,10/01/2015 12:00:00 AM,151,308,284
Northern,Manassas Park City,51685,75,417,492,125,1034,1159,15383,133442,148825,03/01/2012 12:00:00 AM,205,320,302
Northern,Manassas Park City,51685,75,423,498,123,1048,1171,14790,131100,145890,12/01/2012 12:00:00 AM,197,310,293
Northern,Manassas Park City,51685,75,424,499,111,1066,1177,11073,131181,142254,09/01/2015 12:00:00 AM,148,309,285
Northern,Manassas Park City,51685,75,449,524,111,1119,1230,11970,137329,149299,04/01/2015 12:00:00 AM,160,306,285
Northern,Manassas Park City,51685,75,449,524,113,1069,1182,13435,134989,148424,02/01/2013 12:00:00 AM,179,301,283
Northern,Manassas Park City,51685,76,422,498,132,1031,1163,17156,132026,149182,02/01/2012 12:00:00 AM,226,313,300
Northern,Manassas Park City,51685,76,445,521,120,1075,1195,12809,134410,147219,03/01/2013 12:00:00 AM,169,302,283
Northern,Manassas Park City,51685,76,460,536,118,1119,1237,14627,140456,155083,05/01/2013 12:00:00 AM,192,305,289
Northern,Manassas Park City,51685,78,440,518,123,1101,1224,13726,130960,144686,03/01/2014 12:00:00 AM,176,298,279
Northern,Manassas Park City,51685,78,440,518,130,1054,1184,16120,130792,146912,10/01/2013 12:00:00 AM,207,297,284
Northern,Manassas Park City,51685,78,455,533,131,1105,1236,16207,139985,156192,04/01/2013 12:00:00 AM,208,308,293
Northern,Manassas Park City,51685,79,410,489,133,983,1116,16328,126162,142490,05/01/2012 12:00:00 AM,207,308,291
Northern,Manassas Park City,51685,79,432,511,121,1055,1176,14628,130456,145084,11/01/2012 12:00:00 AM,185,302,284
Northern,Manassas Park City,51685,80,414,494,139,1011,1150,17032,131277,148309,04/01/2012 12:00:00 AM,213,317,300
Northern,Manassas Park City,51685,80,430,510,125,1013,1138,14666,127595,142261,09/01/2012 12:00:00 AM,183,297,279
Northern,Manassas Park City,51685,80,430,510,125,1016,1141,14914,129122,144036,08/01/2012 12:00:00 AM,186,300,282
Northern,Manassas Park City,51685,80,433,513,128,1067,1195,14319,125600,139919,01/01/2014 12:00:00 AM,179,290,273
Northern,Manassas Park City,51685,80,440,520,127,1103,1230,13658,130179,143837,04/01/2014 12:00:00 AM,171,296,277
Northern,Manassas Park City,51685,80,446,526,121,1111,1232,12936,133650,146586,05/01/2014 12:00:00 AM,162,300,279
Northern,Manassas Park City,51685,81,433,514,133,1053,1186,15288,125247,140535,12/01/2013 12:00:00 AM,189,289,273
Northern,Manassas Park City,51685,81,437,518,126,1083,1209,14228,126270,140498,06/01/2014 12:00:00 AM,176,289,271
Northern,Manassas Park City,51685,81,446,527,135,1077,1212,16864,133830,150694,08/01/2013 12:00:00 AM,208,300,286
Northern,Manassas Park City,51685,82,425,507,145,1023,1168,17862,125167,143029,01/01/2013 12:00:00 AM,218,295,282
Northern,Manassas Park City,51685,82,427,509,130,1031,1161,15440,132042,147482,10/01/2012 12:00:00 AM,188,309,290
Northern,Manassas Park City,51685,82,430,512,139,1030,1169,16571,120295,136866,11/01/2013 12:00:00 AM,202,280,267
Northern,Manassas Park City,51685,82,440,522,131,1097,1228,14804,129373,144177,02/01/2014 12:00:00 AM,181,294,276
Northern,Manassas Park City,51685,83,412,495,141,992,1133,17831,126782,144613,06/01/2012 12:00:00 AM,215,308,292
Northern,Manassas Park City,51685,83,451,534,141,1081,1222,17952,134276,152228,09/01/2013 12:00:00 AM,216,298,285
Northern,Manassas Park City,51685,85,431,516,146,1012,1158,17977,127762,145739,07/01/2012 12:00:00 AM,211,296,282
Northern,Manassas Park City,51685,85,450,535,146,1087,1233,19051,137228,156279,06/01/2013 12:00:00 AM,224,305,292
Northern,Manassas Park City,51685,87,446,533,152,1084,1236,18833,134034,152867,07/01/2013 12:00:00 AM,216,301,287
Northern,Orange County,51137,214,1037,1251,326,2451,2777,34938,283026,317964,04/01/2016 12:00:00 AM,163,273,254
Northern,Orange County,51137,215,1121,1336,331,2721,3052,36921,318385,355306,07/01/2015 12:00:00 AM,172,284,266
Northern,Orange County,51137,217,1033,1250,333,2444,2777,34757,278080,312837,05/01/2016 12:00:00 AM,160,269,250
Northern,Orange County,51137,217,1293,1510,362,3128,3490,41769,392382,434151,02/01/2012 12:00:00 AM,192,303,288
Northern,Orange County,51137,217,985,1202,311,2313,2624,31171,269000,300171,04/01/2017 12:00:00 AM,144,273,250
Northern,Orange County,51137,218,1010,1228,303,2371,2674,30934,280101,311035,03/01/2017 12:00:00 AM,142,277,253
Northern,Orange County,51137,218,1125,1343,333,2712,3045,36556,317288,353844,08/01/2015 12:00:00 AM,168,282,263
Northern,Orange County,51137,218,1324,1542,354,3198,3552,42725,398283,441008,02/01/2013 12:00:00 AM,196,301,286
Northern,Orange County,51137,218,1341,1559,325,3166,3491,33180,363717,396897,12/01/2013 12:00:00 AM,152,271,255
Northern,Orange County,51137,219,1347,1566,333,3160,3493,33864,355103,388967,01/01/2014 12:00:00 AM,155,264,248
Northern,Orange County,51137,220,1016,1236,299,2400,2699,29452,277221,306673,02/01/2017 12:00:00 AM,134,273,248
Northern,Orange County,51137,220,1277,1497,373,3077,3450,43731,392721,436452,04/01/2012 12:00:00 AM,199,308,292
Northern,Orange County,51137,220,1281,1501,373,3076,3449,44188,390329,434517,05/01/2012 12:00:00 AM,201,305,289
Northern,Orange County,51137,221,1037,1258,328,2441,2769,33769,275899,309668,07/01/2016 12:00:00 AM,153,266,246
Northern,Orange County,51137,221,1046,1267,335,2460,2795,35483,281138,316621,06/01/2016 12:00:00 AM,161,269,250
Northern,Orange County,51137,221,1071,1292,356,2534,2890,40952,298166,339118,03/01/2016 12:00:00 AM,185,278,262
Northern,Orange County,51137,221,1128,1349,343,2732,3075,39033,320388,359421,06/01/2015 12:00:00 AM,177,284,266
Northern,Orange County,51137,221,1143,1364,342,2800,3142,38553,331026,369579,05/01/2015 12:00:00 AM,174,290,271
Northern,Orange County,51137,222,1016,1238,328,2408,2736,34163,273281,307444,08/01/2016 12:00:00 AM,154,269,248
Northern,Orange County,51137,222,1039,1261,287,2436,2723,26976,280227,307203,11/01/2019 12:00:00 AM,122,270,244
Northern,Orange County,51137,222,1323,1545,362,3173,3535,43510,398798,442308,03/01/2013 12:00:00 AM,196,301,286
Northern,Orange County,51137,222,1334,1556,359,3191,3550,43584,400810,444394,12/01/2012 12:00:00 AM,196,300,286
Northern,Orange County,51137,222,1339,1561,342,3148,3490,34442,360604,395046,11/01/2013 12:00:00 AM,155,269,253
Northern,Orange County,51137,222,983,1205,321,2300,2621,31834,271288,303122,05/01/2017 12:00:00 AM,143,276,252
Northern,Orange County,51137,223,1296,1519,348,3140,3488,39984,386455,426439,06/01/2013 12:00:00 AM,179,298,281
Northern,Orange County,51137,223,1346,1569,345,3161,3506,35188,361465,396653,02/01/2014 12:00:00 AM,158,269,253
Northern,Orange County,51137,224,1037,1261,288,2450,2738,26984,287696,314680,09/01/2019 12:00:00 AM,120,277,250
Northern,Orange County,51137,224,1280,1504,376,3108,3484,42884,392705,435589,03/01/2012 12:00:00 AM,191,307,290
Northern,Orange County,51137,224,1316,1540,358,3154,3512,42578,385771,428349,01/01/2013 12:00:00 AM,190,293,278
Northern,Orange County,51137,225,1010,1235,332,2411,2743,34663,272312,306975,10/01/2016 12:00:00 AM,154,270,249
Northern,Orange County,51137,225,1021,1246,322,2381,2703,32573,270596,303169,01/01/2017 12:00:00 AM,145,265,243
Northern,Orange County,51137,225,1049,1274,288,2477,2765,25853,293201,319054,08/01/2019 12:00:00 AM,115,280,250
Northern,Orange County,51137,225,1053,1278,292,2477,2769,26662,293506,320168,10/01/2019 12:00:00 AM,118,279,251
Northern,Orange County,51137,225,1245,1470,296,2870,3166,54539,485528,540067,08/01/2020 12:00:00 AM,242,390,367
Northern,Orange County,51137,225,1307,1532,380,3098,3478,46207,384770,430977,10/01/2012 12:00:00 AM,205,294,281
Northern,Orange County,51137,225,1317,1542,376,3195,3571,45264,399076,444340,07/01/2012 12:00:00 AM,201,303,288
Northern,Orange County,51137,225,960,1185,313,2220,2533,31504,258555,290059,07/01/2017 12:00:00 AM,140,269,245
Northern,Orange County,51137,226,1048,1274,299,2417,2716,54942,410747,465689,03/01/2020 12:00:00 AM,243,392,366
Northern,Orange County,51137,226,1136,1362,349,2700,3049,38238,312258,350496,09/01/2015 12:00:00 AM,169,275,257
Northern,Orange County,51137,226,1287,1513,388,3074,3462,47367,380832,428199,09/01/2012 12:00:00 AM,210,296,283
Northern,Orange County,51137,226,1306,1532,365,3130,3495,42583,393295,435878,04/01/2013 12:00:00 AM,188,301,285
Northern,Orange County,51137,226,992,1218,290,2369,2659,28102,277786,305888,02/01/2018 12:00:00 AM,124,280,251
Northern,Orange County,51137,227,1014,1241,326,2400,2726,33843,274554,308397,12/01/2016 12:00:00 AM,149,271,249
Northern,Orange County,51137,227,1035,1262,297,2422,2719,28263,278321,306584,01/01/2020 12:00:00 AM,125,269,243
Northern,Orange County,51137,227,1051,1278,294,2478,2772,28460,290600.3,319060.3,12/01/2019 12:00:00 AM,125,276,250
Northern,Orange County,51137,227,1070,1297,373,2529,2902,43282,287931,331213,01/01/2016 12:00:00 AM,191,269,255
Northern,Orange County,51137,227,1293,1520,371,3102,3473,45583,384777,430360,08/01/2012 12:00:00 AM,201,298,283
Northern,Orange County,51137,227,1323,1550,379,3169,3548,47977,397736,445713,11/01/2012 12:00:00 AM,211,301,288
Northern,Orange County,51137,228,1301,1529,348,3159,3507,36439,359235,395674,06/01/2014 12:00:00 AM,160,276,259
Northern,Orange County,51137,229,1017,1246,340,2430,2770,36276,269204,305480,09/01/2016 12:00:00 AM,158,265,245
Northern,Orange County,51137,229,1025,1254,298,2402,2700,28690,279758,308448,02/01/2020 12:00:00 AM,125,273,246
Northern,Orange County,51137,229,1031,1260,296,2413,2709,27883,277748,305631,05/01/2019 12:00:00 AM,122,269,243
Northern,Orange County,51137,229,1061,1290,373,2506,2879,43593,288173,331766,02/01/2016 12:00:00 AM,190,272,257
Northern,Orange County,51137,229,1167,1396,360,2811,3171,41139,329564,370703,03/01/2015 12:00:00 AM,180,282,266
Northern,Orange County,51137,229,1282,1511,368,3070,3438,42445,382262,424707,05/01/2013 12:00:00 AM,185,298,281
Northern,Orange County,51137,230,1149,1379,301,2648,2949,54847,456181,511028,04/01/2020 12:00:00 AM,238,397,371
Northern,Orange County,51137,230,1171,1401,361,2851,3212,41658,335113,376771,04/01/2015 12:00:00 AM,181,286,269
Northern,Orange County,51137,230,1291,1521,390,3149,3539,44754,393777,438531,01/01/2012 12:00:00 AM,195,305,288
Northern,Orange County,51137,230,966,1196,324,2254,2578,32884,262180,295064,06/01/2017 12:00:00 AM,143,271,247
Northern,Orange County,51137,230,990,1220,298,2299,2597,27919,260894,288813,02/01/2019 12:00:00 AM,121,264,237
Northern,Orange County,51137,231,1090,1321,375,2607,2982,43087,298946,342033,12/01/2015 12:00:00 AM,187,274,259
Northern,Orange County,51137,231,1097,1328,372,2605,2977,42974,303767,346741,11/01/2015 12:00:00 AM,186,277,261
Northern,Orange County,51137,231,1231,1462,308,2848,3156,56742,486941,543683,07/01/2020 12:00:00 AM,246,396,372
Northern,Orange County,51137,231,1307,1538,406,3142,3548,47501,394304,441805,06/01/2012 12:00:00 AM,206,302,287
Northern,Orange County,51137,231,1317,1548,374,3078,3452,43773,384175,427948,09/01/2013 12:00:00 AM,189,292,276
Northern,Orange County,51137,232,1011,1243,337,2417,2754,35633,277924,313557,11/01/2016 12:00:00 AM,154,275,252
Northern,Orange County,51137,232,1030,1262,303,2414,2717,27585,273506,301091,03/01/2019 12:00:00 AM,119,266,239
Northern,Orange County,51137,232,1041,1273,294,2433,2727,27772,276800,304572,04/01/2019 12:00:00 AM,120,266,239
Northern,Orange County,51137,232,1104,1336,362,2658,3020,40835,307413,348248,10/01/2015 12:00:00 AM,176,278,261
Northern,Orange County,51137,232,1223,1455,291,2812,3103,65974,588195,654169,02/01/2021 12:00:00 AM,284,481,450
Northern,Orange County,51137,232,1231,1463,307,2854,3161,56145,481578,537723,09/01/2020 12:00:00 AM,242,391,368
Northern,Orange County,51137,232,1267,1499,364,3108,3472,38533,346070,384603,07/01/2014 12:00:00 AM,166,273,257
Northern,Orange County,51137,233,1045,1278,295,2444,2739,27571,286911.63,314482.63,07/01/2019 12:00:00 AM,118,275,246
Northern,Orange County,51137,234,1004,1238,311,2371,2682,32193,278131,310324,01/01/2018 12:00:00 AM,138,277,251
Northern,Orange County,51137,234,1299,1533,375,3125,3500,44011,387087,431098,07/01/2013 12:00:00 AM,188,298,281
Northern,Orange County,51137,234,1355,1589,354,3215,3569,38504,364183,402687,03/01/2014 12:00:00 AM,165,269,253
Northern,Orange County,51137,235,1250,1485,380,3043,3423,41037,340666,381703,08/01/2014 12:00:00 AM,175,273,257
Northern,Orange County,51137,235,1312,1547,381,3133,3514,44899,387145,432044,08/01/2013 12:00:00 AM,191,295,279
Northern,Orange County,51137,235,1320,1555,366,3177,3543,39633,363661,403294,05/01/2014 12:00:00 AM,169,276,259
Northern,Orange County,51137,235,1322,1557,373,3113,3486,42738,384501,427239,10/01/2013 12:00:00 AM,182,291,274
Northern,Orange County,51137,235,987,1222,332,2311,2643,33396,270977,304373,08/01/2017 12:00:00 AM,142,275,249
Northern,Orange County,51137,236,1042,1278,302,2439,2741,28563,284794,313357,06/01/2019 12:00:00 AM,121,273,245
Northern,Orange County,51137,236,1203,1439,312,2776,3088,57677,473271,530948,06/01/2020 12:00:00 AM,244,393,369
Northern,Orange County,51137,236,1212,1448,316,2820,3136,63139,507689,570828,10/01/2020 12:00:00 AM,268,419,394
Northern,Orange County,51137,237,1013,1250,320,2363,2683,31119.11,273609,304728.11,12/01/2018 12:00:00 AM,131,270,244
Northern,Orange County,51137,237,1197,1434,379,2878,3257,43236,338339,381575,02/01/2015 12:00:00 AM,182,283,266
Northern,Orange County,51137,237,1241,1478,392,3010,3402,43294,337269,380563,09/01/2014 12:00:00 AM,183,272,257
Northern,Orange County,51137,238,1001,1239,313,2346,2659,31204,279435,310639,04/01/2018 12:00:00 AM,131,279,251
Northern,Orange County,51137,238,1006,1244,312,2379,2691,29483,288398,317881,03/01/2018 12:00:00 AM,124,287,256
Northern,Orange County,51137,238,1177,1415,314,2716,3030,58591,465777,524368,05/01/2020 12:00:00 AM,246,396,371
Northern,Orange County,51137,238,1204,1442,383,2895,3278,43918,335871,379789,01/01/2015 12:00:00 AM,185,279,263
Northern,Orange County,51137,238,1250,1488,389,3028,3417,46825,359962,406787,10/01/2014 12:00:00 AM,197,288,273
Northern,Orange County,51137,239,1005,1244,313,2371,2684,30308,277361,307669,05/01/2018 12:00:00 AM,127,276,247
Northern,Orange County,51137,239,1007,1246,325,2339,2664,32472.11,267967,300439.11,11/01/2018 12:00:00 AM,136,266,241
Northern,Orange County,51137,240,1202,1442,319,2802,3121,61873,510176,572049,11/01/2020 12:00:00 AM,258,424,397
Northern,Orange County,51137,240,1204,1444,325,2792,3117,62744,507334,570078,12/01/2020 12:00:00 AM,261,421,395
Northern,Orange County,51137,240,1234,1474,385,2991,3376,46475,351309,397784,11/01/2014 12:00:00 AM,194,285,270
Northern,Orange County,51137,240,1343,1583,372,3237,3609,40123,372640,412763,04/01/2014 12:00:00 AM,167,277,261
Northern,Orange County,51137,240,983,1223,331,2330,2661,33872,268755,302627,11/01/2017 12:00:00 AM,141,273,247
Northern,Orange County,51137,241,1011,1252,330,2421,2751,34338,281286,315624,12/01/2017 12:00:00 AM,142,278,252
Northern,Orange County,51137,241,1030,1271,322,2412,2734,31769,286442,318211,01/01/2019 12:00:00 AM,132,278,250
Northern,Orange County,51137,241,1207,1448,302,2768,3070,67779,573325,641104,03/01/2021 12:00:00 AM,281,475,443
Northern,Orange County,51137,241,1207,1448,317,2799,3116,70851,580965,651816,01/01/2021 12:00:00 AM,294,481,450
Northern,Orange County,51137,241,1222,1463,392,2933,3325,45676,345363,391039,12/01/2014 12:00:00 AM,190,283,267
Northern,Orange County,51137,242,972,1214,332,2275,2607,32480,263996,296476,09/01/2018 12:00:00 AM,134,272,244
Northern,Orange County,51137,242,991,1233,339,2318,2657,33085,276096,309181,09/01/2017 12:00:00 AM,137,279,251
Northern,Orange County,51137,243,997,1240,337,2307,2644,32041,268010,300051,10/01/2018 12:00:00 AM,132,269,242
Northern,Orange County,51137,244,1005,1249,330,2360,2690,32172,275860,308032,06/01/2018 12:00:00 AM,132,274,247
Northern,Orange County,51137,244,979,1223,334,2304,2638,33322,265916,299238,08/01/2018 12:00:00 AM,137,272,245
Northern,Orange County,51137,244,996,1240,343,2327,2670,34758,274736,309494,10/01/2017 12:00:00 AM,142,276,250
Northern,Orange County,51137,245,1171,1416,312,2674,2986,73119,593368,666487,04/01/2021 12:00:00 AM,298,507,471
Northern,Orange County,51137,245,962,1207,330,2262,2592,33238,259623,292861,07/01/2018 12:00:00 AM,136,270,243
Northern,Orange County,51137,247,1187,1434,317,2711,3028,74599,607975,682574,05/01/2021 12:00:00 AM,302,512,476
Northern,Orange County,51137,251,1218,1469,329,2792,3121,78368,620527,698895,06/01/2021 12:00:00 AM,312,509,476
Northern,Page County,51139,210,1135,1345,259,2619,2878,22532,303924,326456,05/01/2017 12:00:00 AM,107,268,243
Northern,Page County,51139,212,1128,1340,263,2626,2889,23789,293379,317168,04/01/2017 12:00:00 AM,112,260,237
Northern,Page County,51139,213,1176,1389,267,2721,2988,24295,310438,334733,03/01/2017 12:00:00 AM,114,264,241
Northern,Page County,51139,213,1182,1395,256,2819,3075,21982,319789,341771,10/01/2016 12:00:00 AM,103,271,245
Northern,Page County,51139,214,1199,1413,268,2822,3090,24181,310970,335151,01/01/2017 12:00:00 AM,113,259,237
Northern,Page County,51139,215,1169,1384,268,2711,2979,24036,301950,325986,02/01/2017 12:00:00 AM,112,258,236
Northern,Page County,51139,216,1114,1330,269,2533,2802,24703,295209,319912,06/01/2017 12:00:00 AM,114,265,241
Northern,Page County,51139,216,1199,1415,269,2804,3073,23732,315852,339584,12/01/2016 12:00:00 AM,110,263,240
Northern,Page County,51139,216,980,1196,274,2111,2385,23836,237066,260902,07/01/2019 12:00:00 AM,110,242,218
Northern,Page County,51139,217,1254,1471,272,2962,3234,25035,333383,358418,06/01/2016 12:00:00 AM,115,266,244
Northern,Page County,51139,219,1072,1291,278,2470,2748,25555,283502,309057,07/01/2017 12:00:00 AM,117,264,239
Northern,Page County,51139,221,1180,1401,272,2770,3042,24286,313124,337410,11/01/2016 12:00:00 AM,110,265,241
Northern,Page County,51139,221,1222,1443,270,2902,3172,23416,329578,352994,09/01/2016 12:00:00 AM,106,270,245
Northern,Page County,51139,221,1242,1463,286,2928,3214,27174,335226,362400,07/01/2016 12:00:00 AM,123,270,248
Northern,Page County,51139,223,1044,1267,286,2371,2657,26733,267517,294250,09/01/2017 12:00:00 AM,120,256,232
Northern,Page County,51139,224,1088,1312,290,2487,2777,26928,288022,314950,08/01/2017 12:00:00 AM,120,265,240
Northern,Page County,51139,224,1230,1454,286,2910,3196,26452,330458,356910,08/01/2016 12:00:00 AM,118,269,245
Northern,Page County,51139,224,948,1172,291,2020,2311,25660,228041,253701,02/01/2019 12:00:00 AM,115,241,216
Northern,Page County,51139,224,987,1211,293,2138,2431,26119,245595,271714,06/01/2019 12:00:00 AM,117,249,224
Northern,Page County,51139,225,980,1205,303,2125,2428,27553,231607,259160,08/01/2019 12:00:00 AM,122,236,215
Northern,Page County,51139,226,1271,1497,280,2983,3263,26939,335774,362713,05/01/2016 12:00:00 AM,119,264,242
Northern,Page County,51139,227,1036,1263,286,2372,2658,25463,261714,287177,11/01/2017 12:00:00 AM,112,253,227
Northern,Page County,51139,227,1045,1272,288,2398,2686,26467,270719,297186,10/01/2017 12:00:00 AM,117,259,234
Northern,Page County,51139,227,1301,1528,276,3063,3339,26140,346711,372851,04/01/2016 12:00:00 AM,115,266,244
Northern,Page County,51139,227,989,1216,272,2199,2471,24474,247963,272437,07/01/2018 12:00:00 AM,108,251,224
Northern,Page County,51139,227,995,1222,282,2137,2419,24746,239471,264217,12/01/2018 12:00:00 AM,109,241,216
Northern,Page County,51139,228,1000,1228,269,2227,2496,23950,253290,277240,06/01/2018 12:00:00 AM,105,253,226
Northern,Page County,51139,229,1006,1235,294,2154,2448,26348,256725,283073,01/01/2019 12:00:00 AM,115,255,229
Northern,Page County,51139,229,1343,1572,272,3181,3453,24862,360920,385782,03/01/2016 12:00:00 AM,109,269,245
Northern,Page County,51139,229,1373,1602,278,3221,3499,26150,360025,386175,01/01/2016 12:00:00 AM,114,262,241
Northern,Page County,51139,229,970,1199,286,2123,2409,25618,234414,260032,11/01/2018 12:00:00 AM,112,242,217
Northern,Page County,51139,229,976,1205,314,2082,2396,28869,236530,265399,10/01/2019 12:00:00 AM,126,242,220
Northern,Page County,51139,229,989,1218,273,2213,2486,25127,248214,273341,08/01/2018 12:00:00 AM,110,251,224
Northern,Page County,51139,229,990,1219,297,2115,2412,25613,239153,264766,05/01/2019 12:00:00 AM,112,242,217
Northern,Page County,51139,230,1045,1275,286,2353,2639,24624,269727,294351,02/01/2018 12:00:00 AM,107,258,231
Northern,Page County,51139,230,964,1194,317,2083,2400,29658,229699,259357,09/01/2019 12:00:00 AM,129,238,217
Northern,Page County,51139,231,1001,1232,300,2150,2450,26638,244261,270899,04/01/2019 12:00:00 AM,115,244,220
Northern,Page County,51139,231,1026,1257,277,2284,2561,24685,262017,286702,05/01/2018 12:00:00 AM,107,255,228
Northern,Page County,51139,231,1031,1262,281,2315,2596,24452,263002,287454,04/01/2018 12:00:00 AM,106,255,228
Northern,Page County,51139,231,986,1217,299,2107,2406,26548,238595,265143,03/01/2019 12:00:00 AM,115,242,218
Northern,Page County,51139,232,1036,1268,292,2395,2687,26292,270349,296641,12/01/2017 12:00:00 AM,113,261,234
Northern,Page County,51139,232,1355,1587,288,3177,3465,27550,357759,385309,02/01/2016 12:00:00 AM,119,264,243
Northern,Page County,51139,232,1441,1673,290,3416,3706,28088,394852,422940,12/01/2014 12:00:00 AM,121,274,253
Northern,Page County,51139,232,964,1196,324,2048,2372,29930,224985,254915,11/01/2019 12:00:00 AM,129,233,213
Northern,Page County,51139,232,970,1202,288,2151,2439,26765,239299,266064,09/01/2018 12:00:00 AM,115,247,221
Northern,Page County,51139,233,1567,1800,309,3662,3971,28772,418026,446798,04/01/2014 12:00:00 AM,123,267,248
Northern,Page County,51139,234,1441,1675,291,3382,3673,28682,385373,414055,01/01/2015 12:00:00 AM,123,267,247
Northern,Page County,51139,234,985,1219,289,2157,2446,26684,243055,269739,10/01/2018 12:00:00 AM,114,247,221
Northern,Page County,51139,235,1005,1240,331,2122,2453,29677,233795,263472,01/01/2020 12:00:00 AM,126,233,212
Northern,Page County,51139,236,1362,1598,285,3162,3447,26048,355816,381864,12/01/2015 12:00:00 AM,110,261,239
Northern,Page County,51139,236,971,1207,329,2059,2388,29862,227232,257094,02/01/2020 12:00:00 AM,127,234,213
Northern,Page County,51139,236,973,1209,328,2047,2375,29997,225574,255571,12/01/2019 12:00:00 AM,127,232,211
Northern,Page County,51139,237,1345,1582,287,3107,3394,26657,351403,378060,11/01/2015 12:00:00 AM,112,261,239
Northern,Page County,51139,237,1523,1760,335,3564,3899,32157,406293,438450,12/01/2013 12:00:00 AM,136,267,249
Northern,Page County,51139,238,1073,1311,298,2439,2737,26494,279672,306166,01/01/2018 12:00:00 AM,111,261,234
Northern,Page County,51139,238,1413,1651,312,3326,3638,29599,383955,413554,11/01/2014 12:00:00 AM,124,272,250
Northern,Page County,51139,238,1432,1670,306,3374,3680,30125,389065,419190,05/01/2015 12:00:00 AM,127,272,251
Northern,Page County,51139,238,1476,1714,326,3475,3801,30466,389110,419576,07/01/2014 12:00:00 AM,128,264,245
Northern,Page County,51139,239,1035,1274,298,2302,2600,26507,259477,285984,03/01/2018 12:00:00 AM,111,251,224
Northern,Page County,51139,239,1343,1582,296,3124,3420,27980,348347,376327,10/01/2015 12:00:00 AM,117,259,238
Northern,Page County,51139,239,1466,1705,297,3450,3747,29579,396037,425616,04/01/2015 12:00:00 AM,124,270,250
Northern,Page County,51139,239,1544,1783,332,3631,3963,30607,408891,439498,01/01/2014 12:00:00 AM,128,265,246
Northern,Page County,51139,239,1544,1783,336,3631,3967,32697,410540,443237,11/01/2013 12:00:00 AM,137,266,249
Northern,Page County,51139,239,1570,1809,324,3677,4001,30988,418347,449335,03/01/2014 12:00:00 AM,130,266,248
Northern,Page County,51139,239,989,1228,329,2097,2426,60526,361789,422315,03/01/2020 12:00:00 AM,253,366,344
Northern,Page County,51139,240,1504,1744,325,3545,3870,30027,402741,432768,06/01/2014 12:00:00 AM,125,268,248
Northern,Page County,51139,241,1353,1594,302,3183,3485,28029,352129,380158,09/01/2015 12:00:00 AM,116,260,238
Northern,Page County,51139,241,1365,1606,302,3226,3528,28693,363302,391995,08/01/2015 12:00:00 AM,119,266,244
Northern,Page County,51139,241,1524,1765,330,3554,3884,30517,404746,435263,05/01/2014 12:00:00 AM,127,266,247
Northern,Page County,51139,242,1457,1699,305,3421,3726,29771,394683,424454,02/01/2015 12:00:00 AM,123,271,250
Northern,Page County,51139,242,1564,1806,336,3654,3990,31744,416147,447891,02/01/2014 12:00:00 AM,131,266,248
Northern,Page County,51139,243,1403,1646,320,3295,3615,31147,370625,401772,06/01/2015 12:00:00 AM,128,264,244
Northern,Page County,51139,243,1405,1648,320,3326,3646,31080,385026,416106,10/01/2014 12:00:00 AM,128,274,252
Northern,Page County,51139,243,1538,1781,343,3627,3970,35289,443866,479155,10/01/2013 12:00:00 AM,145,289,269
Northern,Page County,51139,245,1390,1635,310,3296,3606,29072,370899,399971,07/01/2015 12:00:00 AM,119,267,245
Northern,Page County,51139,245,1414,1659,337,3331,3668,32660,367247,399907,08/01/2014 12:00:00 AM,133,260,241
Northern,Page County,51139,246,1397,1643,334,3292,3626,30384,363392,393776,09/01/2014 12:00:00 AM,124,260,240
Northern,Page County,51139,246,1453,1699,330,3389,3719,33790,385949,419739,03/01/2015 12:00:00 AM,137,266,247
Northern,Page County,51139,247,1520,1767,334,3605,3939,34276,438427,472703,09/01/2013 12:00:00 AM,139,288,268
Northern,Page County,51139,249,1563,1812,338,3716,4054,34509,458743,493252,06/01/2013 12:00:00 AM,139,294,272
Northern,Page County,51139,250,1040,1290,348,2197,2545,63603,378257.27,441860.27,04/01/2020 12:00:00 AM,254,364,343
Northern,Page County,51139,250,1057,1307,346,2218,2564,64310,382659,446969,05/01/2020 12:00:00 AM,257,362,342
Northern,Page County,51139,250,1531,1781,338,3644,3982,34080,445122,479202,07/01/2013 12:00:00 AM,136,291,269
Northern,Page County,51139,252,1038,1290,344,2177,2521,63255,374696,437951,08/01/2020 12:00:00 AM,251,361,339
Northern,Page County,51139,252,1518,1770,347,3593,3940,36243,434444,470687,08/01/2013 12:00:00 AM,144,286,266
Northern,Page County,51139,252,942,1194,358,1913,2271,82521,438958,521479,06/01/2021 12:00:00 AM,327,466,437
Northern,Page County,51139,253,1053,1306,349,2186,2535,65406,381596,447002,06/01/2020 12:00:00 AM,259,362,342
Northern,Page County,51139,253,1572,1825,359,3714,4073,37066,463645,500711,02/01/2013 12:00:00 AM,147,295,274
Northern,Page County,51139,253,988,1241,368,2101,2469,82443,448449,530892,01/01/2021 12:00:00 AM,326,454,428
Northern,Page County,51139,253,997,1250,358,2118,2476,68846,397432,466278,11/01/2020 12:00:00 AM,272,399,373
Northern,Page County,51139,254,1011,1265,349,2128,2477,67872,392385,460257,10/01/2020 12:00:00 AM,267,388,364
Northern,Page County,51139,254,1568,1822,342,3723,4065,34278,463007,497285,05/01/2013 12:00:00 AM,135,295,273
Northern,Page County,51139,255,1016,1271,357,2139,2496,66101,372797,438898,09/01/2020 12:00:00 AM,259,367,345
Northern,Page County,51139,255,1576,1831,355,3723,4078,36098,454826,490924,01/01/2013 12:00:00 AM,142,289,268
Northern,Page County,51139,255,1579,1834,361,3714,4075,37555,462136,499691,03/01/2013 12:00:00 AM,147,293,272
Northern,Page County,51139,255,957,1212,367,1956,2323,85864,448281,534145,05/01/2021 12:00:00 AM,337,468,441
Northern,Page County,51139,256,1011,1267,369,2132,2501,81132,454913,536045,02/01/2021 12:00:00 AM,317,450,423
Northern,Page County,51139,256,1063,1319,358,2226,2584,65858,387746,453604,07/01/2020 12:00:00 AM,257,365,344
Northern,Page County,51139,256,980,1236,371,2100,2471,71099,381343,452442,12/01/2020 12:00:00 AM,278,389,366
Northern,Page County,51139,257,1566,1823,357,3709,4066,37196,463433,500629,04/01/2013 12:00:00 AM,145,296,275
Northern,Page County,51139,257,974,1231,370,2023,2393,83336,456707,540043,04/01/2021 12:00:00 AM,324,469,439
Northern,Page County,51139,258,1006,1264,365,2115,2480,80296,442597,522893,03/01/2021 12:00:00 AM,311,440,414
Northern,Page County,51139,262,1492,1754,374,3497,3871,40987,428237,469224,10/01/2012 12:00:00 AM,156,287,268
Northern,Page County,51139,264,1551,1815,369,3638,4007,39410,450129,489539,12/01/2012 12:00:00 AM,149,290,270
Northern,Page County,51139,264,1559,1823,397,3639,4036,41197,446354,487551,01/01/2012 12:00:00 AM,156,286,267
Northern,Page County,51139,266,1560,1826,405,3628,4033,43700,450162,493862,02/01/2012 12:00:00 AM,164,289,270
Northern,Page County,51139,267,1527,1794,375,3591,3966,40701,442233,482934,11/01/2012 12:00:00 AM,152,290,269
Northern,Page County,51139,270,1563,1833,412,3636,4048,45045,449901,494946,03/01/2012 12:00:00 AM,167,288,270
Northern,Page County,51139,271,1531,1802,404,3582,3986,43233,442660,485893,05/01/2012 12:00:00 AM,160,289,270
Northern,Page County,51139,271,1555,1826,402,3630,4032,42581,447235,489816,04/01/2012 12:00:00 AM,157,288,268
Northern,Page County,51139,275,1500,1775,408,3486,3894,42952,426655,469607,06/01/2012 12:00:00 AM,156,284,265
Northern,Page County,51139,277,1474,1751,407,3448,3855,42999,428522,471521,07/01/2012 12:00:00 AM,155,291,269
Northern,Page County,51139,277,1488,1765,406,3498,3904,42673,429103,471776,09/01/2012 12:00:00 AM,154,288,267
Northern,Page County,51139,278,1489,1767,404,3470,3874,42843,426578,469421,08/01/2012 12:00:00 AM,154,286,266
Northern,Prince William County,51153,1656,8935,10591,2741,22911,25652,301022,2897085,3198107,03/01/2017 12:00:00 AM,182,324,302
Northern,Prince William County,51153,1666,8561,10227,2836,22035,24871,318781,2805714,3124495,05/01/2017 12:00:00 AM,191,328,306
Northern,Prince William County,51153,1679,8671,10350,2813,22265,25078,310276,2819080,3129356,04/01/2017 12:00:00 AM,185,325,302
Northern,Prince William County,51153,1681,9407,11088,2858,24404,27262,302519,2999526,3302045,09/01/2016 12:00:00 AM,180,319,298
Northern,Prince William County,51153,1694,7261,8955,2615,18198,20813,467655,3095868.7,3563523.7,03/01/2020 12:00:00 AM,276,426,398
Northern,Prince William County,51153,1700,7182,8882,2652,18055,20707,288496,2269524,2558020,02/01/2020 12:00:00 AM,170,316,288
Northern,Prince William County,51153,1703,8446,10149,2921,21915,24836,326644,2770519,3097163,07/01/2017 12:00:00 AM,192,328,305
Northern,Prince William County,51153,1707,9242,10949,2818,23847,26665,297885,2965842,3263727,01/01/2017 12:00:00 AM,175,321,298
Northern,Prince William County,51153,1709,7335,9044,2687,18431,21118,294319,2327704,2622023,12/01/2019 12:00:00 AM,172,317,290
Northern,Prince William County,51153,1711,9450,11161,2911,24514,27425,309351,3009310,3318661,08/01/2016 12:00:00 AM,181,318,297
Northern,Prince William County,51153,1712,7236,8948,2700,18185,20885,289059,2263179,2552238,01/01/2020 12:00:00 AM,169,313,285
Northern,Prince William County,51153,1715,9307,11022,2886,24169,27055,306765,3010623,3317388,10/01/2016 12:00:00 AM,179,323,301
Northern,Prince William County,51153,1717,8496,10213,2934,21931,24865,333053,2768728,3101781,06/01/2017 12:00:00 AM,194,326,304
Northern,Prince William County,51153,1718,9262,10980,2868,23950,26818,305688,2987996,3293684,12/01/2016 12:00:00 AM,178,323,300
Northern,Prince William County,51153,1721,7391,9112,2695,18523,21218,294841,2325109,2619950,11/01/2019 12:00:00 AM,171,315,288
Northern,Prince William County,51153,1722,7464,9186,2703,18670,21373,294370.76,2368642.54,2663013.3,10/01/2019 12:00:00 AM,171,317,290
Northern,Prince William County,51153,1722,9884,11606,2962,25347,28309,326798,3170656,3497454,11/01/2015 12:00:00 AM,190,321,301
Northern,Prince William County,51153,1723,9265,10988,2849,23822,26671,302649,2977904,3280553,02/01/2017 12:00:00 AM,176,321,299
Northern,Prince William County,51153,1724,9442,11166,2931,24456,27387,311113,3004884,3315997,07/01/2016 12:00:00 AM,180,318,297
Northern,Prince William County,51153,1726,9858,11584,2980,25337,28317,326450,3162785,3489235,12/01/2015 12:00:00 AM,189,321,301
Northern,Prince William County,51153,1728,7717,9445,2744,19266,22010,296154,2424024,2720178,08/01/2019 12:00:00 AM,171,314,288
Northern,Prince William County,51153,1728,8523,10251,2954,22067,25021,331272,2801182,3132454,08/01/2017 12:00:00 AM,192,329,306
Northern,Prince William County,51153,1728,9226,10954,2941,23835,26776,312953,2975485,3288438,11/01/2016 12:00:00 AM,181,323,300
Northern,Prince William County,51153,1728,9731,11459,2992,25107,28099,329037,3106620,3435657,01/01/2016 12:00:00 AM,190,319,300
Northern,Prince William County,51153,1731,9768,11499,3003,25098,28101,334659,3122172,3456831,02/01/2016 12:00:00 AM,193,320,301
Northern,Prince William County,51153,1732,7634,9366,2796,19117,21913,305062,2414383,2719445,02/01/2019 12:00:00 AM,176,316,290
Northern,Prince William County,51153,1732,8542,10274,2949,22041,24990,337897,2795752,3133649,10/01/2017 12:00:00 AM,195,327,305
Northern,Prince William County,51153,1735,9555,11290,2990,24702,27692,323251,3034371,3357622,06/01/2016 12:00:00 AM,186,318,297
Northern,Prince William County,51153,1737,7780,9517,2743,19463,22206,291394,2446628,2738022,07/01/2019 12:00:00 AM,168,314,288
Northern,Prince William County,51153,1739,9876,11615,2994,25330,28324,329217,3169183,3498400,10/01/2015 12:00:00 AM,189,321,301
Northern,Prince William County,51153,1742,9781,11523,3023,25114,28137,338491,3113764,3452255,03/01/2016 12:00:00 AM,194,318,300
Northern,Prince William County,51153,1745,7522,9267,2781,18819,21600,304200,2368554,2672754,09/01/2019 12:00:00 AM,174,315,288
Northern,Prince William County,51153,1746,9612,11358,3008,24693,27701,330864,3050691,3381555,04/01/2016 12:00:00 AM,189,317,298
Northern,Prince William County,51153,1748,9576,11324,3013,24669,27682,333217,3041916,3375133,05/01/2016 12:00:00 AM,191,318,298
Northern,Prince William County,51153,1754,7774,9528,2799,19422,22221,297917,2434868,2732785,06/01/2019 12:00:00 AM,170,313,287
Northern,Prince William County,51153,1755,7881,9636,2808,19804,22612,302256,2502498,2804754,05/01/2019 12:00:00 AM,172,318,291
Northern,Prince William County,51153,1756,8527,10283,3006,21978,24984,347488,2761828,3109316,11/01/2017 12:00:00 AM,198,324,302
Northern,Prince William County,51153,1757,8383,10140,2992,21446,24438,336394,2669612,3006006,03/01/2018 12:00:00 AM,191,318,296
Northern,Prince William County,51153,1758,8002,9760,2878,20088,22966,311211,2539178,2850389,03/01/2019 12:00:00 AM,177,317,292
Northern,Prince William County,51153,1758,8497,10255,2999,21961,24960,350026,2789550.1,3139576.1,09/01/2017 12:00:00 AM,199,328,306
Northern,Prince William County,51153,1758,9945,11703,3023,25425,28448,333227,3170579,3503806,08/01/2015 12:00:00 AM,190,319,299
Northern,Prince William County,51153,1759,9908,11667,3061,25324,28385,337188,3158584,3495772,09/01/2015 12:00:00 AM,192,319,300
Northern,Prince William County,51153,1762,8456,10218,2783,20830,23613,501757,3577240,4078997,04/01/2020 12:00:00 AM,285,423,399
Northern,Prince William County,51153,1763,8423,10186,2992,21651,24643,333764,2717449,3051213,02/01/2018 12:00:00 AM,189,323,300
Northern,Prince William County,51153,1765,7829,9594,2889,19673,22562,311209,2482264,2793473,04/01/2019 12:00:00 AM,176,317,291
Northern,Prince William County,51153,1767,8521,10288,2975,21919,24894,339752,2742180,3081932,12/01/2017 12:00:00 AM,192,322,300
Northern,Prince William County,51153,1767,9998,11765,3004,25635,28639,332689,3190644,3523333,07/01/2015 12:00:00 AM,188,319,299
Northern,Prince William County,51153,1771,8555,10326,3017,21996,25013,335024,2783766,3118790,01/01/2018 12:00:00 AM,189,325,302
Northern,Prince William County,51153,1794,8311,10105,3017,21165,24182,332547,2643622,2976169,07/01/2018 12:00:00 AM,185,318,295
Northern,Prince William County,51153,1795,8038,9833,2898,20430,23328,326729,2599569,2926298,12/01/2018 12:00:00 AM,182,323,298
Northern,Prince William County,51153,1796,8009,9805,2927,20193,23120,326870,2674141,3001011,01/01/2019 12:00:00 AM,182,334,306
Northern,Prince William County,51153,1798,8250,10048,3014,21037,24051,329251,2622098,2951349,08/01/2018 12:00:00 AM,183,318,294
Northern,Prince William County,51153,1798,8484,10282,3082,21619,24701,335579,2697181,3032760,05/01/2018 12:00:00 AM,187,318,295
Northern,Prince William County,51153,1799,10046,11845,3124,25741,28865,347910,3208484,3556394,06/01/2015 12:00:00 AM,193,319,300
Northern,Prince William County,51153,1801,8126,9927,2935,20727,23662,329027,2612721,2941748,11/01/2018 12:00:00 AM,183,322,296
Northern,Prince William County,51153,1801,8431,10232,3076,21557,24633,341881,2694277,3036158,04/01/2018 12:00:00 AM,190,320,297
Northern,Prince William County,51153,1804,8173,9977,2951,20857,23808,328997,2617920,2946917,10/01/2018 12:00:00 AM,182,320,295
Northern,Prince William County,51153,1806,10066,11872,3122,25766,28888,344041,3233747,3577788,05/01/2015 12:00:00 AM,190,321,301
Northern,Prince William County,51153,1808,10149,11957,3138,25835,28973,346157,3239239,3585396,04/01/2015 12:00:00 AM,191,319,300
Northern,Prince William County,51153,1808,10171,11979,3122,25878,29000,343310,3260105,3603415,03/01/2015 12:00:00 AM,190,321,301
Northern,Prince William County,51153,1810,8254,10064,3016,21055,24071,333184,2629797,2962981,09/01/2018 12:00:00 AM,184,319,294
Northern,Prince William County,51153,1811,8423,10234,3086,21444,24530,339891,2666704,3006595,06/01/2018 12:00:00 AM,188,317,294
Northern,Prince William County,51153,1813,10191,12004,3152,25889,29041,347511,3269449,3616960,02/01/2015 12:00:00 AM,192,321,301
Northern,Prince William County,51153,1816,8911,10727,2915,21771,24686,531289,3762072,4293361,05/01/2020 12:00:00 AM,293,422,400
Northern,Prince William County,51153,1828,8978,10806,2961,22111,25072,552103,4005275,4557378,10/01/2020 12:00:00 AM,302,446,422
Northern,Prince William County,51153,1830,9281,11111,2945,22703,25648,523690,3849885,4373575,08/01/2020 12:00:00 AM,286,415,394
Northern,Prince William County,51153,1836,9266,11102,2951,22748,25699,529144,3905918,4435062,09/01/2020 12:00:00 AM,288,422,399
Northern,Prince William County,51153,1840,8765,10605,2979,21707,24686,563013,3964735,4527748,11/01/2020 12:00:00 AM,306,452,427
Northern,Prince William County,51153,1846,10498,12344,3250,26259,29509,365520,3326820,3692340,11/01/2014 12:00:00 AM,198,317,299
Northern,Prince William County,51153,1846,9036,10882,2982,21981,24963,537385,3780266,4317651,06/01/2020 12:00:00 AM,291,418,397
Northern,Prince William County,51153,1847,10522,12369,3278,26344,29622,370493,3329995,3700488,12/01/2014 12:00:00 AM,201,316,299
Northern,Prince William County,51153,1849,9172,11021,2985,22319,25304,532514,3816400,4348914,07/01/2020 12:00:00 AM,288,416,395
Northern,Prince William County,51153,1861,10291,12152,3255,25949,29204,361764,3249542,3611306,01/01/2015 12:00:00 AM,194,316,297
Northern,Prince William County,51153,1872,10544,12416,3305,26304,29609,371645,3336135,3707780,10/01/2014 12:00:00 AM,199,316,299
Northern,Prince William County,51153,1893,10497,12390,3411,26123,29534,368367,3188056,3556423,09/01/2014 12:00:00 AM,195,304,287
Northern,Prince William County,51153,1893,10622,12515,3361,26303,29664,359623,3235589,3595212,08/01/2014 12:00:00 AM,190,305,287
Northern,Prince William County,51153,1897,10655,12552,3377,26282,29659,360549,3227920,3588469,07/01/2014 12:00:00 AM,190,303,286
Northern,Prince William County,51153,1897,8794,10691,3095,21801,24896,580868,3936668,4517536,12/01/2020 12:00:00 AM,306,448,423
Northern,Prince William County,51153,1933,11017,12950,3479,26919,30398,372035,3313199,3685234,04/01/2014 12:00:00 AM,192,301,285
Northern,Prince William County,51153,1950,8684,10634,3248,21518,24766,699660,4475117.96,5174777.96,01/01/2021 12:00:00 AM,359,515,487
Northern,Prince William County,51153,1954,10757,12711,3524,26402,29926,379898,3258218,3638116,06/01/2014 12:00:00 AM,194,303,286
Northern,Prince William County,51153,1954,11041,12995,3523,26967,30490,372691,3315826,3688517,02/01/2014 12:00:00 AM,191,300,284
Northern,Prince William County,51153,1955,10906,12861,3561,26637,30198,382505,3278825,3661330,05/01/2014 12:00:00 AM,196,301,285
Northern,Prince William County,51153,1967,11155,13122,3487,27152,30639,380403,3338763,3719166,11/01/2013 12:00:00 AM,193,299,283
Northern,Prince William County,51153,1968,8838,10806,3227,21818,25045,691054,4581882,5272936,02/01/2021 12:00:00 AM,351,518,488
Northern,Prince William County,51153,1970,11049,13019,3561,26995,30556,377525,3313600,3691125,03/01/2014 12:00:00 AM,192,300,284
Northern,Prince William County,51153,1975,11131,13106,3520,27075,30595,379183,3318450,3697633,12/01/2013 12:00:00 AM,192,298,282
Northern,Prince William County,51153,1990,11029,13019,3587,26888,30475,377715,3276548,3654263,01/01/2014 12:00:00 AM,190,297,281
Northern,Prince William County,51153,1990,11137,13127,3546,27089,30635,420586,3582539,4003125,10/01/2013 12:00:00 AM,211,322,305
Northern,Prince William County,51153,2011,11038,13049,3687,26605,30292,431906,3498988,3930894,04/01/2013 12:00:00 AM,215,317,301
Northern,Prince William County,51153,2018,10829,12847,3695,26148,29843,429357,3416528,3845885,01/01/2013 12:00:00 AM,213,315,299
Northern,Prince William County,51153,2018,8823,10841,3387,21667,25054,725020,4522511,5247531,03/01/2021 12:00:00 AM,359,513,484
Northern,Prince William County,51153,2020,10681,12701,3748,25806,29554,446076,3428501,3874577,10/01/2012 12:00:00 AM,221,321,305
Northern,Prince William County,51153,2023,10505,12528,3794,25371,29165,445184,3368563,3813747,09/01/2012 12:00:00 AM,220,321,304
Northern,Prince William County,51153,2028,10518,12546,3785,25415,29200,445559,3380214,3825773,08/01/2012 12:00:00 AM,220,321,305
Northern,Prince William County,51153,2031,11057,13088,3727,26716,30443,440225,3520452,3960677,05/01/2013 12:00:00 AM,217,318,303
Northern,Prince William County,51153,2036,11127,13163,3686,26906,30592,442219,3544736,3986955,09/01/2013 12:00:00 AM,217,319,303
Northern,Prince William County,51153,2037,10785,12822,3746,26224,29970,445903,3455682,3901585,12/01/2012 12:00:00 AM,219,320,304
Northern,Prince William County,51153,2038,10386,12424,3789,25089,28878,446215,3327961,3774176,07/01/2012 12:00:00 AM,219,320,304
Northern,Prince William County,51153,2038,8773,10811,3480,21441,24921,790843,4822077.5,5612920.5,05/01/2021 12:00:00 AM,388,550,519
Northern,Prince William County,51153,2040,11055,13095,3724,26718,30442,438525,3516653,3955178,07/01/2013 12:00:00 AM,215,318,302
Northern,Prince William County,51153,2044,11019,13063,3740,26704,30444,445379,3515483,3960862,06/01/2013 12:00:00 AM,218,319,303
Northern,Prince William County,51153,2046,8722,10768,3484,21303,24787,786234,4783629,5569863,06/01/2021 12:00:00 AM,384,548,517
Northern,Prince William County,51153,2047,10995,13042,3775,26434,30209,444033,3479960,3923993,03/01/2013 12:00:00 AM,217,317,301
Northern,Prince William County,51153,2047,8822,10869,3476,21613,25089,780501,4870171.5,5650672.5,04/01/2021 12:00:00 AM,381,552,520
Northern,Prince William County,51153,2050,10746,12796,3789,26048,29837,453259,3436305,3889564,11/01/2012 12:00:00 AM,221,320,304
Northern,Prince William County,51153,2052,10914,12966,3773,26312,30085,445149,3466427,3911576,02/01/2013 12:00:00 AM,217,318,302
Northern,Prince William County,51153,2054,11097,13151,3737,26854,30591,448536,3536493,3985029,08/01/2013 12:00:00 AM,218,319,303
Northern,Prince William County,51153,2067,10383,12450,3874,25072,28946,452625,3328641,3781266,06/01/2012 12:00:00 AM,219,321,304
Northern,Prince William County,51153,2071,10410,12481,3899,25108,29007,456179,3340429,3796608,05/01/2012 12:00:00 AM,220,321,304
Northern,Prince William County,51153,2086,10385,12471,3945,25072,29017,464358,3344961,3809319,04/01/2012 12:00:00 AM,223,322,305
Northern,Prince William County,51153,2102,10367,12469,3986,25125,29111,469921,3349312,3819233,02/01/2012 12:00:00 AM,224,323,306
Northern,Prince William County,51153,2109,10272,12381,3998,24890,28888,473381,3291313,3764694,01/01/2012 12:00:00 AM,224,320,304
Northern,Prince William County,51153,2112,10390,12502,4010,25115,29125,474494,3335280,3809774,03/01/2012 12:00:00 AM,225,321,305
Northern,Rappahannock County,51157,20,155,175,23,374,397,2341,38087,40428,09/01/2014 12:00:00 AM,117,246,231
Northern,Rappahannock County,51157,21,156,177,26,376,402,2922,40160,43082,10/01/2014 12:00:00 AM,139,257,243
Northern,Rappahannock County,51157,22,166,188,28,400,428,2916,42657,45573,07/01/2014 12:00:00 AM,133,257,242
Northern,Rappahannock County,51157,23,161,184,29,386,415,2951,41034,43985,08/01/2014 12:00:00 AM,128,255,239
Northern,Rappahannock County,51157,25,129,154,27,324,351,2706,36100,38806,12/01/2017 12:00:00 AM,108,280,252
Northern,Rappahannock County,51157,25,154,179,37,366,403,4682,39449,44131,11/01/2014 12:00:00 AM,187,256,247
Northern,Rappahannock County,51157,25,155,180,32,356,388,3619,38690,42309,01/01/2015 12:00:00 AM,145,250,235
Northern,Rappahannock County,51157,25,156,181,36,365,401,4326,38817,43143,12/01/2014 12:00:00 AM,173,249,238
Northern,Rappahannock County,51157,26,124,150,28,301,329,2532,33483,36015,01/01/2018 12:00:00 AM,97,270,240
Northern,Rappahannock County,51157,26,131,157,32,339,371,3020,35706,38726,11/01/2017 12:00:00 AM,116,273,247
Northern,Rappahannock County,51157,26,137,163,35,329,364,3791,34922,38713,01/01/2016 12:00:00 AM,146,255,238
Northern,Rappahannock County,51157,26,149,175,34,344,378,3633,37448,41081,02/01/2015 12:00:00 AM,140,251,235
Northern,Rappahannock County,51157,26,188,214,33,460,493,3495,55623,59118,06/01/2012 12:00:00 AM,134,296,276
Northern,Rappahannock County,51157,26,199,225,41,486,527,5068,56701,61769,01/01/2012 12:00:00 AM,195,285,275
Northern,Rappahannock County,51157,27,111,138,29,271,300,2643,29286,31929,02/01/2018 12:00:00 AM,98,264,231
Northern,Rappahannock County,51157,27,115,142,29,274,303,2477,30606,33083,03/01/2018 12:00:00 AM,92,266,233
Northern,Rappahannock County,51157,27,129,156,34,322,356,3778,38035,41813,07/01/2017 12:00:00 AM,140,295,268
Northern,Rappahannock County,51157,27,130,157,30,335,365,2771,35590,38361,09/01/2017 12:00:00 AM,103,274,244
Northern,Rappahannock County,51157,27,134,161,34,332,366,3542,35877,39419,05/01/2017 12:00:00 AM,131,268,245
Northern,Rappahannock County,51157,27,136,163,30,340,370,2692,37696,40388,10/01/2017 12:00:00 AM,100,277,248
Northern,Rappahannock County,51157,27,143,170,35,346,381,3754,38037,41791,02/01/2016 12:00:00 AM,139,266,246
Northern,Rappahannock County,51157,27,146,173,35,353,388,3755,39026,42781,03/01/2016 12:00:00 AM,139,267,247
Northern,Rappahannock County,51157,27,154,181,35,351,386,3665,38250,41915,03/01/2015 12:00:00 AM,136,248,232
Northern,Rappahannock County,51157,27,167,194,36,407,443,4171,42951,47122,06/01/2014 12:00:00 AM,154,257,243
Northern,Rappahannock County,51157,27,168,195,37,415,452,4464,43518,47982,05/01/2014 12:00:00 AM,165,259,246
Northern,Rappahannock County,51157,27,203,230,42,491,533,5085,58579,63664,02/01/2012 12:00:00 AM,188,289,277
Northern,Rappahannock County,51157,27,203,230,43,477,520,4802,58091,62893,04/01/2012 12:00:00 AM,178,286,273
Northern,Rappahannock County,51157,28,108,136,33,255,288,3001,27264,30265,04/01/2018 12:00:00 AM,107,252,223
Northern,Rappahannock County,51157,28,124,152,35,325,360,3872,33359,37231,08/01/2017 12:00:00 AM,138,269,245
Northern,Rappahannock County,51157,28,128,156,36,299,335,3808,32634,36442,11/01/2015 12:00:00 AM,136,255,234
Northern,Rappahannock County,51157,28,130,158,32,308,340,2978,32924,35902,09/01/2016 12:00:00 AM,106,253,227
Northern,Rappahannock County,51157,28,132,160,35,323,358,3287,33404,36691,02/01/2017 12:00:00 AM,117,253,229
Northern,Rappahannock County,51157,28,134,162,36,305,341,3704,32821,36525,12/01/2015 12:00:00 AM,132,245,225
Northern,Rappahannock County,51157,28,135,163,35,345,380,3809,36277,40086,04/01/2017 12:00:00 AM,136,269,246
Northern,Rappahannock County,51157,28,136,164,35,339,374,3710,36950,40660,06/01/2017 12:00:00 AM,133,272,248
Northern,Rappahannock County,51157,28,141,169,35,352,387,3465,36722,40187,03/01/2017 12:00:00 AM,124,260,238
Northern,Rappahannock County,51157,28,190,218,41,461,502,4299,55664,59963,08/01/2012 12:00:00 AM,154,293,275
Northern,Rappahannock County,51157,28,193,221,38,471,509,4236,57578,61814,09/01/2012 12:00:00 AM,151,298,280
Northern,Rappahannock County,51157,28,194,222,40,473,513,4318,57510,61828,07/01/2012 12:00:00 AM,154,296,279
Northern,Rappahannock County,51157,28,203,231,44,486,530,4998,58963,63961,05/01/2012 12:00:00 AM,179,290,277
Northern,Rappahannock County,51157,29,117,146,32,279,311,2710,30110,32820,11/01/2018 12:00:00 AM,93,257,225
Northern,Rappahannock County,51157,29,129,158,32,312,344,2865,36112,38977,06/01/2019 12:00:00 AM,99,280,247
Northern,Rappahannock County,51157,29,131,160,32,306,338,2961,36753,39714,03/01/2019 12:00:00 AM,102,281,248
Northern,Rappahannock County,51157,29,140,169,37,323,360,3549,36717,40266,08/01/2015 12:00:00 AM,122,262,238
Northern,Rappahannock County,51157,29,142,171,36,336,372,3717,36245,39962,06/01/2015 12:00:00 AM,128,255,234
Northern,Rappahannock County,51157,29,144,173,33,357,390,3049,40729,43778,11/01/2019 12:00:00 AM,105,283,253
Northern,Rappahannock County,51157,29,144,173,37,328,365,4067,37217,41284,05/01/2015 12:00:00 AM,140,258,239
Northern,Rappahannock County,51157,29,144,173,38,350,388,4321,37942,42263,05/01/2016 12:00:00 AM,149,263,244
Northern,Rappahannock County,51157,29,152,181,36,345,381,3858,38738,42596,04/01/2015 12:00:00 AM,133,255,235
Northern,Rappahannock County,51157,29,174,203,41,428,469,4886,45497,50383,04/01/2014 12:00:00 AM,168,261,248
Northern,Rappahannock County,51157,29,185,214,40,454,494,4840,52138,56978,10/01/2013 12:00:00 AM,167,282,266
Northern,Rappahannock County,51157,29,201,230,46,483,529,5093,58006,63099,03/01/2012 12:00:00 AM,176,289,274
Northern,Rappahannock County,51157,30,107,137,35,257,292,2943,27247,30190,05/01/2018 12:00:00 AM,98,255,220
Northern,Rappahannock County,51157,30,109,139,34,264,298,2936,29112,32048,09/01/2018 12:00:00 AM,98,267,231
Northern,Rappahannock County,51157,30,116,146,33,278,311,2923,32794,35717,02/01/2019 12:00:00 AM,97,283,245
Northern,Rappahannock County,51157,30,118,148,32,289,321,2309,29506,31815,06/01/2018 12:00:00 AM,77,250,215
Northern,Rappahannock County,51157,30,129,159,37,302,339,3804,32516,36320,08/01/2016 12:00:00 AM,127,252,228
Northern,Rappahannock County,51157,30,134,164,37,322,359,3474,35031,38505,10/01/2015 12:00:00 AM,116,261,235
Northern,Rappahannock County,51157,30,136,166,37,320,357,3779,35364,39143,09/01/2015 12:00:00 AM,126,260,236
Northern,Rappahannock County,51157,30,143,173,40,346,386,4648,37729,42377,04/01/2016 12:00:00 AM,155,264,245
Northern,Rappahannock County,51157,30,144,174,36,334,370,3641,35821,39462,07/01/2015 12:00:00 AM,121,249,227
Northern,Rappahannock County,51157,30,168,198,44,409,453,5399,43155,48554,03/01/2014 12:00:00 AM,180,257,245
Northern,Rappahannock County,51157,30,171,201,43,409,452,5067,44039,49106,02/01/2014 12:00:00 AM,169,258,244
Northern,Rappahannock County,51157,31,116,147,35,286,321,3210,32886,36096,10/01/2018 12:00:00 AM,104,284,246
Northern,Rappahannock County,51157,31,121,152,34,287,321,2858,32139,34997,12/01/2018 12:00:00 AM,92,266,230
Northern,Rappahannock County,51157,31,123,154,39,291,330,4032,33919,37951,04/01/2019 12:00:00 AM,130,276,246
Northern,Rappahannock County,51157,31,127,158,40,303,343,4102,30766,34868,10/01/2016 12:00:00 AM,132,242,221
Northern,Rappahannock County,51157,31,129,160,40,311,351,4138,31236,35374,11/01/2016 12:00:00 AM,133,242,221
Northern,Rappahannock County,51157,31,130,161,36,306,342,3541,35581,39122,07/01/2019 12:00:00 AM,114,274,243
Northern,Rappahannock County,51157,31,135,166,37,334,371,3545,37551,41096,10/01/2019 12:00:00 AM,114,278,248
Northern,Rappahannock County,51157,31,136,167,36,328,364,3528,38017,41545,08/01/2019 12:00:00 AM,114,280,249
Northern,Rappahannock County,51157,31,137,168,36,332,368,3477,38492,41969,09/01/2019 12:00:00 AM,112,281,250
Northern,Rappahannock County,51157,31,175,206,45,423,468,4821,44475,49296,12/01/2013 12:00:00 AM,156,254,239
Northern,Rappahannock County,51157,31,181,212,46,433,479,4914,50978,55892,04/01/2013 12:00:00 AM,159,282,264
Northern,Rappahannock County,51157,31,189,220,45,457,502,5270,53847,59117,09/01/2013 12:00:00 AM,170,285,269
Northern,Rappahannock County,51157,31,192,223,38,487,525,4569,59930,64499,11/01/2012 12:00:00 AM,147,312,289
Northern,Rappahannock County,51157,31,197,228,42,492,534,5252,59765,65017,12/01/2012 12:00:00 AM,169,303,285
Northern,Rappahannock County,51157,31,198,229,44,496,540,5280,60960,66240,10/01/2012 12:00:00 AM,170,308,289
Northern,Rappahannock County,51157,31,201,232,38,484,522,4071,59551,63622,02/01/2013 12:00:00 AM,131,296,274
Northern,Rappahannock County,51157,32,120,152,36,290,326,3351,34318,37669,01/01/2019 12:00:00 AM,105,286,248
Northern,Rappahannock County,51157,32,126,158,41,303,344,4159,31423,35582,12/01/2016 12:00:00 AM,130,249,225
Northern,Rappahannock County,51157,32,127,159,39,309,348,3901,36316,40217,05/01/2019 12:00:00 AM,122,286,253
Northern,Rappahannock County,51157,32,131,163,41,320,361,4669,33209,37878,01/01/2017 12:00:00 AM,146,254,232
Northern,Rappahannock County,51157,32,136,168,41,323,364,4618,33766,38384,07/01/2016 12:00:00 AM,144,248,228
Northern,Rappahannock County,51157,32,138,170,36,340,376,3450,38607,42057,01/01/2020 12:00:00 AM,108,280,247
Northern,Rappahannock County,51157,32,138,170,42,337,379,4856,35375,40231,06/01/2016 12:00:00 AM,152,256,237
Northern,Rappahannock County,51157,32,139,171,36,351,387,3484,42351,45835,12/01/2019 12:00:00 AM,109,305,268
Northern,Rappahannock County,51157,32,180,212,48,439,487,5703,46530,52233,11/01/2013 12:00:00 AM,178,259,246
Northern,Rappahannock County,51157,32,188,220,47,451,498,5185,53455,58640,05/01/2013 12:00:00 AM,162,284,267
Northern,Rappahannock County,51157,33,114,147,37,278,315,3104,28933,32037,07/01/2018 12:00:00 AM,94,254,218
Northern,Rappahannock County,51157,33,115,148,37,283,320,3007,29834,32841,08/01/2018 12:00:00 AM,91,259,222
Northern,Rappahannock County,51157,33,142,175,40,356,396,4081,41160,45241,02/01/2020 12:00:00 AM,124,290,259
Northern,Rappahannock County,51157,33,183,216,51,447,498,6286,51102,57388,08/01/2013 12:00:00 AM,190,279,266
Northern,Rappahannock County,51157,33,200,233,43,489,532,5266,59401,64667,01/01/2013 12:00:00 AM,160,297,278
Northern,Rappahannock County,51157,34,140,174,40,354,394,7365,59069,66434,03/01/2020 12:00:00 AM,217,422,382
Northern,Rappahannock County,51157,34,170,204,50,401,451,4610,42595,47205,01/01/2014 12:00:00 AM,136,251,231
Northern,Rappahannock County,51157,35,155,190,40,381,421,7689,69404,77093,11/01/2020 12:00:00 AM,220,448,406
Northern,Rappahannock County,51157,35,178,213,56,436,492,6452,49748,56200,07/01/2013 12:00:00 AM,184,279,264
Northern,Rappahannock County,51157,35,187,222,51,445,496,5740,53720,59460,03/01/2013 12:00:00 AM,164,287,268
Northern,Rappahannock County,51157,35,189,224,51,449,500,5911,53247,59158,06/01/2013 12:00:00 AM,169,282,264
Northern,Rappahannock County,51157,36,153,189,42,381,423,7907,64813,72720,04/01/2020 12:00:00 AM,220,424,385
Northern,Rappahannock County,51157,36,165,201,42,400,442,7997,67783,75780,06/01/2020 12:00:00 AM,222,411,377
Northern,Rappahannock County,51157,37,154,191,44,400,444,10034,83606,93640,02/01/2021 12:00:00 AM,271,543,490
Northern,Rappahannock County,51157,37,155,192,44,377,421,8704,67562,76266,10/01/2020 12:00:00 AM,235,436,397
Northern,Rappahannock County,51157,38,159,197,44,394,438,8213,66630,74843,05/01/2020 12:00:00 AM,216,419,380
Northern,Rappahannock County,51157,38,160,198,45,394,439,8468,66358,74826,09/01/2020 12:00:00 AM,223,415,378
Northern,Rappahannock County,51157,38,160,198,45,408,453,10214,81535,91749,03/01/2021 12:00:00 AM,269,510,463
Northern,Rappahannock County,51157,39,158,197,46,378,424,8796,64363,73159,08/01/2020 12:00:00 AM,226,407,371
Northern,Rappahannock County,51157,39,162,201,46,418,464,11083,89705,100788,04/01/2021 12:00:00 AM,284,554,501
Northern,Rappahannock County,51157,39,163,202,46,387,433,8173,65954,74127,07/01/2020 12:00:00 AM,210,405,367
Northern,Rappahannock County,51157,40,155,195,48,404,452,11280,88675,99955,05/01/2021 12:00:00 AM,282,572,513
Northern,Rappahannock County,51157,41,153,194,53,389,442,10712,67584,78296,12/01/2020 12:00:00 AM,261,442,404
Northern,Rappahannock County,51157,42,150,192,54,390,444,11957,79629,91586,01/01/2021 12:00:00 AM,285,531,477
Northern,Rappahannock County,51157,43,153,196,51,387,438,12211,81553,93764,06/01/2021 12:00:00 AM,284,533,478
Northern,Rockingham County,51165,325,2009,2334,446,5080,5526,39317,554251,593568,10/01/2014 12:00:00 AM,121,276,254
Northern,Rockingham County,51165,327,1447,1774,460,3403,3863,38933,365368,404301,10/01/2019 12:00:00 AM,119,253,228
Northern,Rockingham County,51165,329,1854,2183,449,4748,5197,38973,510071,549044,08/01/2015 12:00:00 AM,118,275,252
Northern,Rockingham County,51165,329,1944,2273,465,4900,5365,42270,529337,571607,02/01/2015 12:00:00 AM,128,272,251
Northern,Rockingham County,51165,329,2014,2343,457,5029,5486,40669,552253,592922,12/01/2014 12:00:00 AM,124,274,253
Northern,Rockingham County,51165,331,1442,1773,469,3444,3913,38338,367112,405450,09/01/2019 12:00:00 AM,116,255,229
Northern,Rockingham County,51165,331,1446,1777,456,3451,3907,37214,356570,393784,01/01/2020 12:00:00 AM,112,247,222
Northern,Rockingham County,51165,331,1899,2230,459,4866,5325,39156,530442,569598,04/01/2015 12:00:00 AM,118,279,255
Northern,Rockingham County,51165,332,1460,1792,459,3445,3904,36945,368454,405399,08/01/2019 12:00:00 AM,111,252,226
Northern,Rockingham County,51165,332,1631,1963,446,3778,4224,100206,798562,898768,02/01/2021 12:00:00 AM,302,490,458
Northern,Rockingham County,51165,332,2047,2379,477,5175,5652,38686,540734,579420,09/01/2014 12:00:00 AM,117,264,244
Northern,Rockingham County,51165,333,1445,1778,462,3409,3871,39545,358490,398035,12/01/2019 12:00:00 AM,119,248,224
Northern,Rockingham County,51165,333,1566,1899,481,3947,4428,45858,429371,475229,06/01/2017 12:00:00 AM,138,274,250
Northern,Rockingham County,51165,333,1708,2041,484,4348,4832,41384,456900,498284,05/01/2016 12:00:00 AM,124,268,244
Northern,Rockingham County,51165,333,2006,2339,465,5043,5508,42468,548508,590976,11/01/2014 12:00:00 AM,128,273,253
Northern,Rockingham County,51165,334,1905,2239,471,4845,5316,42528,520452,562980,03/01/2015 12:00:00 AM,127,273,251
Northern,Rockingham County,51165,335,1540,1875,482,3875,4357,45628,421848,467476,07/01/2017 12:00:00 AM,136,274,249
Northern,Rockingham County,51165,335,1700,2035,478,4320,4798,42894,449502,492396,07/01/2016 12:00:00 AM,128,264,242
Northern,Rockingham County,51165,335,1901,2236,462,4848,5310,42149,518370,560519,06/01/2015 12:00:00 AM,126,273,251
Northern,Rockingham County,51165,335,2104,2439,460,5333,5793,38180,564906,603086,07/01/2014 12:00:00 AM,114,268,247
Northern,Rockingham County,51165,335,2172,2507,533,5485,6018,55439,639763,695202,07/01/2012 12:00:00 AM,165,295,277
Northern,Rockingham County,51165,336,1441,1777,486,3384,3870,42491,359371.31,401862.31,11/01/2019 12:00:00 AM,126,249,226
Northern,Rockingham County,51165,336,1780,2116,455,4530,4985,40326,490191,530517,02/01/2016 12:00:00 AM,120,275,251
Northern,Rockingham County,51165,336,1887,2223,462,4815,5277,40322,520588,560910,05/01/2015 12:00:00 AM,120,276,252
Northern,Rockingham County,51165,336,2134,2470,474,5358,5832,38917,569809,608726,06/01/2014 12:00:00 AM,116,267,246
Northern,Rockingham County,51165,336,2202,2538,514,5535,6049,49926,640988,690914,06/01/2013 12:00:00 AM,149,291,272
Northern,Rockingham County,51165,336,2212,2548,510,5519,6029,50027,627362,677389,05/01/2013 12:00:00 AM,149,284,266
Northern,Rockingham County,51165,337,1759,2096,460,4467,4927,40247,476135,516382,03/01/2016 12:00:00 AM,119,271,246
Northern,Rockingham County,51165,338,1449,1787,477,3466,3943,39678,372963,412641,06/01/2019 12:00:00 AM,117,257,231
Northern,Rockingham County,51165,338,1639,1977,468,3837,4305,84748,668013,752761,09/01/2020 12:00:00 AM,251,408,381
Northern,Rockingham County,51165,338,1716,2054,479,4359,4838,41471,455281,496752,06/01/2016 12:00:00 AM,123,265,242
Northern,Rockingham County,51165,338,1719,2057,469,4407,4876,40061,466615,506676,04/01/2016 12:00:00 AM,119,271,246
Northern,Rockingham County,51165,338,1849,2187,447,4715,5162,39589,510538,550127,12/01/2015 12:00:00 AM,117,276,252
Northern,Rockingham County,51165,338,1873,2211,470,4804,5274,42894,515150,558044,07/01/2015 12:00:00 AM,127,275,252
Northern,Rockingham County,51165,339,1603,1942,480,3762,4242,91694,699022,790716,11/01/2020 12:00:00 AM,270,436,407
Northern,Rockingham County,51165,339,1664,2003,467,4264,4731,41687,445137,486824,10/01/2016 12:00:00 AM,123,268,243
Northern,Rockingham County,51165,340,1564,1904,500,3914,4414,47707,423332,471039,05/01/2017 12:00:00 AM,140,271,247
Northern,Rockingham County,51165,340,1602,1942,473,3721,4194,103357,772215,875572,01/01/2021 12:00:00 AM,304,482,451
Northern,Rockingham County,51165,340,1631,1971,468,4182,4650,41449,434471,475920,11/01/2016 12:00:00 AM,122,266,241
Northern,Rockingham County,51165,340,1965,2305,486,4928,5414,44058,526151,570209,01/01/2015 12:00:00 AM,130,268,247
Northern,Rockingham County,51165,340,2074,2414,487,5261,5748,40775,556932,597707,08/01/2014 12:00:00 AM,120,269,248
Northern,Rockingham County,51165,340,2175,2515,489,5361,5850,40755,561936,602691,03/01/2014 12:00:00 AM,120,258,240
Northern,Rockingham County,51165,341,1446,1787,483,3444,3927,42281,360976,403257,02/01/2020 12:00:00 AM,124,250,226
Northern,Rockingham County,51165,341,1464,1805,482,3494,3976,85581,589971,675552,03/01/2020 12:00:00 AM,251,403,374
Northern,Rockingham County,51165,341,1562,1903,475,3902,4377,43427,420788,464215,08/01/2017 12:00:00 AM,127,269,244
Northern,Rockingham County,51165,341,1675,2016,474,4255,4729,41764,440119,481883,08/01/2016 12:00:00 AM,122,263,239
Northern,Rockingham County,51165,341,2164,2505,493,5368,5861,39411,564139,603550,04/01/2014 12:00:00 AM,116,261,241
Northern,Rockingham County,51165,342,1438,1780,483,3440,3923,40331,368099,408430,07/01/2019 12:00:00 AM,118,256,229
Northern,Rockingham County,51165,342,1612,1954,480,3785,4265,92524,680956,773480,10/01/2020 12:00:00 AM,271,422,396
Northern,Rockingham County,51165,342,1842,2184,468,4707,5175,42407,506700,549107,11/01/2015 12:00:00 AM,124,275,251
Northern,Rockingham County,51165,342,2168,2510,498,5362,5860,42311,561093,603404,02/01/2014 12:00:00 AM,124,259,240
Northern,Rockingham County,51165,343,1572,1915,499,3958,4457,47027,421309,468336,04/01/2017 12:00:00 AM,137,268,245
Northern,Rockingham County,51165,343,1631,1974,452,3778,4230,104787,846467,951254,05/01/2021 12:00:00 AM,306,519,482
Northern,Rockingham County,51165,343,1638,1981,479,4204,4683,41738,431772,473510,09/01/2016 12:00:00 AM,122,264,239
Northern,Rockingham County,51165,343,2194,2537,557,5555,6112,58408,636527,694935,05/01/2012 12:00:00 AM,170,290,274
Northern,Rockingham County,51165,344,1450,1794,487,3470,3957,40007,376349,416356,05/01/2019 12:00:00 AM,116,260,232
Northern,Rockingham County,51165,344,1576,1920,501,3970,4471,45515,429248,474763,09/01/2017 12:00:00 AM,132,272,247
Northern,Rockingham County,51165,344,1794,2138,469,4579,5048,42415,487207,529622,01/01/2016 12:00:00 AM,123,272,248
Northern,Rockingham County,51165,344,1843,2187,469,4712,5181,42262,501849,544111,09/01/2015 12:00:00 AM,123,272,249
Northern,Rockingham County,51165,344,2170,2514,553,5497,6050,57451,641386,698837,08/01/2012 12:00:00 AM,167,296,278
Northern,Rockingham County,51165,344,2185,2529,552,5574,6126,55586,640885,696471,06/01/2012 12:00:00 AM,162,293,275
Northern,Rockingham County,51165,344,2239,2583,566,5686,6252,60658,657863,718521,04/01/2012 12:00:00 AM,176,294,278
Northern,Rockingham County,51165,345,1602,1947,496,4060,4556,47105,427204,474309,03/01/2017 12:00:00 AM,137,267,244
Northern,Rockingham County,51165,345,1653,1998,463,3824,4287,103440,803650,907090,03/01/2021 12:00:00 AM,300,486,454
Northern,Rockingham County,51165,345,2192,2537,531,5536,6067,50066,634664,684730,08/01/2013 12:00:00 AM,145,290,270
Northern,Rockingham County,51165,345,2193,2538,521,5538,6059,49519,636870,686389,07/01/2013 12:00:00 AM,144,290,270
Northern,Rockingham County,51165,346,1636,1982,504,4210,4714,47735,438376,486111,02/01/2017 12:00:00 AM,138,268,245
Northern,Rockingham County,51165,347,1446,1793,493,3449,3942,42554,379504,422058,02/01/2019 12:00:00 AM,123,262,235
Northern,Rockingham County,51165,347,1598,1945,487,3736,4223,94661,683181,777842,12/01/2020 12:00:00 AM,273,428,400
Northern,Rockingham County,51165,347,1628,1975,486,4196,4682,45426,434399,479825,01/01/2017 12:00:00 AM,131,267,243
Northern,Rockingham County,51165,347,1630,1977,486,4215,4701,43212,434383,477595,12/01/2016 12:00:00 AM,125,266,242
Northern,Rockingham County,51165,347,2165,2512,496,5409,5905,40470,566035,606505,05/01/2014 12:00:00 AM,117,261,241
Northern,Rockingham County,51165,348,1631,1979,455,3782,4237,105792,846619,952411,06/01/2021 12:00:00 AM,304,519,481
Northern,Rockingham County,51165,348,1822,2170,467,4630,5097,42205,496347,538552,10/01/2015 12:00:00 AM,121,272,248
Northern,Rockingham County,51165,348,2175,2523,507,5385,5892,42218,554309,596527,01/01/2014 12:00:00 AM,121,255,236
Northern,Rockingham County,51165,349,1579,1928,503,3829,4332,43807,406953,450760,03/01/2018 12:00:00 AM,126,258,234
Northern,Rockingham County,51165,349,1602,1951,484,3782,4266,89308,649924,739232,04/01/2020 12:00:00 AM,256,406,379
Northern,Rockingham County,51165,349,1633,1982,476,3842,4318,86766,654172,740938,08/01/2020 12:00:00 AM,249,401,374
Northern,Rockingham County,51165,349,1655,2004,465,3801,4266,108591,851167,959758,04/01/2021 12:00:00 AM,311,514,479
Northern,Rockingham County,51165,349,2159,2508,527,5372,5899,50550,614029,664579,10/01/2013 12:00:00 AM,145,284,265
Northern,Rockingham County,51165,350,1575,1925,518,3914,4432,47452,419410,466862,11/01/2017 12:00:00 AM,136,266,243
Northern,Rockingham County,51165,350,1580,1930,518,3859,4377,47743,409342,457085,12/01/2017 12:00:00 AM,136,259,237
Northern,Rockingham County,51165,350,1590,1940,515,3855,4370,43808,414978,458786,01/01/2018 12:00:00 AM,125,261,236
Northern,Rockingham County,51165,351,1556,1907,522,3874,4396,46683,416005,462688,10/01/2017 12:00:00 AM,133,267,243
Northern,Rockingham County,51165,352,2166,2518,518,5406,5924,46060,567995,614055,11/01/2013 12:00:00 AM,131,262,244
Northern,Rockingham County,51165,353,1625,1978,493,3772,4265,89115,643103,732218,06/01/2020 12:00:00 AM,252,396,370
Northern,Rockingham County,51165,353,2162,2515,570,5459,6029,59988,633865,693853,09/01/2012 12:00:00 AM,170,293,276
Northern,Rockingham County,51165,353,2179,2532,517,5414,5931,44904,561641,606545,12/01/2013 12:00:00 AM,127,258,240
Northern,Rockingham County,51165,354,1479,1833,517,3551,4068,44646,383855,428501,04/01/2019 12:00:00 AM,126,260,234
Northern,Rockingham County,51165,354,1515,1869,505,3664,4169,44591,413112,457703,01/01/2019 12:00:00 AM,126,273,245
Northern,Rockingham County,51165,354,1636,1990,497,3844,4341,90684,659825,750509,05/01/2020 12:00:00 AM,256,403,377
Northern,Rockingham County,51165,355,1576,1931,525,3836,4361,46727,404941,451668,02/01/2018 12:00:00 AM,132,257,234
Northern,Rockingham County,51165,355,2167,2522,535,5436,5971,49702,627863,677565,09/01/2013 12:00:00 AM,140,290,269
Northern,Rockingham County,51165,356,1489,1845,512,3536,4048,43843,386982,430825,03/01/2019 12:00:00 AM,123,260,234
Northern,Rockingham County,51165,357,1637,1994,496,3825,4321,92109,655135,747244,07/01/2020 12:00:00 AM,258,400,375
Northern,Rockingham County,51165,358,1479,1837,522,3602,4124,48986,379846,428832,12/01/2018 12:00:00 AM,137,257,233
Northern,Rockingham County,51165,358,2190,2548,566,5468,6034,56938,620472,677410,04/01/2013 12:00:00 AM,159,283,266
Northern,Rockingham County,51165,358,2192,2550,581,5523,6104,62363,633997,696360,10/01/2012 12:00:00 AM,174,289,273
Northern,Rockingham County,51165,359,2228,2587,592,5659,6251,61952,658338,720290,03/01/2012 12:00:00 AM,173,295,278
Northern,Rockingham County,51165,359,2253,2612,596,5707,6303,61253,658830,720083,02/01/2012 12:00:00 AM,171,292,276
Northern,Rockingham County,51165,360,1561,1921,504,3834,4338,45279,407995,453274,04/01/2018 12:00:00 AM,126,261,236
Northern,Rockingham County,51165,360,2234,2594,590,5602,6192,62215,641211,703426,11/01/2012 12:00:00 AM,173,287,271
Northern,Rockingham County,51165,360,2261,2621,604,5729,6333,63143,652170,715313,01/01/2012 12:00:00 AM,175,288,273
Northern,Rockingham County,51165,361,2219,2580,579,5560,6139,59154,637839,696993,03/01/2013 12:00:00 AM,164,287,270
Northern,Rockingham County,51165,363,2253,2616,578,5645,6223,58737,643742,702479,02/01/2013 12:00:00 AM,162,286,269
Northern,Rockingham County,51165,364,1497,1861,539,3656,4195,51226,391055,442281,11/01/2018 12:00:00 AM,141,261,238
Northern,Rockingham County,51165,364,1517,1881,526,3725,4251,48875,404746,453621,07/01/2018 12:00:00 AM,134,267,241
Northern,Rockingham County,51165,367,2202,2569,578,5507,6085,57798,624669,682467,01/01/2013 12:00:00 AM,157,284,266
Northern,Rockingham County,51165,369,1529,1898,532,3738,4270,48742,395373,444115,05/01/2018 12:00:00 AM,132,259,234
Northern,Rockingham County,51165,371,1502,1873,552,3613,4165,54299,389859,444158,10/01/2018 12:00:00 AM,146,260,237
Northern,Rockingham County,51165,372,1514,1886,541,3708,4249,48441,396245,444686,06/01/2018 12:00:00 AM,130,262,236
Northern,Rockingham County,51165,372,1523,1895,549,3735,4284,49518,399339,448857,08/01/2018 12:00:00 AM,133,262,237
Northern,Rockingham County,51165,372,2212,2584,600,5534,6134,63772,635909,699681,12/01/2012 12:00:00 AM,171,287,271
Northern,Rockingham County,51165,376,1512,1888,561,3671,4232,52265,394183,446448,09/01/2018 12:00:00 AM,139,261,236
Northern,Shenandoah County,51171,271,2018,2289,408,4881,5289,38606,567092,605698,08/01/2014 12:00:00 AM,142,281,265
Northern,Shenandoah County,51171,277,1789,2066,336,4293,4629,75015,902513,977528,02/01/2021 12:00:00 AM,271,504,473
Northern,Shenandoah County,51171,280,1991,2271,413,4807,5220,39399,554305,593704,09/01/2014 12:00:00 AM,141,278,261
Northern,Shenandoah County,51171,281,1786,2067,359,4233,4592,83523,937822,1021345,04/01/2021 12:00:00 AM,297,525,494
Northern,Shenandoah County,51171,281,1789,2070,367,4240,4607,86082,942584,1028666,05/01/2021 12:00:00 AM,306,527,497
Northern,Shenandoah County,51171,281,2029,2310,441,4883,5324,44175,565090,609265,07/01/2014 12:00:00 AM,157,279,264
Northern,Shenandoah County,51171,281,2071,2352,436,4956,5392,44507,590548,635055,05/01/2014 12:00:00 AM,158,285,270
Northern,Shenandoah County,51171,283,1519,1802,384,3804,4188,38680,454126,492806,07/01/2017 12:00:00 AM,137,299,273
Northern,Shenandoah County,51171,283,2107,2390,438,5018,5456,43456,597545,641001,04/01/2014 12:00:00 AM,154,284,268
Northern,Shenandoah County,51171,284,1785,2069,365,4232,4597,83338,950873,1034211,06/01/2021 12:00:00 AM,293,533,500
Northern,Shenandoah County,51171,284,1813,2097,364,4310,4674,83091,888265,971356,03/01/2021 12:00:00 AM,293,490,463
Northern,Shenandoah County,51171,284,2059,2343,441,4938,5379,44547,578842,623389,06/01/2014 12:00:00 AM,157,281,266
Northern,Shenandoah County,51171,284,2066,2350,467,5108,5575,54183,644365,698548,04/01/2012 12:00:00 AM,191,312,297
Northern,Shenandoah County,51171,285,1512,1797,384,3687,4071,34536,427704,462240,02/01/2020 12:00:00 AM,121,283,257
Northern,Shenandoah County,51171,285,1810,2095,450,4443,4893,47894,514056,561950,08/01/2015 12:00:00 AM,168,284,268
Northern,Shenandoah County,51171,285,2126,2411,441,5083,5524,43109,597296,640405,02/01/2014 12:00:00 AM,151,281,266
Northern,Shenandoah County,51171,286,1823,2109,446,4433,4879,48268,517037,565305,07/01/2015 12:00:00 AM,169,284,268
Northern,Shenandoah County,51171,286,2072,2358,476,5125,5601,55648,641141,696789,03/01/2012 12:00:00 AM,195,309,296
Northern,Shenandoah County,51171,287,1540,1827,391,3835,4226,40424,465376,505800,06/01/2017 12:00:00 AM,141,302,277
Northern,Shenandoah County,51171,288,1524,1812,390,3663,4053,36127,425934,462061,01/01/2020 12:00:00 AM,125,279,255
Northern,Shenandoah County,51171,288,1574,1862,382,3895,4277,40438,459421,499859,11/01/2017 12:00:00 AM,140,292,268
Northern,Shenandoah County,51171,288,1625,1913,400,3990,4390,39270,462201,501471,01/01/2017 12:00:00 AM,136,284,262
Northern,Shenandoah County,51171,288,2071,2359,481,5115,5596,57422,639946,697368,02/01/2012 12:00:00 AM,199,309,296
Northern,Shenandoah County,51171,288,2181,2469,457,5326,5783,51206,682263,733469,04/01/2013 12:00:00 AM,178,313,297
Northern,Shenandoah County,51171,289,1494,1783,378,3645,4023,35161,428952,464113,11/01/2019 12:00:00 AM,122,287,260
Northern,Shenandoah County,51171,289,1541,1830,395,3800,4195,39958,454895,494853,05/01/2017 12:00:00 AM,138,295,270
Northern,Shenandoah County,51171,289,1569,1858,388,3789,4177,39694,454749,494443,03/01/2017 12:00:00 AM,137,290,266
Northern,Shenandoah County,51171,289,1791,2080,452,4363,4815,48580,502205,550785,09/01/2015 12:00:00 AM,168,280,265
Northern,Shenandoah County,51171,289,2164,2453,453,5225,5678,50508,664343,714851,09/01/2013 12:00:00 AM,175,307,291
Northern,Shenandoah County,51171,290,1534,1824,390,3735,4125,71787,630788,702575,03/01/2020 12:00:00 AM,248,411,385
Northern,Shenandoah County,51171,290,2102,2392,456,5009,5465,44912,588869,633781,03/01/2014 12:00:00 AM,155,280,265
Northern,Shenandoah County,51171,290,2143,2433,437,5163,5600,43131,598398,641529,01/01/2014 12:00:00 AM,149,279,264
Northern,Shenandoah County,51171,290,2159,2449,442,5221,5663,44975,612584,657559,11/01/2013 12:00:00 AM,155,284,269
Northern,Shenandoah County,51171,291,1454,1745,392,3488,3880,37678,412170,449848,02/01/2019 12:00:00 AM,129,283,258
Northern,Shenandoah County,51171,291,1517,1808,392,3790,4182,39542,451592,491134,08/01/2017 12:00:00 AM,136,298,272
Northern,Shenandoah County,51171,291,1542,1833,396,3789,4185,38127,442570,480697,04/01/2018 12:00:00 AM,131,287,262
Northern,Shenandoah County,51171,291,1549,1840,391,3848,4239,39867,446824,486691,12/01/2017 12:00:00 AM,137,288,265
Northern,Shenandoah County,51171,291,1561,1852,391,3864,4255,39687,454019,493706,10/01/2017 12:00:00 AM,136,291,267
Northern,Shenandoah County,51171,291,1573,1864,381,3905,4286,35817,454509,490326,02/01/2018 12:00:00 AM,123,289,263
Northern,Shenandoah County,51171,291,2155,2446,458,5226,5684,52552,664619,717171,08/01/2013 12:00:00 AM,181,308,293
Northern,Shenandoah County,51171,292,1518,1810,387,3674,4061,37155,437565,474720,12/01/2019 12:00:00 AM,127,288,262
Northern,Shenandoah County,51171,292,1776,2068,456,4362,4818,49463,498661,548124,10/01/2015 12:00:00 AM,169,281,265
Northern,Shenandoah County,51171,292,2099,2391,465,5173,5638,54478,653633,708111,09/01/2012 12:00:00 AM,187,311,296
Northern,Shenandoah County,51171,292,2148,2440,440,5198,5638,45614,607981,653595,12/01/2013 12:00:00 AM,156,283,268
Northern,Shenandoah County,51171,292,2163,2455,463,5222,5685,52226,658665,710891,10/01/2013 12:00:00 AM,179,305,290
Northern,Shenandoah County,51171,292,2171,2463,466,5281,5747,52952,669794,722746,03/01/2013 12:00:00 AM,181,309,293
Northern,Shenandoah County,51171,293,1556,1849,398,3807,4205,39846,461735,501581,04/01/2017 12:00:00 AM,136,297,271
Northern,Shenandoah County,51171,293,1643,1936,408,4044,4452,39091,465874,504965,12/01/2016 12:00:00 AM,133,284,261
Northern,Shenandoah County,51171,293,1767,2060,399,4241,4640,88528,875590,964118,01/01/2021 12:00:00 AM,302,496,468
Northern,Shenandoah County,51171,293,1890,2183,453,4608,5061,48882,540306,589188,05/01/2015 12:00:00 AM,167,286,270
Northern,Shenandoah County,51171,293,2051,2344,483,5048,5531,57821,626720,684541,01/01/2012 12:00:00 AM,197,306,292
Northern,Shenandoah County,51171,293,2174,2467,463,5338,5801,52971,676621,729592,02/01/2013 12:00:00 AM,181,311,296
Northern,Shenandoah County,51171,294,1478,1772,382,3643,4025,36691,428522,465213,09/01/2018 12:00:00 AM,125,290,263
Northern,Shenandoah County,51171,294,1482,1776,390,3645,4035,37922,430344,468266,11/01/2018 12:00:00 AM,129,290,264
Northern,Shenandoah County,51171,294,1490,1784,388,3671,4059,37539,438085,475624,10/01/2018 12:00:00 AM,128,294,267
Northern,Shenandoah County,51171,294,1496,1790,379,3638,4017,35343,432669,468012,10/01/2019 12:00:00 AM,120,289,261
Northern,Shenandoah County,51171,294,1539,1833,396,3856,4252,40326,464453,504779,09/01/2017 12:00:00 AM,137,302,275
Northern,Shenandoah County,51171,294,2159,2453,463,5253,5716,53270,661536,714806,01/01/2013 12:00:00 AM,181,306,291
Northern,Shenandoah County,51171,295,1470,1765,406,3597,4003,40618,423137,463755,07/01/2018 12:00:00 AM,138,288,263
Northern,Shenandoah County,51171,295,1497,1792,398,3670,4068,38485,432986,471471,08/01/2018 12:00:00 AM,130,289,263
Northern,Shenandoah County,51171,295,1509,1804,388,3717,4105,33374,439805,473179,06/01/2019 12:00:00 AM,113,291,262
Northern,Shenandoah County,51171,295,1510,1805,387,3748,4135,34498,434251,468749,08/01/2019 12:00:00 AM,117,288,260
Northern,Shenandoah County,51171,295,1559,1854,397,3841,4238,38692,446853,485545,01/01/2018 12:00:00 AM,131,287,262
Northern,Shenandoah County,51171,295,1642,1937,408,3997,4405,74403,682554,756957,04/01/2020 12:00:00 AM,252,416,391
Northern,Shenandoah County,51171,295,1728,2023,407,4166,4573,79100,755453,834553,11/01/2020 12:00:00 AM,268,437,413
Northern,Shenandoah County,51171,295,1758,2053,405,4212,4617,79359,760159,839518,12/01/2020 12:00:00 AM,269,432,409
Northern,Shenandoah County,51171,295,2148,2443,462,5268,5730,53041,673643,726684,07/01/2013 12:00:00 AM,180,314,297
Northern,Shenandoah County,51171,295,2201,2496,465,5383,5848,53614,688700,742314,05/01/2013 12:00:00 AM,182,313,297
Northern,Shenandoah County,51171,296,1502,1798,400,3654,4054,40284,430488,470772,12/01/2018 12:00:00 AM,136,287,262
Northern,Shenandoah County,51171,296,1526,1822,412,3736,4148,39662,441493,481155,05/01/2018 12:00:00 AM,134,289,264
Northern,Shenandoah County,51171,296,1637,1933,409,4041,4450,39034,467758,506792,11/01/2016 12:00:00 AM,132,286,262
Northern,Shenandoah County,51171,296,1921,2217,438,4649,5087,47426,547747,595173,01/01/2015 12:00:00 AM,160,285,268
Northern,Shenandoah County,51171,296,2019,2315,446,4864,5310,48068,584116,632184,10/01/2014 12:00:00 AM,162,289,273
Northern,Shenandoah County,51171,296,2171,2467,457,5330,5787,51355,684803,736158,06/01/2013 12:00:00 AM,173,315,298
Northern,Shenandoah County,51171,297,1545,1842,399,3780,4179,38839,453709,492548,03/01/2019 12:00:00 AM,131,294,267
Northern,Shenandoah County,51171,297,1668,1965,412,4104,4516,41189,483862,525051,02/01/2017 12:00:00 AM,139,290,267
Northern,Shenandoah County,51171,297,1748,2045,404,4258,4662,77422,765667,843089,10/01/2020 12:00:00 AM,261,438,412
Northern,Shenandoah County,51171,297,1850,2147,484,4461,4945,53112,523260,576372,06/01/2015 12:00:00 AM,179,283,268
Northern,Shenandoah County,51171,297,1986,2283,440,4789,5229,49359,577232,626591,11/01/2014 12:00:00 AM,166,291,274
Northern,Shenandoah County,51171,297,2057,2354,482,5080,5562,55487,645229,700716,05/01/2012 12:00:00 AM,187,314,298
Northern,Shenandoah County,51171,298,1682,1980,416,4145,4561,39634,480991,520625,09/01/2016 12:00:00 AM,133,286,263
Northern,Shenandoah County,51171,298,1690,1988,423,4091,4514,39493,476641,516134,07/01/2016 12:00:00 AM,133,282,260
Northern,Shenandoah County,51171,298,1705,2003,410,4148,4558,38343,483936,522279,08/01/2016 12:00:00 AM,129,284,261
Northern,Shenandoah County,51171,298,1948,2246,458,4689,5147,51662,561261,612923,12/01/2014 12:00:00 AM,173,288,273
Northern,Shenandoah County,51171,299,1531,1830,394,3778,4172,35425,449696,485121,07/01/2019 12:00:00 AM,118,294,265
Northern,Shenandoah County,51171,299,1687,1986,418,4131,4549,39644,480008,519652,10/01/2016 12:00:00 AM,133,285,262
Northern,Shenandoah County,51171,299,1920,2219,463,4668,5131,51109,556267,607376,02/01/2015 12:00:00 AM,171,290,274
Northern,Shenandoah County,51171,300,1509,1809,390,3727,4117,35736,442171,477907,04/01/2019 12:00:00 AM,119,293,264
Northern,Shenandoah County,51171,300,1518,1818,394,3755,4149,36848,441469,478317,09/01/2019 12:00:00 AM,123,291,263
Northern,Shenandoah County,51171,300,1675,1975,423,4080,4503,76863,688721,765584,05/01/2020 12:00:00 AM,256,411,388
Northern,Shenandoah County,51171,300,1902,2202,456,4645,5101,49524,540055,589579,04/01/2015 12:00:00 AM,165,284,268
Northern,Shenandoah County,51171,300,2126,2426,495,5178,5673,59849,655011,714860,12/01/2012 12:00:00 AM,199,308,295
Northern,Shenandoah County,51171,301,1530,1831,409,3711,4120,38945,465204,504149,01/01/2019 12:00:00 AM,129,304,275
Northern,Shenandoah County,51171,301,1769,2070,444,4307,4751,45404,496060,541464,02/01/2016 12:00:00 AM,151,280,262
Northern,Shenandoah County,51171,301,1780,2081,453,4388,4841,48779,501232,550011,11/01/2015 12:00:00 AM,162,282,264
Northern,Shenandoah County,51171,301,2050,2351,508,5071,5579,60342,642865,703207,06/01/2012 12:00:00 AM,200,314,299
Northern,Shenandoah County,51171,302,1558,1860,413,3860,4273,40613,449655,490268,03/01/2018 12:00:00 AM,134,289,264
Northern,Shenandoah County,51171,302,1694,1996,431,4097,4528,79233,697827,777060,06/01/2020 12:00:00 AM,262,412,389
Northern,Shenandoah County,51171,302,1706,2008,437,4176,4613,41900,484223,526123,05/01/2016 12:00:00 AM,139,284,262
Northern,Shenandoah County,51171,302,2101,2403,514,5127,5641,62913,643789,706702,10/01/2012 12:00:00 AM,208,306,294
Northern,Shenandoah County,51171,303,1520,1823,400,3731,4131,37351,451876,489227,05/01/2019 12:00:00 AM,123,297,268
Northern,Shenandoah County,51171,303,1532,1835,429,3754,4183,43308,444502,487810,06/01/2018 12:00:00 AM,143,290,266
Northern,Shenandoah County,51171,303,1708,2011,435,4141,4576,41748,484326,526074,06/01/2016 12:00:00 AM,138,284,262
Northern,Shenandoah County,51171,303,1738,2041,437,4204,4641,79069,715420,794489,07/01/2020 12:00:00 AM,261,412,389
Northern,Shenandoah County,51171,304,1769,2073,448,4245,4693,81764,724291,806055,08/01/2020 12:00:00 AM,269,409,389
Northern,Shenandoah County,51171,304,1931,2235,457,4680,5137,50441,551172,601613,03/01/2015 12:00:00 AM,166,285,269
Northern,Shenandoah County,51171,305,1712,2017,449,4158,4607,43444,484000,527444,04/01/2016 12:00:00 AM,142,283,261
Northern,Shenandoah County,51171,306,1787,2093,451,4391,4842,47986,505281,553267,12/01/2015 12:00:00 AM,157,283,264
Northern,Shenandoah County,51171,306,2085,2391,501,5108,5609,60628,645607,706235,08/01/2012 12:00:00 AM,198,310,295
Northern,Shenandoah County,51171,306,2088,2394,499,5130,5629,59682,647501,707183,07/01/2012 12:00:00 AM,195,310,295
Northern,Shenandoah County,51171,306,2113,2419,516,5132,5648,64033,648297,712330,11/01/2012 12:00:00 AM,209,307,294
Northern,Shenandoah County,51171,307,1770,2077,451,4353,4804,46615,498522,545137,01/01/2016 12:00:00 AM,152,282,262
Northern,Shenandoah County,51171,308,1736,2044,453,4232,4685,45092,490797,535889,03/01/2016 12:00:00 AM,146,283,262
Northern,Shenandoah County,51171,310,1748,2058,449,4250,4699,82092,730605,812697,09/01/2020 12:00:00 AM,265,418,395
Northern,Spotsylvania County,51177,580,3973,4553,934,10188,11122,107546,1245860,1353406,02/01/2016 12:00:00 AM,185,314,297
Northern,Spotsylvania County,51177,589,3967,4556,941,10202,11143,107824,1243088,1350912,03/01/2016 12:00:00 AM,183,313,297
Northern,Spotsylvania County,51177,590,3460,4050,923,8524,9447,101123,1041405,1142528,08/01/2019 12:00:00 AM,171,301,282
Northern,Spotsylvania County,51177,590,3613,4203,943,9207,10150,104231,1137814,1242045,03/01/2017 12:00:00 AM,177,315,296
Northern,Spotsylvania County,51177,590,3996,4586,961,10270,11231,112869,1249486,1362355,12/01/2015 12:00:00 AM,191,313,297
Northern,Spotsylvania County,51177,592,3575,4167,933,9193,10126,104947,1160575,1265522,06/01/2017 12:00:00 AM,177,325,304
Northern,Spotsylvania County,51177,592,3994,4586,999,10234,11233,118296,1246313,1364609,11/01/2015 12:00:00 AM,200,312,298
Northern,Spotsylvania County,51177,593,3515,4108,925,9073,9998,103297,1141115,1244412,07/01/2017 12:00:00 AM,174,325,303
Northern,Spotsylvania County,51177,593,3551,4144,924,9120,10044,103798,1134762,1238560,05/01/2017 12:00:00 AM,175,320,299
Northern,Spotsylvania County,51177,594,3430,4024,939,8501,9440,105955,1037323,1143278,09/01/2019 12:00:00 AM,178,302,284
Northern,Spotsylvania County,51177,594,3586,4180,943,9220,10163,105884,1142405,1248289,04/01/2017 12:00:00 AM,178,319,299
Northern,Spotsylvania County,51177,594,3790,4384,991,9782,10773,112902,1169639,1282541,09/01/2016 12:00:00 AM,190,309,293
Northern,Spotsylvania County,51177,595,3546,4141,958,9205,10163,109050,1153087,1262137,10/01/2017 12:00:00 AM,183,325,305
Northern,Spotsylvania County,51177,595,4302,4897,1177,10636,11813,143953,1400665,1544618,04/01/2012 12:00:00 AM,242,326,315
Northern,Spotsylvania County,51177,597,3729,4326,1005,9642,10647,115154,1166971,1282125,10/01/2016 12:00:00 AM,193,313,296
Northern,Spotsylvania County,51177,597,3859,4456,986,9932,10918,113893,1184201,1298094,06/01/2016 12:00:00 AM,191,307,291
Northern,Spotsylvania County,51177,598,3384,3982,1000,8583,9583,115208,1057725,1172933,10/01/2018 12:00:00 AM,193,313,295
Northern,Spotsylvania County,51177,598,3679,4277,962,9483,10445,105597,1154679,1260276,01/01/2017 12:00:00 AM,177,314,295
Northern,Spotsylvania County,51177,598,3958,4556,982,10168,11150,116050,1230396,1346446,01/01/2016 12:00:00 AM,194,311,296
Northern,Spotsylvania County,51177,598,3959,4557,1037,10108,11145,122083,1236950,1359033,10/01/2015 12:00:00 AM,204,312,298
Northern,Spotsylvania County,51177,599,3553,4152,973,9183,10156,110305,1143995,1254300,11/01/2017 12:00:00 AM,184,322,302
Northern,Spotsylvania County,51177,600,3905,4505,1086,9965,11051,123236,1220797,1344033,06/01/2015 12:00:00 AM,205,313,298
Northern,Spotsylvania County,51177,601,3762,4363,957,9632,10589,106407,1174634,1281041,02/01/2017 12:00:00 AM,177,312,294
Northern,Spotsylvania County,51177,601,3898,4499,1044,9977,11021,119083,1212633,1331716,08/01/2015 12:00:00 AM,198,311,296
Northern,Spotsylvania County,51177,603,3448,4051,941,8478,9419,104714,1045299,1150013,10/01/2019 12:00:00 AM,174,303,284
Northern,Spotsylvania County,51177,603,3458,4061,963,8475,9438,107080,1038540,1145620,07/01/2019 12:00:00 AM,178,300,282
Northern,Spotsylvania County,51177,603,3525,4128,1001,9046,10047,118151,1120576,1238727,01/01/2018 12:00:00 AM,196,318,300
Northern,Spotsylvania County,51177,603,3575,4178,974,9201,10175,113214,1173766,1286980,08/01/2017 12:00:00 AM,188,328,308
Northern,Spotsylvania County,51177,603,3720,4323,991,9583,10574,111681,1164176,1275857,11/01/2016 12:00:00 AM,185,313,295
Northern,Spotsylvania County,51177,604,3408,4012,1005,8630,9635,115994,1070072.63,1186066.63,11/01/2018 12:00:00 AM,192,314,296
Northern,Spotsylvania County,51177,604,3559,4163,972,9198,10170,112784,1169062,1281846,09/01/2017 12:00:00 AM,187,328,308
Northern,Spotsylvania County,51177,604,3800,4404,1018,9837,10855,116140,1189060,1305200,08/01/2016 12:00:00 AM,192,313,296
Northern,Spotsylvania County,51177,604,3874,4478,1093,9915,11008,124158,1206598,1330756,07/01/2015 12:00:00 AM,206,311,297
Northern,Spotsylvania County,51177,604,3933,4537,993,10040,11033,113771,1219005,1332776,04/01/2016 12:00:00 AM,188,310,294
Northern,Spotsylvania County,51177,605,3863,4468,1010,9945,10955,116258,1200293,1316551,05/01/2016 12:00:00 AM,192,311,295
Northern,Spotsylvania County,51177,605,3933,4538,1042,10033,11075,122420,1229726,1352146,09/01/2015 12:00:00 AM,202,313,298
Northern,Spotsylvania County,51177,606,3468,4074,955,8504,9459,107269,1038652,1145921,11/01/2019 12:00:00 AM,177,299,281
Northern,Spotsylvania County,51177,606,3936,4542,1080,10040,11120,122819,1230184,1353003,05/01/2015 12:00:00 AM,203,313,298
Northern,Spotsylvania County,51177,607,3487,4094,991,8560,9551,108713,1042493,1151206,06/01/2019 12:00:00 AM,179,299,281
Northern,Spotsylvania County,51177,608,3790,4398,1045,9724,10769,118682,1175054,1293736,07/01/2016 12:00:00 AM,195,310,294
Northern,Spotsylvania County,51177,608,3967,4575,1067,10116,11183,121856,1234975,1356831,04/01/2015 12:00:00 AM,200,311,297
Northern,Spotsylvania County,51177,610,3377,3987,1007,8519,9526,116533,1068464,1184997,12/01/2018 12:00:00 AM,191,316,297
Northern,Spotsylvania County,51177,611,3689,4300,1007,9464,10471,112226,1152340,1264566,12/01/2016 12:00:00 AM,184,312,294
Northern,Spotsylvania County,51177,611,4339,4950,1188,10603,11791,145728,1398536,1544264,08/01/2012 12:00:00 AM,239,322,312
Northern,Spotsylvania County,51177,612,3365,3977,1022,8557,9579,119620,1051886,1171506,09/01/2018 12:00:00 AM,195,313,295
Northern,Spotsylvania County,51177,612,3453,4065,991,8524,9515,108453,1039077,1147530,05/01/2019 12:00:00 AM,177,301,282
Northern,Spotsylvania County,51177,613,3574,4187,1006,9177,10183,117046,1151026,1268072,12/01/2017 12:00:00 AM,191,322,303
Northern,Spotsylvania County,51177,613,4305,4918,1224,10641,11865,150806,1398664,1549470,05/01/2012 12:00:00 AM,246,325,315
Northern,Spotsylvania County,51177,614,3378,3992,1009,8415,9424,111352,1042689,1154041,02/01/2019 12:00:00 AM,181,309,289
Northern,Spotsylvania County,51177,614,3465,4079,953,8547,9500,108669,1049733,1158402,12/01/2019 12:00:00 AM,177,303,284
Northern,Spotsylvania County,51177,614,3983,4597,1076,10130,11206,120237,1240633,1360870,03/01/2015 12:00:00 AM,196,311,296
Northern,Spotsylvania County,51177,615,4338,4953,1239,10717,11956,152703,1408829,1561532,03/01/2012 12:00:00 AM,248,325,315
Northern,Spotsylvania County,51177,616,3398,4014,1029,8457,9486,115256,1067790,1183046,01/01/2019 12:00:00 AM,187,314,295
Northern,Spotsylvania County,51177,617,3454,4071,1012,8480,9492,112870,1045322,1158192,03/01/2019 12:00:00 AM,183,303,284
Northern,Spotsylvania County,51177,618,3525,4143,1035,9029,10064,121243,1125237,1246480,02/01/2018 12:00:00 AM,196,319,301
Northern,Spotsylvania County,51177,619,4310,4929,1240,10639,11879,156977,1395498,1552475,01/01/2012 12:00:00 AM,254,324,315
Northern,Spotsylvania County,51177,620,3409,4029,1043,8720,9763,121733,1075810,1197543,08/01/2018 12:00:00 AM,196,316,297
Northern,Spotsylvania County,51177,620,3410,4030,969,8425,9394,105333,1029045,1134378,01/01/2020 12:00:00 AM,170,302,281
Northern,Spotsylvania County,51177,621,4300,4921,1236,10582,11818,149989,1393427,1543416,06/01/2012 12:00:00 AM,242,324,314
Northern,Spotsylvania County,51177,622,3359,3981,1052,8531,9583,121670,1046623,1168293,07/01/2018 12:00:00 AM,196,312,293
Northern,Spotsylvania County,51177,622,3408,4030,1037,8653,9690,120696,1071613,1192309,06/01/2018 12:00:00 AM,194,314,296
Northern,Spotsylvania County,51177,623,4254,4877,1241,10465,11706,151973,1386693,1538666,07/01/2012 12:00:00 AM,244,326,315
Northern,Spotsylvania County,51177,624,3455,4079,1022,8551,9573,112878,1044544,1157422,04/01/2019 12:00:00 AM,181,302,284
Northern,Spotsylvania County,51177,624,4303,4927,1220,10541,11761,152961,1397841,1550802,09/01/2012 12:00:00 AM,245,325,315
Northern,Spotsylvania County,51177,627,3451,4078,1056,8760,9816,124667,1082175,1206842,04/01/2018 12:00:00 AM,199,314,296
Northern,Spotsylvania County,51177,627,3464,4091,1061,8814,9875,124271,1095811,1220082,03/01/2018 12:00:00 AM,198,316,298
Northern,Spotsylvania County,51177,628,4347,4975,1270,10714,11984,159078,1416152,1575230,02/01/2012 12:00:00 AM,253,326,317
Northern,Spotsylvania County,51177,629,3349,3978,981,8286,9267,107035,1015938,1122973,02/01/2020 12:00:00 AM,170,303,282
Northern,Spotsylvania County,51177,630,3982,4612,1126,10128,11254,127829,1250231,1378060,02/01/2015 12:00:00 AM,203,314,299
Northern,Spotsylvania County,51177,631,4008,4639,996,9468,10464,218238,1986673,2204911,02/01/2021 12:00:00 AM,346,496,475
Northern,Spotsylvania County,51177,632,3448,4080,1063,8733,9796,127584,1072079.97,1199663.97,05/01/2018 12:00:00 AM,202,311,294
Northern,Spotsylvania County,51177,632,4072,4704,1152,10348,11500,130360,1291176,1421536,12/01/2014 12:00:00 AM,206,317,302
Northern,Spotsylvania County,51177,635,4011,4646,1175,10112,11287,138371,1229962,1368333,09/01/2014 12:00:00 AM,218,307,295
Northern,Spotsylvania County,51177,635,4418,5053,1198,10824,12022,149596,1450825,1600421,03/01/2013 12:00:00 AM,236,328,317
Northern,Spotsylvania County,51177,635,4445,5080,1138,10830,11968,138840,1424403,1563243,08/01/2013 12:00:00 AM,219,320,308
Northern,Spotsylvania County,51177,637,4347,4984,1229,10657,11886,153819,1409504,1563323,12/01/2012 12:00:00 AM,241,324,314
Northern,Spotsylvania County,51177,639,4067,4706,1159,10333,11492,133673,1291684,1425357,11/01/2014 12:00:00 AM,209,318,303
Northern,Spotsylvania County,51177,640,4420,5060,1176,10755,11931,144618,1419618,1564236,07/01/2013 12:00:00 AM,226,321,309
Northern,Spotsylvania County,51177,641,4028,4669,1163,10222,11385,129898,1250664,1380562,01/01/2015 12:00:00 AM,203,310,296
Northern,Spotsylvania County,51177,641,4399,5040,1194,10688,11882,147155,1419870,1567025,05/01/2013 12:00:00 AM,230,323,311
Northern,Spotsylvania County,51177,642,4404,5046,1213,10755,11968,150004,1435095,1585099,04/01/2013 12:00:00 AM,234,326,314
Northern,Spotsylvania County,51177,643,3399,4042,1027,8378,9405,184371,1424256,1608627,03/01/2020 12:00:00 AM,287,419,398
Northern,Spotsylvania County,51177,644,4404,5048,1189,10726,11915,146972,1420342,1567314,06/01/2013 12:00:00 AM,228,323,310
Northern,Spotsylvania County,51177,646,4313,4959,1259,10567,11826,156578,1410725,1567303,10/01/2012 12:00:00 AM,242,327,316
Northern,Spotsylvania County,51177,646,4488,5134,1165,10923,12088,143661,1427502,1571163,09/01/2013 12:00:00 AM,222,318,306
Northern,Spotsylvania County,51177,647,4003,4650,1202,10204,11406,139719,1278601,1418320,10/01/2014 12:00:00 AM,216,319,305
Northern,Spotsylvania County,51177,647,4233,4880,1204,10465,11669,140033,1281158,1421191,07/01/2014 12:00:00 AM,216,303,291
Northern,Spotsylvania County,51177,648,4337,4985,1267,10617,11884,158375,1408250,1566625,11/01/2012 12:00:00 AM,244,325,314
Northern,Spotsylvania County,51177,651,3982,4633,1025,9387,10412,221204,1950848,2172052,03/01/2021 12:00:00 AM,340,490,469
Northern,Spotsylvania County,51177,651,4369,5020,1240,10726,11966,156744,1425429,1582173,02/01/2013 12:00:00 AM,241,326,315
Northern,Spotsylvania County,51177,651,4421,5072,1187,10816,12003,138968,1327415,1466383,04/01/2014 12:00:00 AM,213,300,289
Northern,Spotsylvania County,51177,651,4485,5136,1200,10916,12116,139832,1329490,1469322,03/01/2014 12:00:00 AM,215,296,286
Northern,Spotsylvania County,51177,652,4073,4725,1222,10153,11375,142991,1238868,1381859,08/01/2014 12:00:00 AM,219,304,292
Northern,Spotsylvania County,51177,652,4377,5029,1215,10736,11951,140727,1319023,1459750,06/01/2014 12:00:00 AM,216,301,290
Northern,Spotsylvania County,51177,653,4345,4998,1252,10685,11937,155544,1401943,1557487,01/01/2013 12:00:00 AM,238,323,312
Northern,Spotsylvania County,51177,655,4537,5192,1170,11095,12265,145487,1447210,1592697,10/01/2013 12:00:00 AM,222,319,307
Northern,Spotsylvania County,51177,656,4487,5143,1155,11016,12171,133890,1343904,1477794,11/01/2013 12:00:00 AM,204,300,287
Northern,Spotsylvania County,51177,657,4428,5085,1209,10825,12034,142817,1331544,1474361,05/01/2014 12:00:00 AM,217,301,290
Northern,Spotsylvania County,51177,658,3786,4444,1043,9189,10232,186536,1572557,1759093,04/01/2020 12:00:00 AM,283,415,396
Northern,Spotsylvania County,51177,661,3923,4584,1061,9229,10290,245072,2091170,2336242,04/01/2021 12:00:00 AM,371,533,510
Northern,Spotsylvania County,51177,664,4494,5158,1183,11050,12233,138393,1340400,1478793,12/01/2013 12:00:00 AM,208,298,287
Northern,Spotsylvania County,51177,667,4479,5146,1200,11022,12222,139018,1322509,1461527,01/01/2014 12:00:00 AM,208,295,284
Northern,Spotsylvania County,51177,669,4496,5165,1220,11007,12227,142578,1337486,1480064,02/01/2014 12:00:00 AM,213,297,287
Northern,Spotsylvania County,51177,674,3884,4558,1082,9126,10208,247302,2059529,2306831,05/01/2021 12:00:00 AM,367,530,506
Northern,Spotsylvania County,51177,678,3936,4614,1077,9464,10541,193616,1621077,1814693,05/01/2020 12:00:00 AM,286,412,393
Northern,Spotsylvania County,51177,679,4018,4697,1110,9519,10629,205617,1731806,1937423,12/01/2020 12:00:00 AM,303,431,412
Northern,Spotsylvania County,51177,682,3848,4530,1118,9117,10235,254179,2050021,2304200,06/01/2021 12:00:00 AM,373,533,509
Northern,Spotsylvania County,51177,683,4100,4783,1097,9803,10900,197143,1667284,1864427,08/01/2020 12:00:00 AM,289,407,390
Northern,Spotsylvania County,51177,684,4092,4776,1100,9781,10881,199105,1682027,1881132,09/01/2020 12:00:00 AM,291,411,394
Northern,Spotsylvania County,51177,687,4017,4704,1120,9578,10698,210147,1740957,1951104,10/01/2020 12:00:00 AM,306,433,415
Northern,Spotsylvania County,51177,692,4014,4706,1115,9618,10733,199512,1652302,1851814,06/01/2020 12:00:00 AM,288,412,394
Northern,Spotsylvania County,51177,693,3982,4675,1138,9503,10641,217963,1735489,1953452,11/01/2020 12:00:00 AM,315,436,418
Northern,Spotsylvania County,51177,694,3958,4652,1154,9369,10523,250391,1934341,2184732,01/01/2021 12:00:00 AM,361,489,470
Northern,Spotsylvania County,51177,698,4099,4797,1123,9811,10934,201871,1672634,1874505,07/01/2020 12:00:00 AM,289,408,391
Northern,Stafford County,51179,418,2644,3062,771,6965,7736,88458,907210,995668,04/01/2018 12:00:00 AM,212,343,325
Northern,Stafford County,51179,425,2659,3084,791,7051,7842,91854,914433,1006287,02/01/2018 12:00:00 AM,216,344,326
Northern,Stafford County,51179,426,2632,3058,751,6961,7712,85133,912710,997843,04/01/2017 12:00:00 AM,200,347,326
Northern,Stafford County,51179,429,2680,3109,773,7071,7844,88215,915376,1003591,05/01/2018 12:00:00 AM,206,342,323
Northern,Stafford County,51179,429,2696,3125,754,7148,7902,82387,942904,1025291,03/01/2017 12:00:00 AM,192,350,328
Northern,Stafford County,51179,431,2654,3085,771,7002,7773,87422,905757,993179,06/01/2018 12:00:00 AM,203,341,322
Northern,Stafford County,51179,431,2966,3397,798,8028,8826,92488,1017803,1110291,11/01/2015 12:00:00 AM,215,343,327
Northern,Stafford County,51179,432,2703,3135,817,7186,8003,94197,945244.58,1039441.58,01/01/2018 12:00:00 AM,218,350,332
Northern,Stafford County,51179,432,2760,3192,821,7482,8303,90926,953693,1044619,11/01/2016 12:00:00 AM,210,346,327
Northern,Stafford County,51179,433,2652,3085,792,7058,7850,100435,941206,1041641,08/01/2017 12:00:00 AM,232,355,338
Northern,Stafford County,51179,434,2694,3128,808,7156,7964,95998,927588,1023586,11/01/2017 12:00:00 AM,221,344,327
Northern,Stafford County,51179,435,2681,3116,813,7161,7974,97262,927941,1025203,12/01/2017 12:00:00 AM,224,346,329
Northern,Stafford County,51179,437,2618,3055,768,6943,7711,88275,900870,989145,07/01/2018 12:00:00 AM,202,344,324
Northern,Stafford County,51179,437,2800,3237,830,7537,8367,93369,956971,1050340,10/01/2016 12:00:00 AM,214,342,324
Northern,Stafford County,51179,438,2609,3047,801,6930,7731,94495,904203,998698,07/01/2017 12:00:00 AM,216,347,328
Northern,Stafford County,51179,438,2951,3389,819,8039,8858,95162,1009501,1104663,10/01/2015 12:00:00 AM,217,342,326
Northern,Stafford County,51179,438,2962,3400,824,8052,8876,95083,1001720,1096803,09/01/2015 12:00:00 AM,217,338,323
Northern,Stafford County,51179,440,2957,3397,835,8015,8850,96051,1013024,1109075,12/01/2015 12:00:00 AM,218,343,326
Northern,Stafford County,51179,441,2705,3146,809,7156,7965,94167,949718,1043885,03/01/2018 12:00:00 AM,214,351,332
Northern,Stafford County,51179,441,2717,3158,818,7221,8039,97066,938701.56,1035767.56,10/01/2017 12:00:00 AM,220,345,328
Northern,Stafford County,51179,443,2523,2966,777,6639,7416,88386,867610,955996,02/01/2019 12:00:00 AM,200,344,322
Northern,Stafford County,51179,443,2653,3096,804,7043,7847,93194,913935,1007129,06/01/2017 12:00:00 AM,210,344,325
Northern,Stafford County,51179,444,2663,3107,801,7026,7827,90000,920629,1010629,05/01/2017 12:00:00 AM,203,346,325
Northern,Stafford County,51179,444,2743,3187,843,7404,8247,92362,939309,1031671,01/01/2017 12:00:00 AM,208,342,324
Northern,Stafford County,51179,444,2926,3370,844,7927,8771,95456,1005719,1101175,02/01/2016 12:00:00 AM,215,344,327
Northern,Stafford County,51179,445,2985,3430,850,8046,8896,96963,1008935,1105898,08/01/2015 12:00:00 AM,218,338,322
Northern,Stafford County,51179,446,2605,3051,766,6905,7671,87273,903769,991042,08/01/2018 12:00:00 AM,196,347,325
Northern,Stafford County,51179,447,2672,3119,819,7102,7921,97651,933450,1031101,09/01/2017 12:00:00 AM,218,349,331
Northern,Stafford County,51179,451,2589,3040,768,6941,7709,90403,922871,1013274,11/01/2018 12:00:00 AM,200,356,333
Northern,Stafford County,51179,451,2772,3223,866,7499,8365,97358,946951,1044309,12/01/2016 12:00:00 AM,216,342,324
Northern,Stafford County,51179,451,2887,3338,859,7815,8674,96063,976128,1072191,01/01/2016 12:00:00 AM,213,338,321
Northern,Stafford County,51179,453,2787,3240,845,7480,8325,92856,961889,1054745,02/01/2017 12:00:00 AM,205,345,326
Northern,Stafford County,51179,454,2633,3087,775,6998,7773,89934,921646,1011580,12/01/2018 12:00:00 AM,198,350,328
Northern,Stafford County,51179,454,2935,3389,851,7956,8807,96365,986443,1082808,03/01/2016 12:00:00 AM,212,336,320
Northern,Stafford County,51179,456,2601,3057,794,6912,7706,92001,909036,1001037,09/01/2018 12:00:00 AM,202,349,327
Northern,Stafford County,51179,457,2714,3171,789,7199,7988,94293,1019357,1113650,01/01/2019 12:00:00 AM,206,376,351
Northern,Stafford County,51179,459,2579,3038,794,6867,7661,92970,920411,1013381,10/01/2018 12:00:00 AM,203,357,334
Northern,Stafford County,51179,459,2824,3283,889,7557,8446,97765,951875,1049640,09/01/2016 12:00:00 AM,213,337,320
Northern,Stafford County,51179,460,2842,3302,887,7627,8514,100661,967323,1067984,08/01/2016 12:00:00 AM,219,340,323
Northern,Stafford County,51179,462,3047,3509,904,8126,9030,103751,1023987,1127738,06/01/2015 12:00:00 AM,225,336,321
Northern,Stafford County,51179,465,2851,3316,897,7651,8548,104583,952087,1056670,05/01/2016 12:00:00 AM,225,334,319
Northern,Stafford County,51179,465,2892,3357,886,7826,8712,101102,972685,1073787,04/01/2016 12:00:00 AM,217,336,320
Northern,Stafford County,51179,466,2846,3312,895,7627,8522,102032,953777,1055809,06/01/2016 12:00:00 AM,219,335,319
Northern,Stafford County,51179,466,2992,3458,897,8038,8935,100157,1011084,1111241,07/01/2015 12:00:00 AM,215,338,321
Northern,Stafford County,51179,467,2833,3300,909,7564,8473,100113,940027,1040140,07/01/2016 12:00:00 AM,214,332,315
Northern,Stafford County,51179,470,2786,3256,828,7416,8244,96868,972125,1068993,03/01/2019 12:00:00 AM,206,349,328
Northern,Stafford County,51179,474,2786,3260,826,7371,8197,95145,948827,1043972,04/01/2019 12:00:00 AM,201,341,320
Northern,Stafford County,51179,480,2782,3262,851,7367,8218,97449,945147,1042596,05/01/2019 12:00:00 AM,203,340,320
Northern,Stafford County,51179,480,2786,3266,841,7396,8237,96904,962824,1059728,06/01/2019 12:00:00 AM,202,346,324
Northern,Stafford County,51179,480,3104,3584,954,8220,9174,112144,1031508,1143652,04/01/2015 12:00:00 AM,234,332,319
Northern,Stafford County,51179,482,3091,3573,937,8240,9177,108122,1041208,1149330,05/01/2015 12:00:00 AM,224,337,322
Northern,Stafford County,51179,484,3283,3767,759,8493,9252,167500,1777568,1945068,02/01/2021 12:00:00 AM,346,541,516
Northern,Stafford County,51179,486,3097,3583,973,8208,9181,115454,1033292,1148746,03/01/2015 12:00:00 AM,238,334,321
Northern,Stafford County,51179,487,3300,3787,998,8471,9469,118880,1096108,1214988,10/01/2014 12:00:00 AM,244,332,321
Northern,Stafford County,51179,488,3242,3730,999,8432,9431,119361,1080413,1199774,11/01/2014 12:00:00 AM,245,333,322
Northern,Stafford County,51179,493,3141,3634,988,8284,9272,115662,1049471,1165133,02/01/2015 12:00:00 AM,235,334,321
Northern,Stafford County,51179,496,3225,3721,1021,8408,9429,120506,1077494,1198000,12/01/2014 12:00:00 AM,243,334,322
Northern,Stafford County,51179,496,3333,3829,1006,8468,9474,120858,1059560,1180418,09/01/2014 12:00:00 AM,244,318,308
Northern,Stafford County,51179,496,3466,3962,981,8736,9717,116624,1086854,1203478,07/01/2014 12:00:00 AM,235,314,304
Northern,Stafford County,51179,497,3205,3702,998,8444,9442,117681,1062387,1180068,01/01/2015 12:00:00 AM,237,331,319
Northern,Stafford County,51179,500,3410,3910,1005,8598,9603,120434,1071071,1191505,08/01/2014 12:00:00 AM,241,314,305
Northern,Stafford County,51179,503,3546,4049,1000,8757,9757,128103,1179668,1307771,10/01/2013 12:00:00 AM,255,333,323
Northern,Stafford County,51179,507,3480,3987,1005,8645,9650,121276,1072459,1193735,11/01/2013 12:00:00 AM,239,308,299
Northern,Stafford County,51179,508,2718,3226,925,7127,8052,106639,923849,1030488,07/01/2019 12:00:00 AM,210,340,319
Northern,Stafford County,51179,512,3483,3995,1019,8693,9712,120533,1077745,1198278,02/01/2014 12:00:00 AM,235,309,300
Northern,Stafford County,51179,516,3558,4074,1028,8866,9894,120202,1108252,1228454,04/01/2014 12:00:00 AM,233,311,302
Northern,Stafford County,51179,519,3469,3988,1052,8641,9693,122245,1061142,1183387,01/01/2014 12:00:00 AM,236,306,297
Northern,Stafford County,51179,520,3479,3999,1033,8692,9725,122384,1086368,1208752,06/01/2014 12:00:00 AM,235,312,302
Northern,Stafford County,51179,521,3221,3742,857,8304,9161,196102,1862462,2058564,04/01/2021 12:00:00 AM,376,578,550
Northern,Stafford County,51179,523,3197,3720,887,8202,9089,205313,1837180,2042493,05/01/2021 12:00:00 AM,393,575,549
Northern,Stafford County,51179,523,3233,3756,1108,8184,9292,147248,1091529,1238777,03/01/2012 12:00:00 AM,282,338,330
Northern,Stafford County,51179,523,3273,3796,838,8445,9283,185065,1742041,1927106,03/01/2021 12:00:00 AM,354,532,508
Northern,Stafford County,51179,523,3477,4000,1066,8632,9698,127916,1066982,1194898,12/01/2013 12:00:00 AM,245,307,299
Northern,Stafford County,51179,523,3504,4027,1057,8719,9776,124815,1090393,1215208,05/01/2014 12:00:00 AM,239,311,302
Northern,Stafford County,51179,526,3499,4025,1064,8706,9770,125121,1088515,1213636,03/01/2014 12:00:00 AM,238,311,302
Northern,Stafford County,51179,527,3214,3741,1130,8159,9289,150461,1094744,1245205,02/01/2012 12:00:00 AM,286,341,333
Northern,Stafford County,51179,527,3249,3776,1125,8217,9342,149809,1103599,1253408,04/01/2012 12:00:00 AM,284,340,332
Northern,Stafford County,51179,528,3204,3732,897,8195,9092,202136,1826116,2028252,06/01/2021 12:00:00 AM,383,570,543
Northern,Stafford County,51179,528,3237,3765,886,8380,9266,187385,1724907,1912292,01/01/2021 12:00:00 AM,355,533,508
Northern,Stafford County,51179,530,3544,4074,1067,8754,9821,137916,1175664,1313580,09/01/2013 12:00:00 AM,260,332,322
Northern,Stafford County,51179,531,3471,4002,1127,8652,9779,148147,1167695,1315842,10/01/2012 12:00:00 AM,279,336,329
Northern,Stafford County,51179,532,3536,4068,1138,8813,9951,150267,1176461,1326728,02/01/2013 12:00:00 AM,282,333,326
Northern,Stafford County,51179,532,3558,4090,1100,8824,9924,139790,1180455,1320245,07/01/2013 12:00:00 AM,263,332,323
Northern,Stafford County,51179,532,3561,4093,1110,8852,9962,146216,1184683,1330899,05/01/2013 12:00:00 AM,275,333,325
Northern,Stafford County,51179,533,3399,3932,1144,8512,9656,148170,1152192,1300362,09/01/2012 12:00:00 AM,278,339,331
Northern,Stafford County,51179,534,2726,3260,973,7231,8204,112455,942414,1054869,10/01/2019 12:00:00 AM,211,346,324
Northern,Stafford County,51179,534,3321,3855,1163,8378,9541,155475,1137748,1293223,07/01/2012 12:00:00 AM,291,343,335
Northern,Stafford County,51179,534,3546,4080,1082,8793,9875,139385,1179521,1318906,08/01/2013 12:00:00 AM,261,333,323
Northern,Stafford County,51179,536,3381,3917,1169,8471,9640,154476,1141289,1295765,08/01/2012 12:00:00 AM,288,338,331
Northern,Stafford County,51179,537,2730,3267,981,7195,8176,112540,929542,1042082,09/01/2019 12:00:00 AM,210,340,319
Northern,Stafford County,51179,537,3162,3699,1162,8035,9197,152783,1079353,1232136,01/01/2012 12:00:00 AM,285,341,333
Northern,Stafford County,51179,538,3281,3819,1163,8246,9409,156317,1109858,1266175,05/01/2012 12:00:00 AM,291,338,332
Northern,Stafford County,51179,538,3566,4104,1140,8826,9966,146157,1178476,1324633,06/01/2013 12:00:00 AM,272,330,323
Northern,Stafford County,51179,541,2724,3265,1028,7165,8193,119852,927260,1047112,08/01/2019 12:00:00 AM,222,340,321
Northern,Stafford County,51179,542,2772,3314,956,7369,8325,108758,949266,1058024,12/01/2019 12:00:00 AM,201,342,319
Northern,Stafford County,51179,542,3307,3849,1166,8284,9450,154479,1114312,1268791,06/01/2012 12:00:00 AM,285,337,330
Northern,Stafford County,51179,543,3234,3777,922,8324,9246,174824,1526203,1701027,11/01/2020 12:00:00 AM,322,472,450
Northern,Stafford County,51179,543,3525,4068,1173,8758,9931,154920,1160960,1315880,01/01/2013 12:00:00 AM,285,329,323
Northern,Stafford County,51179,543,3540,4083,1138,8790,9928,149185,1175023,1324208,04/01/2013 12:00:00 AM,275,332,324
Northern,Stafford County,51179,544,3241,3785,944,8357,9301,176179,1512061,1688240,12/01/2020 12:00:00 AM,324,467,446
Northern,Stafford County,51179,544,3532,4076,1158,8779,9937,152842,1173193,1326035,03/01/2013 12:00:00 AM,281,332,325
Northern,Stafford County,51179,546,2703,3249,982,7228,8210,109596,917592,1027188,11/01/2019 12:00:00 AM,201,339,316
Northern,Stafford County,51179,546,2723,3269,944,7266,8210,103706,938319,1042025,01/01/2020 12:00:00 AM,190,345,319
Northern,Stafford County,51179,546,3507,4053,1174,8744,9918,155528,1175135,1330663,12/01/2012 12:00:00 AM,285,335,328
Northern,Stafford County,51179,551,3310,3861,953,8509,9462,178572,1539733,1718305,10/01/2020 12:00:00 AM,324,465,445
Northern,Stafford County,51179,554,3488,4042,1191,8646,9837,156964,1162403,1319367,11/01/2012 12:00:00 AM,283,333,326
Northern,Stafford County,51179,561,2714,3275,981,7199,8180,105223,931858,1037081,02/01/2020 12:00:00 AM,188,343,317
Northern,Stafford County,51179,562,3345,3907,977,8621,9598,172302,1472062,1644364,09/01/2020 12:00:00 AM,307,440,421
Northern,Stafford County,51179,564,2833,3397,973,7483,8456,172883,1257068,1429951,03/01/2020 12:00:00 AM,307,444,421
Northern,Stafford County,51179,564,3373,3937,965,8694,9659,170825,1461570,1632395,08/01/2020 12:00:00 AM,303,433,415
Northern,Stafford County,51179,580,3146,3726,998,8241,9239,177008,1390757,1567765,04/01/2020 12:00:00 AM,305,442,421
Northern,Stafford County,51179,587,3359,3946,1007,8701,9708,177901,1467145,1645046,07/01/2020 12:00:00 AM,303,437,417
Northern,Stafford County,51179,588,3288,3876,1030,8518,9548,180683,1453460,1634143,05/01/2020 12:00:00 AM,307,442,422
Northern,Stafford County,51179,590,3352,3942,1021,8631,9652,181219,1463955,1645174,06/01/2020 12:00:00 AM,307,437,417
Northern,Warren County,51187,225,1556,1781,280,3657,3937,32705,463881,496586,04/01/2017 12:00:00 AM,145,298,279
Northern,Warren County,51187,229,1376,1605,313,3158,3471,31760,380478,412238,02/01/2020 12:00:00 AM,139,277,257
Northern,Warren County,51187,232,1593,1825,301,3716,4017,33609,468006,501615,02/01/2017 12:00:00 AM,145,294,275
Northern,Warren County,51187,233,1397,1630,319,3252,3571,33241,397554,430795,12/01/2019 12:00:00 AM,143,285,264
Northern,Warren County,51187,233,1539,1772,296,3613,3909,33067,462733,495800,05/01/2017 12:00:00 AM,142,301,280
Northern,Warren County,51187,233,1597,1830,297,3510,3807,66550,737264,803814,03/01/2021 12:00:00 AM,286,462,439
Northern,Warren County,51187,234,1397,1631,313,3281,3594,33539,399848,433387,10/01/2019 12:00:00 AM,143,286,266
Northern,Warren County,51187,234,1567,1801,299,3677,3976,33413,464283,497696,03/01/2017 12:00:00 AM,143,296,276
Northern,Warren County,51187,235,1549,1784,308,3380,3688,75801,777280,853081,05/01/2021 12:00:00 AM,323,502,478
Northern,Warren County,51187,236,1372,1608,322,3142,3464,59311,540198,599509,03/01/2020 12:00:00 AM,251,394,373
Northern,Warren County,51187,237,1376,1613,327,3164,3491,34442,380479,414921,01/01/2020 12:00:00 AM,145,277,257
Northern,Warren County,51187,237,1544,1781,320,3616,3936,34527,452862,487389,12/01/2016 12:00:00 AM,146,293,274
Northern,Warren County,51187,238,1398,1636,321,3275,3596,34106,400759,434865,11/01/2019 12:00:00 AM,143,287,266
Northern,Warren County,51187,238,1477,1715,327,3361,3688,60169,581236,641405,04/01/2020 12:00:00 AM,253,394,374
Northern,Warren County,51187,238,1565,1803,300,3487,3787,68033,733618,801651,02/01/2021 12:00:00 AM,286,469,445
Northern,Warren County,51187,239,1530,1769,314,3319,3633,75832,751126,826958,06/01/2021 12:00:00 AM,317,491,467
Northern,Warren County,51187,239,1542,1781,306,3620,3926,33546,457392,490938,06/01/2017 12:00:00 AM,140,297,276
Northern,Warren County,51187,239,1557,1796,313,3415,3728,73144,777177,850321,04/01/2021 12:00:00 AM,306,499,473
Northern,Warren County,51187,241,1373,1614,343,3231,3574,38236,396126,434362,02/01/2019 12:00:00 AM,159,289,269
Northern,Warren County,51187,241,1571,1812,322,3678,4000,34298,460730,495028,01/01/2017 12:00:00 AM,142,293,273
Northern,Warren County,51187,242,1543,1785,319,3413,3732,63826,636010,699836,11/01/2020 12:00:00 AM,264,412,392
Northern,Warren County,51187,242,1553,1795,322,3431,3753,71774,719468,791242,01/01/2021 12:00:00 AM,297,463,441
Northern,Warren County,51187,242,1558,1800,327,3465,3792,62834,636935,699769,12/01/2020 12:00:00 AM,260,409,389
Northern,Warren County,51187,244,1521,1765,320,3595,3915,37609,455613,493222,07/01/2017 12:00:00 AM,154,300,279
Northern,Warren County,51187,244,1530,1774,328,3653,3981,36185,454492,490677,10/01/2017 12:00:00 AM,148,297,277
Northern,Warren County,51187,244,1531,1775,336,3455,3791,61716,594005,655721,05/01/2020 12:00:00 AM,253,388,369
Northern,Warren County,51187,244,1540,1784,329,3653,3982,37403,464717,502120,08/01/2017 12:00:00 AM,153,302,281
Northern,Warren County,51187,245,1398,1643,342,3246,3588,35759,399914,435673,09/01/2019 12:00:00 AM,146,286,265
Northern,Warren County,51187,245,1401,1646,355,3297,3652,39371,405789,445160,04/01/2019 12:00:00 AM,161,290,270
Northern,Warren County,51187,245,1548,1793,336,3456,3792,62418,599133,661551,06/01/2020 12:00:00 AM,255,387,369
Northern,Warren County,51187,246,1397,1643,357,3291,3648,40059,401439,441498,03/01/2019 12:00:00 AM,163,287,269
Northern,Warren County,51187,246,1455,1701,341,3436,3777,39451,423726,463177,12/01/2018 12:00:00 AM,160,291,272
Northern,Warren County,51187,246,1526,1772,345,3587,3932,37621,452618,490239,11/01/2016 12:00:00 AM,153,297,277
Northern,Warren County,51187,246,1546,1792,338,3451,3789,61855,591184,653039,08/01/2020 12:00:00 AM,251,382,364
Northern,Warren County,51187,248,1408,1656,360,3261,3621,38178,396498,434676,07/01/2019 12:00:00 AM,154,282,262
Northern,Warren County,51187,248,1519,1767,340,3595,3935,38281,450358,488639,09/01/2017 12:00:00 AM,154,296,277
Northern,Warren County,51187,248,1524,1772,336,3380,3716,64407,614933,679340,10/01/2020 12:00:00 AM,260,403,383
Northern,Warren County,51187,249,1393,1642,356,3245,3601,37236,394854,432090,08/01/2019 12:00:00 AM,150,283,263
Northern,Warren County,51187,249,1445,1694,347,3396,3743,39837,421463,461300,11/01/2018 12:00:00 AM,160,292,272
Northern,Warren County,51187,250,1448,1698,355,3414,3769,42592,433871,476463,01/01/2019 12:00:00 AM,170,300,281
Northern,Warren County,51187,251,1400,1651,354,3255,3609,38252,398782,437034,06/01/2019 12:00:00 AM,152,285,265
Northern,Warren County,51187,251,1539,1790,342,3601,3943,38645,443346,481991,06/01/2018 12:00:00 AM,154,288,269
Northern,Warren County,51187,251,1573,1824,344,3548,3892,63179,609510,672689,07/01/2020 12:00:00 AM,252,387,369
Northern,Warren County,51187,252,1557,1809,343,3470,3813,63627,595674,659301,09/01/2020 12:00:00 AM,252,383,364
Northern,Warren County,51187,252,1564,1816,356,3680,4036,37670,462432,500102,10/01/2016 12:00:00 AM,149,296,275
Northern,Warren County,51187,253,1369,1622,364,3222,3586,41011,392289,433300,05/01/2019 12:00:00 AM,162,287,267
Northern,Warren County,51187,254,1492,1746,358,3463,3821,41012,419495,460507,07/01/2018 12:00:00 AM,161,281,264
Northern,Warren County,51187,254,1513,1767,340,3601,3941,39465,442291,481756,12/01/2017 12:00:00 AM,155,292,273
Northern,Warren County,51187,254,1522,1776,342,3632,3974,41295,454580,495875,11/01/2017 12:00:00 AM,163,299,279
Northern,Warren County,51187,254,1522,1776,352,3571,3923,39580,435616,475196,03/01/2018 12:00:00 AM,156,286,268
Northern,Warren County,51187,255,1550,1805,349,3655,4004,41028,443483,484511,05/01/2018 12:00:00 AM,161,286,268
Northern,Warren County,51187,255,1578,1833,373,3718,4091,40755,458422,499177,09/01/2016 12:00:00 AM,160,291,272
Northern,Warren County,51187,257,1446,1703,363,3398,3761,41777,417548,459325,10/01/2018 12:00:00 AM,163,289,270
Northern,Warren County,51187,257,1525,1782,356,3603,3959,39172,440265,479437,02/01/2018 12:00:00 AM,152,289,269
Northern,Warren County,51187,257,1539,1796,360,3610,3970,41656,435736,477392,04/01/2018 12:00:00 AM,162,283,266
Northern,Warren County,51187,257,1621,1878,366,3840,4206,40280,484150,524430,03/01/2016 12:00:00 AM,157,299,279
Northern,Warren County,51187,258,1581,1839,379,3731,4110,40126,470895,511021,05/01/2016 12:00:00 AM,156,298,278
Northern,Warren County,51187,259,1507,1766,378,3545,3923,42853,429791,472644,08/01/2018 12:00:00 AM,165,285,268
Northern,Warren County,51187,259,1592,1851,379,3750,4129,40399,474322,514721,04/01/2016 12:00:00 AM,156,298,278
Northern,Warren County,51187,260,1488,1748,370,3484,3854,41670,428694,470364,09/01/2018 12:00:00 AM,160,288,269
Northern,Warren County,51187,260,1587,1847,378,3777,4155,40512,470904,511416,06/01/2016 12:00:00 AM,156,297,277
Northern,Warren County,51187,261,1536,1797,360,3671,4031,40632,446141,486773,01/01/2018 12:00:00 AM,156,290,271
Northern,Warren County,51187,261,1571,1832,382,3691,4073,40524,460964,501488,07/01/2016 12:00:00 AM,155,293,274
Northern,Warren County,51187,263,1571,1834,389,3696,4085,41864,456097,497961,08/01/2016 12:00:00 AM,159,290,272
Northern,Warren County,51187,265,1626,1891,380,3870,4250,41062,489733,530795,02/01/2016 12:00:00 AM,155,301,281
Northern,Warren County,51187,267,1639,1906,398,3926,4324,43190,489602,532792,01/01/2016 12:00:00 AM,162,299,280
Northern,Warren County,51187,276,1668,1944,400,3978,4378,41866,499742,541608,08/01/2015 12:00:00 AM,152,300,279
Northern,Warren County,51187,276,1942,2218,499,4417,4916,61235,582669,643904,04/01/2012 12:00:00 AM,222,300,290
Northern,Warren County,51187,278,1663,1941,417,3989,4406,45152,498811,543963,12/01/2015 12:00:00 AM,162,300,280
Northern,Warren County,51187,278,1940,2218,495,4411,4906,62630,577253,639883,05/01/2012 12:00:00 AM,225,298,288
Northern,Warren County,51187,280,1670,1950,426,4005,4431,47005,497334,544339,11/01/2015 12:00:00 AM,168,298,279
Northern,Warren County,51187,280,1991,2271,490,4534,5024,60705,598335,659040,07/01/2012 12:00:00 AM,217,301,290
Northern,Warren County,51187,282,1663,1945,417,3984,4401,43142,499091,542233,07/01/2015 12:00:00 AM,153,300,279
Northern,Warren County,51187,282,1719,2001,415,4117,4532,47616,518336,565952,04/01/2015 12:00:00 AM,169,302,283
Northern,Warren County,51187,282,1991,2273,495,4541,5036,61362,592075,653437,06/01/2012 12:00:00 AM,218,297,287
Northern,Warren County,51187,283,1668,1951,420,3985,4405,46099,499438,545537,10/01/2015 12:00:00 AM,163,299,280
Northern,Warren County,51187,284,2024,2308,500,4637,5137,62048,613185,675233,08/01/2012 12:00:00 AM,218,303,293
Northern,Warren County,51187,285,1684,1969,429,4022,4451,44929,506127,551056,06/01/2015 12:00:00 AM,158,301,280
Northern,Warren County,51187,285,1737,2022,423,4146,4569,46409,519901,566310,03/01/2015 12:00:00 AM,163,299,280
Northern,Warren County,51187,288,1684,1972,436,4014,4450,48381,505305,553686,05/01/2015 12:00:00 AM,168,300,281
Northern,Warren County,51187,288,2049,2337,519,4654,5173,65991,621153,687144,09/01/2012 12:00:00 AM,229,303,294
Northern,Warren County,51187,289,1952,2241,534,4469,5003,66402,590125,656527,03/01/2012 12:00:00 AM,230,302,293
Northern,Warren County,51187,289,2072,2361,500,4725,5225,63153,628948,692101,10/01/2012 12:00:00 AM,219,304,293
Northern,Warren County,51187,291,1945,2236,445,4513,4958,49548,560667,610215,05/01/2014 12:00:00 AM,170,288,273
Northern,Warren County,51187,292,2067,2359,510,4679,5189,62281,626554,688835,11/01/2012 12:00:00 AM,213,303,292
Northern,Warren County,51187,293,1655,1948,418,3988,4406,43941,502316,546257,09/01/2015 12:00:00 AM,150,304,280
Northern,Warren County,51187,293,1959,2252,543,4496,5039,68310,596734,665044,02/01/2012 12:00:00 AM,233,305,295
Northern,Warren County,51187,293,2083,2376,494,4751,5245,61757,635764,697521,12/01/2012 12:00:00 AM,211,305,294
Northern,Warren County,51187,295,1958,2253,447,4514,4961,51553,555161,606714,01/01/2014 12:00:00 AM,175,284,269
Northern,Warren County,51187,296,2085,2381,496,4714,5210,60280,622665,682945,01/01/2013 12:00:00 AM,204,299,287
Northern,Warren County,51187,298,1935,2233,550,4492,5042,66712,590688,657400,01/01/2012 12:00:00 AM,224,305,294
Northern,Warren County,51187,298,1951,2249,445,4558,5003,49587,559607,609194,06/01/2014 12:00:00 AM,166,287,271
Northern,Warren County,51187,298,1978,2276,441,4563,5004,49075,560375,609450,12/01/2013 12:00:00 AM,165,283,268
Northern,Warren County,51187,299,1951,2250,468,4501,4969,54337,556913,611250,04/01/2014 12:00:00 AM,182,285,272
Northern,Warren County,51187,300,1782,2082,452,4225,4677,51914,535077,586991,10/01/2014 12:00:00 AM,173,300,282
Northern,Warren County,51187,300,2098,2398,506,4728,5234,63332,633813,697145,02/01/2013 12:00:00 AM,211,302,291
Northern,Warren County,51187,301,1707,2008,458,4081,4539,50969,511875,562844,02/01/2015 12:00:00 AM,169,300,280
Northern,Warren County,51187,301,1882,2183,453,4416,4869,48904,539997,588901,08/01/2014 12:00:00 AM,162,287,270
Northern,Warren County,51187,301,1992,2293,438,4581,5019,49586,567679,617265,11/01/2013 12:00:00 AM,165,285,269
Northern,Warren County,51187,302,1761,2063,459,4180,4639,53754,526989,580743,12/01/2014 12:00:00 AM,178,299,282
Northern,Warren County,51187,302,1763,2065,462,4187,4649,53250,526848,580098,11/01/2014 12:00:00 AM,176,299,281
Northern,Warren County,51187,303,1918,2221,471,4481,4952,52179,545992,598171,07/01/2014 12:00:00 AM,172,285,269
Northern,Warren County,51187,303,1951,2254,455,4509,4964,51252,559800,611052,02/01/2014 12:00:00 AM,169,287,271
Northern,Warren County,51187,304,1944,2248,458,4495,4953,52538,553626,606164,03/01/2014 12:00:00 AM,173,285,270
Northern,Warren County,51187,305,1726,2031,470,4135,4605,54647,507167,561814,01/01/2015 12:00:00 AM,179,294,277
Northern,Warren County,51187,308,2004,2312,465,4609,5074,56804,611541,668345,10/01/2013 12:00:00 AM,184,305,289
Northern,Warren County,51187,308,2029,2337,489,4622,5111,59761,613889,673650,08/01/2013 12:00:00 AM,194,303,288
Northern,Warren County,51187,309,2004,2313,481,4596,5077,58913,606740,665653,09/01/2013 12:00:00 AM,191,303,288
Northern,Warren County,51187,310,2092,2402,513,4738,5251,65127,628223,693350,03/01/2013 12:00:00 AM,210,300,289
Northern,Warren County,51187,311,1839,2150,475,4336,4811,51565,528183,579748,09/01/2014 12:00:00 AM,166,287,270
Northern,Warren County,51187,312,2069,2381,527,4691,5218,66291,625452,691743,04/01/2013 12:00:00 AM,212,302,291
Northern,Warren County,51187,314,2020,2334,508,4590,5098,61894,609128,671022,07/01/2013 12:00:00 AM,197,302,287
Northern,Warren County,51187,314,2055,2369,526,4665,5191,66247,622640,688887,05/01/2013 12:00:00 AM,211,303,291
Northern,Warren County,51187,321,2012,2333,540,4580,5120,66966,609691,676657,06/01/2013 12:00:00 AM,209,303,290
Northern,Winchester City,51840,259,1248,1507,305,2664,2969,32620,328259,360879,12/01/2019 12:00:00 AM,126,263,239
Northern,Winchester City,51840,261,1222,1483,309,2631,2940,32866,326426,359292,02/01/2020 12:00:00 AM,126,267,242
Northern,Winchester City,51840,261,1282,1543,310,2753,3063,33563,335935,369498,10/01/2019 12:00:00 AM,129,262,239
Northern,Winchester City,51840,265,1317,1582,321,2883,3204,32405,346687,379092,02/01/2019 12:00:00 AM,122,263,240
Northern,Winchester City,51840,266,1763,2029,369,3883,4252,39585,464804,504389,06/01/2014 12:00:00 AM,149,264,249
Northern,Winchester City,51840,267,1619,1886,358,3681,4039,39026,446520,485546,01/01/2015 12:00:00 AM,146,276,257
Northern,Winchester City,51840,268,1226,1494,316,2622,2938,31681,320346,352027,01/01/2020 12:00:00 AM,118,261,236
Northern,Winchester City,51840,268,1297,1565,331,2793,3124,36558,336065,372623,09/01/2019 12:00:00 AM,136,259,238
Northern,Winchester City,51840,268,1313,1581,329,2835,3164,33819,342354,376173,08/01/2019 12:00:00 AM,126,261,238
Northern,Winchester City,51840,269,1262,1531,315,2677,2992,34372,333479,367851,11/01/2019 12:00:00 AM,128,264,240
Northern,Winchester City,51840,269,1590,1859,365,3616,3981,40097,437460,477557,04/01/2015 12:00:00 AM,149,275,257
Northern,Winchester City,51840,269,1608,1877,368,3671,4039,41399,445096,486495,02/01/2015 12:00:00 AM,154,277,259
Northern,Winchester City,51840,270,1302,1572,331,2808,3139,33602,339316,372918,07/01/2019 12:00:00 AM,124,261,237
Northern,Winchester City,51840,271,1219,1490,323,2630,2953,60329,452839,513168,03/01/2020 12:00:00 AM,223,371,344
Northern,Winchester City,51840,271,1336,1607,327,2911,3238,32959,353722,386681,03/01/2019 12:00:00 AM,122,265,241
Northern,Winchester City,51840,271,1548,1819,371,3491,3862,40223,420599,460822,08/01/2015 12:00:00 AM,148,272,253
Northern,Winchester City,51840,271,1832,2103,402,3956,4358,43032,478098,521130,04/01/2014 12:00:00 AM,159,261,248
Northern,Winchester City,51840,272,1331,1603,332,2873,3205,33063,349601,382664,04/01/2019 12:00:00 AM,122,263,239
Northern,Winchester City,51840,272,1575,1847,365,3580,3945,39203,434254,473457,05/01/2015 12:00:00 AM,144,276,256
Northern,Winchester City,51840,272,1856,2128,404,3972,4376,44563,483519,528082,11/01/2013 12:00:00 AM,164,261,248
Northern,Winchester City,51840,273,1337,1610,341,2903,3244,34881,345326,380207,09/01/2018 12:00:00 AM,128,258,236
Northern,Winchester City,51840,273,1349,1622,343,2922,3265,36358,357083,393441,01/01/2019 12:00:00 AM,133,265,243
Northern,Winchester City,51840,273,1358,1631,341,2977,3318,35163,362326,397489,08/01/2018 12:00:00 AM,129,267,244
Northern,Winchester City,51840,273,1606,1879,367,3669,4036,40358,443965,484323,03/01/2015 12:00:00 AM,148,276,258
Northern,Winchester City,51840,273,1620,1893,367,3675,4042,39395,453613,493008,12/01/2014 12:00:00 AM,144,280,260
Northern,Winchester City,51840,274,1908,2182,396,4106,4502,46766,535861,582627,10/01/2013 12:00:00 AM,171,281,267
Northern,Winchester City,51840,275,1337,1612,348,2907,3255,36904,345863,382767,11/01/2018 12:00:00 AM,134,259,237
Northern,Winchester City,51840,275,1351,1626,338,2963,3301,35338,353542,388880,10/01/2018 12:00:00 AM,129,262,239
Northern,Winchester City,51840,276,1333,1609,349,2797,3146,84546,639679,724225,04/01/2021 12:00:00 AM,306,480,450
Northern,Winchester City,51840,276,1830,2106,415,3935,4350,45775,468602,514377,12/01/2013 12:00:00 AM,166,256,244
Northern,Winchester City,51840,277,1343,1620,339,2795,3134,82089,648320,730409,05/01/2021 12:00:00 AM,296,483,451
Northern,Winchester City,51840,277,1581,1858,379,3580,3959,41576,431256,472832,06/01/2015 12:00:00 AM,150,273,254
Northern,Winchester City,51840,278,1314,1592,351,2852,3203,35434,344606,380040,06/01/2019 12:00:00 AM,127,262,239
Northern,Winchester City,51840,278,1318,1596,346,2836,3182,34308,343764,378072,05/01/2019 12:00:00 AM,123,261,237
Northern,Winchester City,51840,278,1562,1840,383,3527,3910,40717,426603,467320,09/01/2015 12:00:00 AM,146,273,254
Northern,Winchester City,51840,279,1320,1599,353,2881,3234,38096,341023,379119,12/01/2018 12:00:00 AM,137,258,237
Northern,Winchester City,51840,279,1645,1924,392,3696,4088,43628,458331,501959,10/01/2014 12:00:00 AM,156,279,261
Northern,Winchester City,51840,279,1723,2002,398,3789,4187,42561,453649,496210,07/01/2014 12:00:00 AM,153,263,248
Northern,Winchester City,51840,279,1784,2063,408,3862,4270,43548,465740,509288,05/01/2014 12:00:00 AM,156,261,247
Northern,Winchester City,51840,279,1829,2108,421,3932,4353,43881,470483,514364,02/01/2014 12:00:00 AM,157,257,244
Northern,Winchester City,51840,280,1340,1620,339,2883,3222,64145,500337,564482,04/01/2020 12:00:00 AM,229,373,348
Northern,Winchester City,51840,280,1491,1771,383,3442,3825,41571,409275,450846,01/01/2016 12:00:00 AM,148,274,255
Northern,Winchester City,51840,280,1560,1840,383,3521,3904,41581,420607,462188,07/01/2015 12:00:00 AM,149,270,251
Northern,Winchester City,51840,280,1644,1924,396,3701,4097,43661,456919,500580,11/01/2014 12:00:00 AM,156,278,260
Northern,Winchester City,51840,280,1818,2098,420,3930,4350,44558,466379,510937,01/01/2014 12:00:00 AM,159,257,244
Northern,Winchester City,51840,280,1917,2197,418,4113,4531,49921,537687,587608,09/01/2013 12:00:00 AM,178,280,267
Northern,Winchester City,51840,281,1331,1612,350,2814,3164,79478,606730,686208,02/01/2021 12:00:00 AM,283,456,426
Northern,Winchester City,51840,281,1505,1786,388,3402,3790,44208,407623,451831,04/01/2016 12:00:00 AM,157,271,253
Northern,Winchester City,51840,282,1331,1613,357,2918,3275,36649,353702,390351,07/01/2018 12:00:00 AM,130,266,242
Northern,Winchester City,51840,283,1823,2106,439,3939,4378,47939,471345,519284,03/01/2014 12:00:00 AM,169,259,247
Northern,Winchester City,51840,285,1499,1784,380,3386,3766,42637,405721,448358,05/01/2016 12:00:00 AM,150,271,251
Northern,Winchester City,51840,285,1511,1796,384,3434,3818,40875,408166,449041,09/01/2016 12:00:00 AM,143,270,250
Northern,Winchester City,51840,285,1656,1941,411,3723,4134,44811,443444,488255,09/01/2014 12:00:00 AM,157,268,252
Northern,Winchester City,51840,286,1509,1795,399,3409,3808,43215,409215,452430,08/01/2016 12:00:00 AM,151,271,252
Northern,Winchester City,51840,286,1525,1811,403,3484,3887,43184,414118,457302,12/01/2015 12:00:00 AM,151,272,253
Northern,Winchester City,51840,287,1310,1597,375,2774,3149,73452,504686,578138,12/01/2020 12:00:00 AM,256,385,362
Northern,Winchester City,51840,287,1349,1636,359,2859,3218,81881,600465,682346,03/01/2021 12:00:00 AM,285,445,417
Northern,Winchester City,51840,287,1367,1654,380,2999,3379,40593,363035,403628,05/01/2018 12:00:00 AM,141,266,244
Northern,Winchester City,51840,287,1382,1669,378,3038,3416,42486,363712,406198,11/01/2017 12:00:00 AM,148,263,243
Northern,Winchester City,51840,287,1931,2218,425,4169,4594,50959,542510,593469,08/01/2013 12:00:00 AM,178,281,268
Northern,Winchester City,51840,288,1325,1613,352,2755,3107,86384,635743.08,722127.08,06/01/2021 12:00:00 AM,300,480,448
Northern,Winchester City,51840,288,1356,1644,382,2974,3356,41065,363625,404690,06/01/2018 12:00:00 AM,143,268,246
Northern,Winchester City,51840,288,1379,1667,376,2947,3323,73416,538155,611571,10/01/2020 12:00:00 AM,255,390,367
Northern,Winchester City,51840,288,1494,1782,387,3375,3762,44111,403234,447345,06/01/2016 12:00:00 AM,153,270,251
Northern,Winchester City,51840,288,1556,1844,395,3510,3905,42546,422242,464788,10/01/2015 12:00:00 AM,148,271,252
Northern,Winchester City,51840,289,1340,1629,377,2892,3269,73405,531768,605173,11/01/2020 12:00:00 AM,254,397,371
Northern,Winchester City,51840,289,1704,1993,418,3796,4214,45849,450157,496006,08/01/2014 12:00:00 AM,159,264,249
Northern,Winchester City,51840,289,1915,2204,445,4087,4532,52861,534836,587697,07/01/2013 12:00:00 AM,183,279,267
Northern,Winchester City,51840,290,1361,1651,383,2973,3356,42044,363710,405754,04/01/2018 12:00:00 AM,145,267,246
Northern,Winchester City,51840,290,1375,1665,355,2915,3270,67312,501498,568810,05/01/2020 12:00:00 AM,232,365,342
Northern,Winchester City,51840,290,1393,1683,374,3090,3464,41187,378947,420134,09/01/2017 12:00:00 AM,142,272,250
Northern,Winchester City,51840,290,1492,1782,398,3400,3798,44628,407573,452201,03/01/2016 12:00:00 AM,154,273,254
Northern,Winchester City,51840,291,1301,1592,385,2753,3138,85716,578052,663768,01/01/2021 12:00:00 AM,295,444,417
Northern,Winchester City,51840,291,1418,1709,365,3219,3584,38878,395302,434180,07/01/2017 12:00:00 AM,134,279,254
Northern,Winchester City,51840,291,1419,1710,371,3211,3582,39976,395841,435817,06/01/2017 12:00:00 AM,137,279,255
Northern,Winchester City,51840,291,1526,1817,376,3465,3841,40345,416301,456646,02/01/2017 12:00:00 AM,139,273,251
Northern,Winchester City,51840,291,1530,1821,407,3484,3891,43593,412493,456086,11/01/2015 12:00:00 AM,150,270,250
Northern,Winchester City,51840,292,1393,1685,380,3096,3476,41713,373477,415190,12/01/2017 12:00:00 AM,143,268,246
Northern,Winchester City,51840,292,1412,1704,370,3186,3556,39749,391492,431241,08/01/2017 12:00:00 AM,136,277,253
Northern,Winchester City,51840,292,1417,1709,379,3216,3595,40458,393007,433465,05/01/2017 12:00:00 AM,139,277,254
Northern,Winchester City,51840,292,1487,1779,396,3420,3816,43416,413372,456788,02/01/2016 12:00:00 AM,149,278,257
Northern,Winchester City,51840,292,1500,1792,407,3408,3815,44847,409101,453948,10/01/2016 12:00:00 AM,154,273,253
Northern,Winchester City,51840,292,1524,1816,384,3452,3836,39645,415519,455164,01/01/2017 12:00:00 AM,136,273,251
Northern,Winchester City,51840,292,1929,2221,466,4151,4617,55972,547141,603113,06/01/2013 12:00:00 AM,192,284,272
Northern,Winchester City,51840,293,1397,1690,381,3100,3481,43414,372983,416397,10/01/2017 12:00:00 AM,148,267,246
Northern,Winchester City,51840,293,1952,2245,503,4131,4634,58586,540568,599154,12/01/2012 12:00:00 AM,200,277,267
Northern,Winchester City,51840,294,1503,1797,399,3368,3767,43429,400696,444125,07/01/2016 12:00:00 AM,148,267,247
Northern,Winchester City,51840,295,1476,1771,383,3322,3705,41261,407251,448512,03/01/2017 12:00:00 AM,140,276,253
Northern,Winchester City,51840,295,1499,1794,391,3409,3800,41151,411217,452368,11/01/2016 12:00:00 AM,139,274,252
Northern,Winchester City,51840,296,1377,1673,371,2900,3271,69363,504833,574196,06/01/2020 12:00:00 AM,234,367,343
Northern,Winchester City,51840,298,1384,1682,394,3005,3399,42920,366670,409590,03/01/2018 12:00:00 AM,144,265,244
Northern,Winchester City,51840,298,1388,1686,400,3056,3456,43445,371897,415342,01/01/2018 12:00:00 AM,146,268,246
Northern,Winchester City,51840,298,1391,1689,379,2976,3355,71152,515707,586859,09/01/2020 12:00:00 AM,239,371,347
Northern,Winchester City,51840,298,1428,1726,386,3265,3651,41798,399060,440858,04/01/2017 12:00:00 AM,140,279,255
Northern,Winchester City,51840,299,1517,1816,402,3418,3820,42921,411125,454046,12/01/2016 12:00:00 AM,144,271,250
Northern,Winchester City,51840,299,1956,2255,498,4149,4647,58369,537509,595878,01/01/2013 12:00:00 AM,195,275,264
Northern,Winchester City,51840,299,1971,2270,512,4168,4680,59679,544484,604163,11/01/2012 12:00:00 AM,200,276,266
Northern,Winchester City,51840,300,1374,1674,395,3016,3411,43310,368770,412080,02/01/2018 12:00:00 AM,144,268,246
Northern,Winchester City,51840,300,1396,1696,375,2958,3333,69865,512442,582307,08/01/2020 12:00:00 AM,233,367,343
Northern,Winchester City,51840,300,1401,1701,374,2945,3319,70557,513457,584014,07/01/2020 12:00:00 AM,235,366,343
Northern,Winchester City,51840,302,1948,2250,483,4194,4677,58070,546950,605020,05/01/2013 12:00:00 AM,192,281,269
Northern,Winchester City,51840,303,1934,2237,508,4114,4622,60036,541444,601480,02/01/2013 12:00:00 AM,198,280,269
Northern,Winchester City,51840,304,1934,2238,502,4170,4672,58234,544848,603082,04/01/2013 12:00:00 AM,192,282,269
Northern,Winchester City,51840,305,1905,2210,536,4028,4564,63428,527664,591092,09/01/2012 12:00:00 AM,208,277,267
Northern,Winchester City,51840,305,1932,2237,497,4123,4620,58424,542697,601121,03/01/2013 12:00:00 AM,192,281,269
Northern,Winchester City,51840,307,1926,2233,524,4054,4578,63337,532904,596241,08/01/2012 12:00:00 AM,206,277,267
Northern,Winchester City,51840,309,1949,2258,547,4095,4642,64337,534764,599101,10/01/2012 12:00:00 AM,208,274,265
Northern,Winchester City,51840,311,1908,2219,546,3987,4533,65818,525063,590881,07/01/2012 12:00:00 AM,212,275,266
Northern,Winchester City,51840,314,1929,2243,569,3890,4459,68805,512773,581578,01/01/2012 12:00:00 AM,219,266,259
Northern,Winchester City,51840,317,1925,2242,550,3964,4514,66496,524099,590595,05/01/2012 12:00:00 AM,210,272,263
Northern,Winchester City,51840,320,1905,2225,552,3995,4547,67715,525464,593179,06/01/2012 12:00:00 AM,212,276,267
Northern,Winchester City,51840,320,1952,2272,568,3927,4495,69621,524508,594129,03/01/2012 12:00:00 AM,218,269,262
Northern,Winchester City,51840,321,1949,2270,564,3926,4490,67970,526836,594806,04/01/2012 12:00:00 AM,212,270,262
Northern,Winchester City,51840,323,1952,2275,580,3924,4504,72035,525352,597387,02/01/2012 12:00:00 AM,223,269,263
Piedmont,Albemarle County,51003,345,2793,3138,528,6002,6530,60317,776031,836348,04/01/2012 12:00:00 AM,175,278,267
Piedmont,Albemarle County,51003,353,2799,3152,537,5982,6519,62359,766365,828724,05/01/2012 12:00:00 AM,177,274,263
Piedmont,Albemarle County,51003,354,2804,3158,543,6027,6570,62270,780224,842494,03/01/2012 12:00:00 AM,176,278,267
Piedmont,Albemarle County,51003,354,2805,3159,541,6065,6606,63227,782475,845702,02/01/2012 12:00:00 AM,179,279,268
Piedmont,Albemarle County,51003,357,2849,3206,546,6130,6676,62956,787058,850014,06/01/2012 12:00:00 AM,176,276,265
Piedmont,Albemarle County,51003,358,2868,3226,553,6134,6687,73806,889467,963273,07/01/2012 12:00:00 AM,206,310,299
Piedmont,Albemarle County,51003,363,2879,3242,557,6179,6736,65103,798098,863201,08/01/2012 12:00:00 AM,179,277,266
Piedmont,Albemarle County,51003,368,2890,3258,555,6221,6776,65297,803757,869054,09/01/2012 12:00:00 AM,177,278,267
Piedmont,Albemarle County,51003,373,2831,3204,583,6132,6715,68662,781754,850416,01/01/2012 12:00:00 AM,184,276,265
Piedmont,Albemarle County,51003,383,1585,1968,561,3435,3996,58515,395475,453990,02/01/2019 12:00:00 AM,153,250,231
Piedmont,Albemarle County,51003,390,2901,3291,564,6209,6773,66438,793288,859726,07/01/2013 12:00:00 AM,170,273,261
Piedmont,Albemarle County,51003,391,2897,3288,600,6193,6793,69468,801164,870632,10/01/2012 12:00:00 AM,178,277,265
Piedmont,Albemarle County,51003,391,2913,3304,569,6283,6852,65850,802544,868394,08/01/2013 12:00:00 AM,168,276,263
Piedmont,Albemarle County,51003,392,1662,2054,581,3594,4175,62628,417368,479996,02/01/2020 12:00:00 AM,160,251,234
Piedmont,Albemarle County,51003,394,1923,2317,592,4344,4936,62298,503627,565925,02/01/2017 12:00:00 AM,158,262,244
Piedmont,Albemarle County,51003,394,2893,3287,610,6149,6759,71455,796335,867790,11/01/2012 12:00:00 AM,181,275,264
Piedmont,Albemarle County,51003,396,1680,2076,583,3757,4340,60500,433944,494444,03/01/2019 12:00:00 AM,153,258,238
Piedmont,Albemarle County,51003,396,1701,2097,575,3738,4313,61314,442132,503446,06/01/2019 12:00:00 AM,155,260,240
Piedmont,Albemarle County,51003,396,1707,2103,578,3769,4347,59838,444605.51,504443.51,08/01/2019 12:00:00 AM,151,260,240
Piedmont,Albemarle County,51003,396,1718,2114,571,3782,4353,59697,440968,500665,07/01/2019 12:00:00 AM,151,257,237
Piedmont,Albemarle County,51003,396,2875,3271,612,6135,6747,72688,794488,867176,12/01/2012 12:00:00 AM,184,276,265
Piedmont,Albemarle County,51003,397,1675,2072,593,3695,4288,62151,431565,493716,05/01/2019 12:00:00 AM,157,258,238
Piedmont,Albemarle County,51003,397,1751,2148,585,3802,4387,105072,656586,761658,03/01/2020 12:00:00 AM,265,375,355
Piedmont,Albemarle County,51003,399,1654,2053,582,3661,4243,60557,424183,484740,12/01/2018 12:00:00 AM,152,256,236
Piedmont,Albemarle County,51003,401,2885,3286,600,6153,6753,73040,796450,869490,05/01/2013 12:00:00 AM,182,276,265
Piedmont,Albemarle County,51003,401,2910,3311,609,6207,6816,73498,802973,876471,06/01/2013 12:00:00 AM,183,276,265
Piedmont,Albemarle County,51003,402,1671,2073,599,3650,4249,62583,422175,484758,01/01/2020 12:00:00 AM,156,253,234
Piedmont,Albemarle County,51003,402,1672,2074,596,3691,4287,62178,429576,491754,04/01/2019 12:00:00 AM,155,257,237
Piedmont,Albemarle County,51003,403,1654,2057,598,3680,4278,62969,447389,510358,01/01/2019 12:00:00 AM,156,270,248
Piedmont,Albemarle County,51003,403,1660,2063,601,3708,4309,63051,425998,489049,11/01/2018 12:00:00 AM,156,257,237
Piedmont,Albemarle County,51003,403,1878,2281,609,4256,4865,64895,487845,552740,04/01/2017 12:00:00 AM,161,260,242
Piedmont,Albemarle County,51003,404,1883,2287,608,4248,4856,66167,497877,564044,06/01/2017 12:00:00 AM,164,264,247
Piedmont,Albemarle County,51003,404,2929,3333,617,6254,6871,75040,807869,882909,04/01/2013 12:00:00 AM,186,276,265
Piedmont,Albemarle County,51003,405,1667,2072,609,3701,4310,62951,430028,492979,11/01/2019 12:00:00 AM,155,258,238
Piedmont,Albemarle County,51003,405,1680,2085,607,3699,4306,62506,436248,498754,09/01/2019 12:00:00 AM,154,260,239
Piedmont,Albemarle County,51003,406,2361,2767,630,5299,5929,67237,621200,688437,05/01/2015 12:00:00 AM,166,263,249
Piedmont,Albemarle County,51003,406,2915,3321,649,6192,6841,77507,790799,868306,01/01/2013 12:00:00 AM,191,271,261
Piedmont,Albemarle County,51003,407,1710,2117,623,3743,4366,66232,443324,509556,10/01/2019 12:00:00 AM,163,259,241
Piedmont,Albemarle County,51003,407,2889,3296,602,6250,6852,69953,794612,864565,09/01/2013 12:00:00 AM,172,275,262
Piedmont,Albemarle County,51003,408,1879,2287,610,4273,4883,64664,495112,559776,05/01/2017 12:00:00 AM,158,263,245
Piedmont,Albemarle County,51003,409,2889,3298,607,6293,6900,70355,798130,868485,10/01/2013 12:00:00 AM,172,276,263
Piedmont,Albemarle County,51003,410,1845,2255,618,4192,4810,66977,489783,556760,07/01/2017 12:00:00 AM,163,265,247
Piedmont,Albemarle County,51003,410,2927,3337,637,6216,6853,78436,819948,898384,03/01/2013 12:00:00 AM,191,280,269
Piedmont,Albemarle County,51003,411,2944,3355,654,6240,6894,77824,803069,880893,02/01/2013 12:00:00 AM,189,273,263
Piedmont,Albemarle County,51003,412,1812,2224,601,4129,4730,64119,473565,537684,10/01/2017 12:00:00 AM,156,261,242
Piedmont,Albemarle County,51003,412,1826,2238,608,4188,4796,63958,476953,540911,11/01/2017 12:00:00 AM,155,261,242
Piedmont,Albemarle County,51003,413,1683,2096,622,3706,4328,67111,432618,499729,12/01/2019 12:00:00 AM,162,257,238
Piedmont,Albemarle County,51003,413,1779,2192,617,4030,4647,63554,464968,528522,01/01/2018 12:00:00 AM,154,261,241
Piedmont,Albemarle County,51003,413,1843,2256,612,4163,4775,65985,486962,552947,08/01/2017 12:00:00 AM,160,264,245
Piedmont,Albemarle County,51003,414,1909,2323,621,4318,4939,66049,498349,564398,03/01/2017 12:00:00 AM,160,261,243
Piedmont,Albemarle County,51003,414,2379,2793,649,5294,5943,69014,621319,690333,03/01/2015 12:00:00 AM,167,261,247
Piedmont,Albemarle County,51003,414,2421,2835,665,5361,6026,70198,621115,691313,01/01/2015 12:00:00 AM,170,257,244
Piedmont,Albemarle County,51003,415,1745,2160,641,3900,4541,66281,447659,513940,07/01/2018 12:00:00 AM,160,257,238
Piedmont,Albemarle County,51003,415,1761,2176,637,3919,4556,63944,453262,517206,06/01/2018 12:00:00 AM,154,257,238
Piedmont,Albemarle County,51003,415,1779,2194,622,4008,4630,62167,464370,526537,02/01/2018 12:00:00 AM,150,261,240
Piedmont,Albemarle County,51003,415,1804,2219,614,4113,4727,63236,478984,542220,12/01/2017 12:00:00 AM,152,266,244
Piedmont,Albemarle County,51003,415,1812,2227,622,4165,4787,64885,483489,548374,09/01/2017 12:00:00 AM,156,267,246
Piedmont,Albemarle County,51003,415,2365,2780,660,5287,5947,71392,616071,687463,04/01/2015 12:00:00 AM,172,260,247
Piedmont,Albemarle County,51003,416,1696,2112,633,3716,4349,65358,430249,495607,09/01/2018 12:00:00 AM,157,254,235
Piedmont,Albemarle County,51003,416,1973,2389,638,4217,4855,114402,732733,847135,04/01/2020 12:00:00 AM,275,371,355
Piedmont,Albemarle County,51003,417,1665,2082,626,3674,4300,64433,424703,489136,10/01/2018 12:00:00 AM,155,255,235
Piedmont,Albemarle County,51003,417,2039,2456,634,4312,4946,113010,745872,858882,05/01/2020 12:00:00 AM,271,366,350
Piedmont,Albemarle County,51003,418,1727,2145,641,3855,4496,65404,440210,505614,08/01/2018 12:00:00 AM,156,255,236
Piedmont,Albemarle County,51003,418,1997,2415,621,4239,4860,112251,740607,852858,06/01/2020 12:00:00 AM,269,371,353
Piedmont,Albemarle County,51003,418,2392,2810,668,5375,6043,70536,627555,698091,02/01/2015 12:00:00 AM,169,262,248
Piedmont,Albemarle County,51003,418,2477,2895,670,5474,6144,73318,646525,719843,12/01/2014 12:00:00 AM,175,261,249
Piedmont,Albemarle County,51003,419,1916,2335,630,4364,4994,65004,501209,566213,12/01/2016 12:00:00 AM,155,262,242
Piedmont,Albemarle County,51003,419,2071,2490,589,4400,4989,131090,931473,1062563,02/01/2021 12:00:00 AM,313,450,427
Piedmont,Albemarle County,51003,419,2246,2665,651,5172,5823,70979,602256,673235,10/01/2015 12:00:00 AM,169,268,253
Piedmont,Albemarle County,51003,419,2261,2680,642,5176,5818,70377,608560,678937,08/01/2015 12:00:00 AM,168,269,253
Piedmont,Albemarle County,51003,419,2347,2766,651,5258,5909,71704,616383,688087,06/01/2015 12:00:00 AM,171,263,249
Piedmont,Albemarle County,51003,421,1770,2191,645,3965,4610,65550,460926,526476,04/01/2018 12:00:00 AM,156,260,240
Piedmont,Albemarle County,51003,421,1776,2197,636,3956,4592,66047,464455.95,530502.95,03/01/2018 12:00:00 AM,157,262,241
Piedmont,Albemarle County,51003,421,1947,2368,646,4407,5053,66351,501456,567807,01/01/2017 12:00:00 AM,158,258,240
Piedmont,Albemarle County,51003,422,1761,2183,650,3942,4592,66252,453028,519280,05/01/2018 12:00:00 AM,157,257,238
Piedmont,Albemarle County,51003,422,2024,2446,632,4292,4924,113429,739957,853386,07/01/2020 12:00:00 AM,269,366,349
Piedmont,Albemarle County,51003,422,2806,3228,643,6140,6783,69601,709272,778873,01/01/2014 12:00:00 AM,165,253,241
Piedmont,Albemarle County,51003,422,2818,3240,642,6168,6810,70681,718006,788687,12/01/2013 12:00:00 AM,167,255,243
Piedmont,Albemarle County,51003,422,2848,3270,631,6229,6860,68823,725403,794226,11/01/2013 12:00:00 AM,163,255,243
Piedmont,Albemarle County,51003,423,2250,2673,657,5177,5834,71350,603835,675185,09/01/2015 12:00:00 AM,169,268,253
Piedmont,Albemarle County,51003,424,2295,2719,659,5193,5852,73465,610941,684406,07/01/2015 12:00:00 AM,173,266,252
Piedmont,Albemarle County,51003,425,2226,2651,664,5109,5773,71242,595320,666562,11/01/2015 12:00:00 AM,168,267,251
Piedmont,Albemarle County,51003,426,1945,2371,665,4451,5116,67602,518815,586417,10/01/2016 12:00:00 AM,159,267,247
Piedmont,Albemarle County,51003,427,1909,2336,679,4373,5052,69451,503109,572560,11/01/2016 12:00:00 AM,163,264,245
Piedmont,Albemarle County,51003,427,2071,2498,606,4375,4981,133363,916221,1049584,03/01/2021 12:00:00 AM,312,442,420
Piedmont,Albemarle County,51003,428,2219,2647,653,5092,5745,69270,587170,656440,12/01/2015 12:00:00 AM,162,265,248
Piedmont,Albemarle County,51003,429,1978,2407,672,4554,5226,69962,538024,607986,09/01/2016 12:00:00 AM,163,272,253
Piedmont,Albemarle County,51003,429,2071,2500,637,4401,5038,115317,759311,874628,08/01/2020 12:00:00 AM,269,367,350
Piedmont,Albemarle County,51003,430,2023,2453,672,4651,5323,70201,543857,614058,07/01/2016 12:00:00 AM,163,269,250
Piedmont,Albemarle County,51003,430,2492,2922,685,5515,6200,75542,659332,734874,11/01/2014 12:00:00 AM,176,265,251
Piedmont,Albemarle County,51003,432,2045,2477,628,4282,4910,145172,983676,1128848,04/01/2021 12:00:00 AM,336,481,456
Piedmont,Albemarle County,51003,432,2716,3148,672,5958,6630,73179,704136,777315,05/01/2014 12:00:00 AM,169,259,247
Piedmont,Albemarle County,51003,433,2180,2613,680,4951,5631,73849,570274,644123,02/01/2016 12:00:00 AM,171,262,247
Piedmont,Albemarle County,51003,433,2520,2953,704,5556,6260,79623,670298,749921,10/01/2014 12:00:00 AM,184,266,254
Piedmont,Albemarle County,51003,433,2545,2978,690,5632,6322,71927,649958,721885,09/01/2014 12:00:00 AM,166,255,242
Piedmont,Albemarle County,51003,434,2059,2493,679,4687,5366,70862,562454,633316,06/01/2016 12:00:00 AM,163,273,254
Piedmont,Albemarle County,51003,434,2175,2609,673,4955,5628,71730,568122,639852,01/01/2016 12:00:00 AM,165,261,245
Piedmont,Albemarle County,51003,434,2794,3228,651,6136,6787,71485,716896,788381,03/01/2014 12:00:00 AM,165,257,244
Piedmont,Albemarle County,51003,435,2816,3251,665,6142,6807,72719,718911,791630,02/01/2014 12:00:00 AM,167,255,244
Piedmont,Albemarle County,51003,436,2038,2474,632,4243,4875,147602,978051,1125653,05/01/2021 12:00:00 AM,339,480,455
Piedmont,Albemarle County,51003,436,2041,2477,639,4226,4865,148623,972191,1120814,06/01/2021 12:00:00 AM,341,476,452
Piedmont,Albemarle County,51003,438,2019,2457,690,4638,5328,71662,541373,613035,08/01/2016 12:00:00 AM,164,268,250
Piedmont,Albemarle County,51003,438,2565,3003,690,5669,6359,72868,662887,735755,08/01/2014 12:00:00 AM,166,258,245
Piedmont,Albemarle County,51003,438,2698,3136,703,5918,6621,75705,696027,771732,06/01/2014 12:00:00 AM,173,258,246
Piedmont,Albemarle County,51003,439,2146,2585,684,4893,5577,72043,563924,635967,03/01/2016 12:00:00 AM,164,263,246
Piedmont,Albemarle County,51003,441,2062,2503,701,4724,5425,75402,554569,629971,05/01/2016 12:00:00 AM,171,269,252
Piedmont,Albemarle County,51003,441,2100,2541,699,4810,5509,73135,553787,626922,04/01/2016 12:00:00 AM,166,264,247
Piedmont,Albemarle County,51003,441,2106,2547,650,4496,5146,117900,784928,902828,09/01/2020 12:00:00 AM,267,373,354
Piedmont,Albemarle County,51003,442,2075,2517,662,4393,5055,125962,804379,930341,10/01/2020 12:00:00 AM,285,388,370
Piedmont,Albemarle County,51003,442,2628,3070,710,5824,6534,75689,681723,757412,07/01/2014 12:00:00 AM,171,259,247
Piedmont,Albemarle County,51003,442,2761,3203,686,6069,6755,74295,710631,784926,04/01/2014 12:00:00 AM,168,257,245
Piedmont,Albemarle County,51003,443,2011,2454,674,4278,4952,146813,888441,1035254,01/01/2021 12:00:00 AM,331,442,422
Piedmont,Albemarle County,51003,443,2058,2501,661,4329,4990,125763,795525,921288,11/01/2020 12:00:00 AM,284,387,368
Piedmont,Albemarle County,51003,445,2035,2480,672,4330,5002,129089,789756,918845,12/01/2020 12:00:00 AM,290,388,371
Piedmont,Alleghany County,51005,164,707,871,215,1594,1809,17847,169931,187778,08/01/2019 12:00:00 AM,109,240,216
Piedmont,Alleghany County,51005,164,749,913,213,1621,1834,18392,182141,200533,02/01/2020 12:00:00 AM,112,243,220
Piedmont,Alleghany County,51005,165,760,925,213,1671,1884,39949,284778,324727,03/01/2020 12:00:00 AM,242,375,351
Piedmont,Alleghany County,51005,166,719,885,212,1608,1820,16658,170130,186788,09/01/2019 12:00:00 AM,100,237,211
Piedmont,Alleghany County,51005,166,730,896,209,1615,1824,17852,172312,190164,11/01/2019 12:00:00 AM,108,236,212
Piedmont,Alleghany County,51005,167,704,871,222,1597,1819,18297,172799,191096,07/01/2019 12:00:00 AM,110,245,219
Piedmont,Alleghany County,51005,167,733,900,218,1612,1830,18732,175714,194446,12/01/2019 12:00:00 AM,112,240,216
Piedmont,Alleghany County,51005,167,745,912,221,1628,1849,18054,182170,200224,01/01/2020 12:00:00 AM,108,245,220
Piedmont,Alleghany County,51005,168,777,945,201,1774,1975,17146,198570,215716,12/01/2017 12:00:00 AM,102,256,228
Piedmont,Alleghany County,51005,169,719,888,213,1603,1816,17053,170219,187272,10/01/2019 12:00:00 AM,101,237,211
Piedmont,Alleghany County,51005,171,744,915,207,1706,1913,16508,189477,205985,06/01/2018 12:00:00 AM,97,255,225
Piedmont,Alleghany County,51005,171,765,936,204,1729,1933,17047,191731,208778,01/01/2018 12:00:00 AM,100,251,223
Piedmont,Alleghany County,51005,171,806,977,226,1753,1979,42061,302874,344935,04/01/2020 12:00:00 AM,246,376,353
Piedmont,Alleghany County,51005,173,825,998,232,1803,2035,42707,307903,350610,05/01/2020 12:00:00 AM,247,373,351
Piedmont,Alleghany County,51005,174,709,883,238,1595,1833,20348,173505,193853,06/01/2019 12:00:00 AM,117,245,220
Piedmont,Alleghany County,51005,174,753,927,209,1694,1903,17363,190867,208230,02/01/2018 12:00:00 AM,100,253,225
Piedmont,Alleghany County,51005,174,813,987,233,1785,2018,43637,308868,352505,06/01/2020 12:00:00 AM,251,380,357
Piedmont,Alleghany County,51005,175,750,925,216,1717,1933,18395,185313,203708,10/01/2018 12:00:00 AM,105,247,220
Piedmont,Alleghany County,51005,175,789,964,219,1781,2000,18965,197658,216623,11/01/2017 12:00:00 AM,108,251,225
Piedmont,Alleghany County,51005,176,717,893,244,1621,1865,21591,174110,195701,05/01/2019 12:00:00 AM,123,243,219
Piedmont,Alleghany County,51005,176,723,899,227,1630,1857,20047,172953,193000,02/01/2019 12:00:00 AM,114,239,215
Piedmont,Alleghany County,51005,176,736,912,215,1689,1904,19041,187609,206650,05/01/2018 12:00:00 AM,108,255,227
Piedmont,Alleghany County,51005,176,741,917,211,1686,1897,17331,183495,200826,04/01/2018 12:00:00 AM,98,248,219
Piedmont,Alleghany County,51005,176,746,922,211,1697,1908,18483,187955,206438,03/01/2018 12:00:00 AM,105,252,224
Piedmont,Alleghany County,51005,178,780,958,217,1784,2001,18531,199478,218009,10/01/2017 12:00:00 AM,104,256,228
Piedmont,Alleghany County,51005,179,730,909,246,1665,1911,20906,175735,196641,04/01/2019 12:00:00 AM,117,241,216
Piedmont,Alleghany County,51005,180,736,916,221,1682,1903,18738,186110,204848,07/01/2018 12:00:00 AM,104,253,224
Piedmont,Alleghany County,51005,180,744,924,217,1693,1910,17822,183666,201488,08/01/2018 12:00:00 AM,99,247,218
Piedmont,Alleghany County,51005,180,749,929,229,1736,1965,20776,187428,208204,12/01/2018 12:00:00 AM,115,250,224
Piedmont,Alleghany County,51005,180,760,940,226,1742,1968,19958,190722,210680,11/01/2018 12:00:00 AM,111,251,224
Piedmont,Alleghany County,51005,181,752,933,239,1726,1965,23128,191369,214497,01/01/2019 12:00:00 AM,128,254,230
Piedmont,Alleghany County,51005,181,833,1014,242,1844,2086,44654,317942,362596,07/01/2020 12:00:00 AM,247,382,358
Piedmont,Alleghany County,51005,182,743,925,225,1712,1937,19914,186139,206053,09/01/2018 12:00:00 AM,109,251,223
Piedmont,Alleghany County,51005,182,834,1016,243,1836,2079,45338,312313,357651,09/01/2020 12:00:00 AM,249,374,352
Piedmont,Alleghany County,51005,183,835,1018,243,1823,2066,45328,310027,355355,08/01/2020 12:00:00 AM,248,371,349
Piedmont,Alleghany County,51005,184,733,917,248,1675,1923,21124,175861,196985,03/01/2019 12:00:00 AM,115,240,215
Piedmont,Alleghany County,51005,184,780,964,230,1779,2009,19329,195423,214752,09/01/2017 12:00:00 AM,105,251,223
Piedmont,Alleghany County,51005,184,840,1024,236,1898,2134,53092,397227,450319,02/01/2021 12:00:00 AM,289,473,440
Piedmont,Alleghany County,51005,187,768,955,232,1756,1988,19753,194465,214218,07/01/2017 12:00:00 AM,106,253,224
Piedmont,Alleghany County,51005,187,773,960,231,1772,2003,18569,197929,216498,06/01/2017 12:00:00 AM,99,256,226
Piedmont,Alleghany County,51005,187,828,1015,245,1851,2096,47686,339144,386830,10/01/2020 12:00:00 AM,255,410,381
Piedmont,Alleghany County,51005,188,786,974,237,1776,2013,19746,198865,218611,08/01/2017 12:00:00 AM,105,253,224
Piedmont,Alleghany County,51005,188,839,1027,255,1840,2095,58346,410162,468508,06/01/2021 12:00:00 AM,310,489,456
Piedmont,Alleghany County,51005,190,831,1021,253,1877,2130,48850,343666,392516,12/01/2020 12:00:00 AM,257,414,384
Piedmont,Alleghany County,51005,190,836,1026,255,1879,2134,49960,342638,392598,11/01/2020 12:00:00 AM,263,410,383
Piedmont,Alleghany County,51005,191,842,1033,250,1883,2133,55929,387317,443246,03/01/2021 12:00:00 AM,293,460,429
Piedmont,Alleghany County,51005,192,828,1020,264,1828,2092,61364,403681,465045,05/01/2021 12:00:00 AM,320,488,456
Piedmont,Alleghany County,51005,192,829,1021,256,1842,2098,59398,415568,474966,04/01/2021 12:00:00 AM,309,501,465
Piedmont,Alleghany County,51005,194,778,972,242,1783,2025,19983,196221,216204,05/01/2017 12:00:00 AM,103,252,222
Piedmont,Alleghany County,51005,195,825,1020,267,1865,2132,59821,387168,446989,01/01/2021 12:00:00 AM,307,469,438
Piedmont,Alleghany County,51005,196,857,1053,253,2015,2268,22786,216043,238829,09/01/2015 12:00:00 AM,116,252,227
Piedmont,Alleghany County,51005,197,763,960,248,1757,2005,21656,192347,214003,03/01/2017 12:00:00 AM,110,252,223
Piedmont,Alleghany County,51005,198,769,967,249,1782,2031,20397,194665,215062,04/01/2017 12:00:00 AM,103,253,222
Piedmont,Alleghany County,51005,198,861,1059,254,2026,2280,22609,215426,238035,08/01/2015 12:00:00 AM,114,250,225
Piedmont,Alleghany County,51005,202,818,1020,267,1936,2203,21608,203631,225239,05/01/2016 12:00:00 AM,107,249,221
Piedmont,Alleghany County,51005,203,836,1039,272,1982,2254,24387,211362,235749,10/01/2015 12:00:00 AM,120,253,227
Piedmont,Alleghany County,51005,203,840,1043,272,1978,2250,22453,208440,230893,04/01/2016 12:00:00 AM,111,248,221
Piedmont,Alleghany County,51005,203,843,1046,261,1964,2225,21519,212384,233903,01/01/2017 12:00:00 AM,106,252,224
Piedmont,Alleghany County,51005,203,849,1052,269,1977,2246,22764,209756,232520,03/01/2016 12:00:00 AM,112,247,221
Piedmont,Alleghany County,51005,204,831,1035,278,1958,2236,25050,205380,230430,11/01/2015 12:00:00 AM,123,247,223
Piedmont,Alleghany County,51005,205,868,1073,263,2022,2285,23802,215926,239728,07/01/2015 12:00:00 AM,116,249,223
Piedmont,Alleghany County,51005,207,842,1049,262,1973,2235,21649,217220,238869,02/01/2017 12:00:00 AM,105,258,228
Piedmont,Alleghany County,51005,208,862,1070,279,2000,2279,26408,214433,240841,06/01/2015 12:00:00 AM,127,249,225
Piedmont,Alleghany County,51005,209,812,1021,279,1921,2200,23238,200504,223742,06/01/2016 12:00:00 AM,111,247,219
Piedmont,Alleghany County,51005,210,799,1009,287,1859,2146,23652,198353,222005,08/01/2016 12:00:00 AM,113,248,220
Piedmont,Alleghany County,51005,210,817,1027,274,1902,2176,23162,203308,226470,12/01/2016 12:00:00 AM,110,249,221
Piedmont,Alleghany County,51005,210,824,1034,292,1912,2204,25840,204328,230168,02/01/2016 12:00:00 AM,123,248,223
Piedmont,Alleghany County,51005,212,832,1044,293,1948,2241,27340,203858,231198,12/01/2015 12:00:00 AM,129,245,221
Piedmont,Alleghany County,51005,213,796,1009,289,1867,2156,22935,196892,219827,07/01/2016 12:00:00 AM,108,247,218
Piedmont,Alleghany County,51005,214,873,1087,285,2046,2331,25004,221443,246447,02/01/2015 12:00:00 AM,117,254,227
Piedmont,Alleghany County,51005,215,826,1041,303,1916,2219,28240,200191,228431,01/01/2016 12:00:00 AM,131,242,219
Piedmont,Alleghany County,51005,215,837,1052,296,1988,2284,26457,217242,243699,10/01/2014 12:00:00 AM,123,260,232
Piedmont,Alleghany County,51005,215,860,1075,291,1997,2288,27244,221951,249195,04/01/2015 12:00:00 AM,127,258,232
Piedmont,Alleghany County,51005,215,861,1076,296,2028,2324,25351,222637,247988,12/01/2014 12:00:00 AM,118,259,230
Piedmont,Alleghany County,51005,215,879,1094,298,2044,2342,24673,216331,241004,09/01/2014 12:00:00 AM,115,246,220
Piedmont,Alleghany County,51005,216,812,1028,288,1892,2180,24582,205818,230400,11/01/2016 12:00:00 AM,114,253,224
Piedmont,Alleghany County,51005,216,815,1031,300,1886,2186,26132,201937,228069,09/01/2016 12:00:00 AM,121,248,221
Piedmont,Alleghany County,51005,216,870,1086,292,2041,2333,24554,215272,239826,01/01/2015 12:00:00 AM,114,247,221
Piedmont,Alleghany County,51005,217,841,1058,295,1950,2245,27447,213821,241268,05/01/2015 12:00:00 AM,126,254,228
Piedmont,Alleghany County,51005,217,881,1098,290,2052,2342,25974,223617,249591,03/01/2015 12:00:00 AM,120,254,227
Piedmont,Alleghany County,51005,219,851,1070,308,1996,2304,26845,220299,247144,11/01/2014 12:00:00 AM,123,259,231
Piedmont,Alleghany County,51005,219,893,1112,306,2074,2380,25581,217590,243171,08/01/2014 12:00:00 AM,117,244,219
Piedmont,Alleghany County,51005,220,815,1035,301,1888,2189,26245,207349,233594,10/01/2016 12:00:00 AM,119,254,226
Piedmont,Alleghany County,51005,220,889,1109,315,2137,2452,34001,243082,277083,04/01/2012 12:00:00 AM,155,273,250
Piedmont,Alleghany County,51005,220,890,1110,323,2120,2443,34021,239593,273614,03/01/2012 12:00:00 AM,155,269,246
Piedmont,Alleghany County,51005,221,885,1106,334,2121,2455,34708,240374,275082,02/01/2012 12:00:00 AM,157,272,249
Piedmont,Alleghany County,51005,221,898,1119,313,2075,2388,27923,222074,249997,04/01/2014 12:00:00 AM,126,247,223
Piedmont,Alleghany County,51005,222,886,1108,321,2042,2363,28575,217471,246046,05/01/2014 12:00:00 AM,129,245,222
Piedmont,Alleghany County,51005,223,880,1103,313,2047,2360,26819,217776,244595,07/01/2014 12:00:00 AM,120,247,222
Piedmont,Alleghany County,51005,223,938,1161,317,2176,2493,27792,226222,254014,01/01/2014 12:00:00 AM,125,241,219
Piedmont,Alleghany County,51005,225,884,1109,314,2131,2445,32948,246923,279871,05/01/2012 12:00:00 AM,146,279,252
Piedmont,Alleghany County,51005,225,886,1111,314,2108,2422,35000,268711,303711,07/01/2012 12:00:00 AM,156,303,273
Piedmont,Alleghany County,51005,226,877,1103,317,2085,2402,31899,236250,268149,09/01/2012 12:00:00 AM,141,269,243
Piedmont,Alleghany County,51005,226,882,1108,324,2105,2429,33189,240792,273981,08/01/2012 12:00:00 AM,147,273,247
Piedmont,Alleghany County,51005,226,936,1162,327,2152,2479,29817,228139,257956,02/01/2014 12:00:00 AM,132,244,222
Piedmont,Alleghany County,51005,227,882,1109,317,2110,2427,32538,246030,278568,06/01/2012 12:00:00 AM,143,279,251
Piedmont,Alleghany County,51005,228,876,1104,323,2041,2364,27828,214850,242678,06/01/2014 12:00:00 AM,122,245,220
Piedmont,Alleghany County,51005,228,922,1150,337,2104,2441,31696,221853,253549,03/01/2014 12:00:00 AM,139,241,220
Piedmont,Alleghany County,51005,228,936,1164,323,2222,2545,32326,250669,282995,06/01/2013 12:00:00 AM,142,268,243
Piedmont,Alleghany County,51005,229,928,1157,319,2207,2526,31364,247971,279335,07/01/2013 12:00:00 AM,137,267,241
Piedmont,Alleghany County,51005,230,930,1160,337,2157,2494,31615,228313,259928,12/01/2013 12:00:00 AM,137,245,224
Piedmont,Alleghany County,51005,230,940,1170,336,2177,2513,32279,229807,262086,11/01/2013 12:00:00 AM,140,244,224
Piedmont,Alleghany County,51005,231,932,1163,324,2175,2499,32590,246054,278644,10/01/2013 12:00:00 AM,141,264,240
Piedmont,Alleghany County,51005,232,861,1093,360,2062,2422,36246,234187,270433,01/01/2012 12:00:00 AM,156,272,247
Piedmont,Alleghany County,51005,233,891,1124,341,2109,2450,34424,238207,272631,11/01/2012 12:00:00 AM,148,267,243
Piedmont,Alleghany County,51005,236,927,1163,332,2182,2514,32355,247672,280027,09/01/2013 12:00:00 AM,137,267,241
Piedmont,Alleghany County,51005,237,875,1112,343,2073,2416,35726,233900,269626,10/01/2012 12:00:00 AM,151,267,242
Piedmont,Alleghany County,51005,238,906,1144,341,2170,2511,33352,242942,276294,02/01/2013 12:00:00 AM,140,268,242
Piedmont,Alleghany County,51005,238,931,1169,342,2207,2549,34454,246289,280743,08/01/2013 12:00:00 AM,145,265,240
Piedmont,Alleghany County,51005,239,916,1155,342,2196,2538,35259,242904,278163,04/01/2013 12:00:00 AM,148,265,241
Piedmont,Alleghany County,51005,239,924,1163,342,2217,2559,35224,249491,284715,05/01/2013 12:00:00 AM,147,270,245
Piedmont,Alleghany County,51005,240,895,1135,351,2127,2478,35321,235508,270829,01/01/2013 12:00:00 AM,147,263,239
Piedmont,Alleghany County,51005,243,908,1151,363,2165,2528,36456,241584,278040,03/01/2013 12:00:00 AM,150,266,242
Piedmont,Alleghany County,51005,244,886,1130,357,2123,2480,37092,239914,277006,12/01/2012 12:00:00 AM,152,271,245
Piedmont,Amherst County,51009,283,1224,1507,374,2830,3204,32861,307331,340192,01/01/2020 12:00:00 AM,116,251,226
Piedmont,Amherst County,51009,285,1219,1504,368,2826,3194,32702,307796,340498,02/01/2020 12:00:00 AM,115,252,226
Piedmont,Amherst County,51009,288,1242,1530,366,2988,3354,36493,331995,368488,07/01/2017 12:00:00 AM,127,267,241
Piedmont,Amherst County,51009,288,1248,1536,385,2904,3289,70630,493523,564153,03/01/2020 12:00:00 AM,245,395,367
Piedmont,Amherst County,51009,288,1275,1563,370,3054,3424,35929,346024,381953,08/01/2017 12:00:00 AM,125,271,244
Piedmont,Amherst County,51009,289,1442,1731,376,3250,3626,84257,690424,774681,02/01/2021 12:00:00 AM,292,479,448
Piedmont,Amherst County,51009,290,1234,1524,385,2872,3257,35650,309448,345098,12/01/2019 12:00:00 AM,123,251,226
Piedmont,Amherst County,51009,290,1266,1556,361,2960,3321,35022,327704,362726,11/01/2017 12:00:00 AM,121,259,233
Piedmont,Amherst County,51009,290,1356,1646,385,3109,3494,71027,536277,607304,04/01/2020 12:00:00 AM,245,395,369
Piedmont,Amherst County,51009,290,1385,1675,388,3164,3552,71249,536940,608189,05/01/2020 12:00:00 AM,246,388,363
Piedmont,Amherst County,51009,293,1212,1505,389,2812,3201,35758,303489,339247,11/01/2019 12:00:00 AM,122,250,225
Piedmont,Amherst County,51009,293,1235,1528,372,2839,3211,37002,310482,347484,10/01/2018 12:00:00 AM,126,251,227
Piedmont,Amherst County,51009,293,1266,1559,362,3033,3395,34715,342862,377577,09/01/2017 12:00:00 AM,118,271,242
Piedmont,Amherst County,51009,293,1435,1728,389,3231,3620,71039,548930,619969,08/01/2020 12:00:00 AM,242,383,359
Piedmont,Amherst County,51009,294,1277,1571,363,3011,3374,35108,332780,367888,10/01/2017 12:00:00 AM,119,261,234
Piedmont,Amherst County,51009,295,1248,1543,365,2877,3242,36417,322527,358944,09/01/2018 12:00:00 AM,123,258,233
Piedmont,Amherst County,51009,295,1261,1556,354,2930,3284,33906,318458,352364,07/01/2018 12:00:00 AM,115,253,226
Piedmont,Amherst County,51009,295,1269,1564,357,2967,3324,34148,326150,360298,06/01/2018 12:00:00 AM,116,257,230
Piedmont,Amherst County,51009,295,1437,1732,399,3238,3637,75911,582123,658034,12/01/2020 12:00:00 AM,257,405,380
Piedmont,Amherst County,51009,296,1409,1705,393,3205,3598,72439,550237,622676,06/01/2020 12:00:00 AM,245,391,365
Piedmont,Amherst County,51009,296,1424,1720,400,3204,3604,88468,662366,750834,01/01/2021 12:00:00 AM,299,465,437
Piedmont,Amherst County,51009,296,1433,1729,393,3229,3622,73115,553719,626834,07/01/2020 12:00:00 AM,247,386,363
Piedmont,Amherst County,51009,297,1265,1562,367,2958,3325,36416,322478,358894,12/01/2017 12:00:00 AM,123,255,230
Piedmont,Amherst County,51009,297,1442,1739,402,3273,3675,77436,595630,673066,11/01/2020 12:00:00 AM,261,413,387
Piedmont,Amherst County,51009,298,1393,1691,391,3164,3555,92146,702497,794643,05/01/2021 12:00:00 AM,309,504,470
Piedmont,Amherst County,51009,298,1449,1747,396,3310,3706,72166,553623,625789,09/01/2020 12:00:00 AM,242,382,358
Piedmont,Amherst County,51009,299,1206,1505,393,2794,3187,35894,305058,340952,10/01/2019 12:00:00 AM,120,253,227
Piedmont,Amherst County,51009,299,1262,1561,371,2915,3286,36657,319985,356642,08/01/2018 12:00:00 AM,123,254,228
Piedmont,Amherst County,51009,299,1275,1574,386,3069,3455,37952,343368,381320,06/01/2017 12:00:00 AM,127,269,242
Piedmont,Amherst County,51009,299,1433,1732,389,3249,3638,86868,665439,752307,03/01/2021 12:00:00 AM,291,464,434
Piedmont,Amherst County,51009,300,1168,1468,380,2627,3007,35778,302031,337809,02/01/2019 12:00:00 AM,119,259,230
Piedmont,Amherst County,51009,300,1237,1537,375,2941,3316,35736,324369,360105,03/01/2017 12:00:00 AM,119,262,234
Piedmont,Amherst County,51009,301,1235,1536,384,2976,3360,37457,334512,371969,05/01/2017 12:00:00 AM,124,271,242
Piedmont,Amherst County,51009,302,1271,1573,369,2983,3352,35616,327981,363597,02/01/2018 12:00:00 AM,118,258,231
Piedmont,Amherst County,51009,302,1277,1579,373,2952,3325,35337,324467.91,359804.91,03/01/2018 12:00:00 AM,117,254,228
Piedmont,Amherst County,51009,302,1409,1711,401,3175,3576,94001,703880,797881,04/01/2021 12:00:00 AM,311,500,466
Piedmont,Amherst County,51009,303,1211,1514,403,2771,3174,38243,308101,346344,06/01/2019 12:00:00 AM,126,254,229
Piedmont,Amherst County,51009,303,1211,1514,409,2806,3215,38058,305076,343134,09/01/2019 12:00:00 AM,126,252,227
Piedmont,Amherst County,51009,303,1234,1537,384,2865,3249,39335,317329,356664,11/01/2018 12:00:00 AM,130,257,232
Piedmont,Amherst County,51009,303,1276,1579,369,2955,3324,34759,324595,359354,04/01/2018 12:00:00 AM,115,254,228
Piedmont,Amherst County,51009,303,1280,1583,366,3000,3366,34445,326557,361002,05/01/2018 12:00:00 AM,114,255,228
Piedmont,Amherst County,51009,303,1390,1693,402,3153,3555,94603,699205,793808,06/01/2021 12:00:00 AM,312,503,469
Piedmont,Amherst County,51009,304,1192,1496,398,2697,3095,37499,300269,337768,05/01/2019 12:00:00 AM,123,252,226
Piedmont,Amherst County,51009,304,1206,1510,398,2788,3186,36817,304027,340844,08/01/2019 12:00:00 AM,121,252,226
Piedmont,Amherst County,51009,304,1210,1514,395,2784,3179,39209,312340,351549,12/01/2018 12:00:00 AM,129,258,232
Piedmont,Amherst County,51009,304,1213,1517,401,2776,3177,38017,306596,344613,07/01/2019 12:00:00 AM,125,253,227
Piedmont,Amherst County,51009,304,1242,1546,385,2998,3383,37590,335809,373399,04/01/2017 12:00:00 AM,124,270,242
Piedmont,Amherst County,51009,304,1269,1573,375,2969,3344,36316,321449,357765,01/01/2018 12:00:00 AM,119,253,227
Piedmont,Amherst County,51009,304,1319,1623,396,3190,3586,36264,337359,373623,05/01/2015 12:00:00 AM,119,256,230
Piedmont,Amherst County,51009,304,1451,1755,408,3298,3706,79226,601409,680635,10/01/2020 12:00:00 AM,261,414,388
Piedmont,Amherst County,51009,305,1214,1519,393,2748,3141,36861,307647,344508,03/01/2019 12:00:00 AM,121,253,227
Piedmont,Amherst County,51009,306,1204,1510,397,2724,3121,37090,305619,342709,04/01/2019 12:00:00 AM,121,254,227
Piedmont,Amherst County,51009,308,1217,1525,406,2752,3158,39600,324989,364589,01/01/2019 12:00:00 AM,129,267,239
Piedmont,Amherst County,51009,311,1309,1620,406,3149,3555,37962,334998,372960,06/01/2015 12:00:00 AM,122,256,230
Piedmont,Amherst County,51009,312,1307,1619,408,3156,3564,38377,336043,374420,07/01/2015 12:00:00 AM,123,257,231
Piedmont,Amherst County,51009,313,1333,1646,423,3200,3623,39024,339758,378782,04/01/2015 12:00:00 AM,125,255,230
Piedmont,Amherst County,51009,313,1384,1697,409,3195,3604,33891,325834,359725,05/01/2014 12:00:00 AM,108,235,212
Piedmont,Amherst County,51009,315,1310,1625,415,3139,3554,41213,339285,380498,08/01/2015 12:00:00 AM,131,259,234
Piedmont,Amherst County,51009,315,1343,1658,415,3128,3543,36206,314736,350942,06/01/2014 12:00:00 AM,115,234,212
Piedmont,Amherst County,51009,316,1333,1649,410,3157,3567,35738,319433,355171,07/01/2014 12:00:00 AM,113,240,215
Piedmont,Amherst County,51009,316,1344,1660,415,3179,3594,36958,322966,359924,08/01/2014 12:00:00 AM,117,240,217
Piedmont,Amherst County,51009,317,1285,1602,424,3055,3479,40702,330060,370762,04/01/2016 12:00:00 AM,128,257,231
Piedmont,Amherst County,51009,317,1301,1618,398,3152,3550,37720,340144,377864,01/01/2017 12:00:00 AM,119,261,234
Piedmont,Amherst County,51009,317,1307,1624,437,3113,3550,41500,327093,368593,03/01/2015 12:00:00 AM,131,250,227
Piedmont,Amherst County,51009,317,1314,1631,424,3153,3577,41287,337444,378731,09/01/2015 12:00:00 AM,130,257,232
Piedmont,Amherst County,51009,318,1303,1621,425,3115,3540,41291,334472,375763,05/01/2016 12:00:00 AM,130,257,232
Piedmont,Amherst County,51009,318,1307,1625,412,3103,3515,39848,332177,372025,03/01/2016 12:00:00 AM,125,254,229
Piedmont,Amherst County,51009,318,1307,1625,426,3168,3594,42815,339407,382222,06/01/2016 12:00:00 AM,135,260,235
Piedmont,Amherst County,51009,318,1346,1664,426,3197,3623,39481,323828,363309,09/01/2014 12:00:00 AM,124,241,218
Piedmont,Amherst County,51009,319,1424,1743,425,3267,3692,36311,330043,366354,03/01/2014 12:00:00 AM,114,232,210
Piedmont,Amherst County,51009,319,1430,1749,421,3277,3698,35214,335525,370739,04/01/2014 12:00:00 AM,110,235,212
Piedmont,Amherst County,51009,320,1290,1610,403,3131,3534,38672,338839,377511,11/01/2016 12:00:00 AM,121,263,234
Piedmont,Amherst County,51009,320,1298,1618,414,3117,3531,40428,338284,378712,07/01/2016 12:00:00 AM,126,261,234
Piedmont,Amherst County,51009,320,1325,1645,426,3186,3612,39965,339239,379204,10/01/2015 12:00:00 AM,125,256,231
Piedmont,Amherst County,51009,321,1298,1619,412,3154,3566,39751,343536,383287,08/01/2016 12:00:00 AM,124,265,237
Piedmont,Amherst County,51009,321,1315,1636,427,3121,3548,40577,331042,371619,02/01/2016 12:00:00 AM,126,252,227
Piedmont,Amherst County,51009,322,1296,1618,409,3158,3567,40148,345207,385355,09/01/2016 12:00:00 AM,125,266,238
Piedmont,Amherst County,51009,323,1304,1627,429,3133,3562,39637,330647,370284,01/01/2016 12:00:00 AM,123,254,228
Piedmont,Amherst County,51009,323,1305,1628,439,3145,3584,41037,326966,368003,01/01/2015 12:00:00 AM,127,251,226
Piedmont,Amherst County,51009,323,1324,1647,434,3168,3602,41532,340767,382299,10/01/2014 12:00:00 AM,129,257,232
Piedmont,Amherst County,51009,324,1302,1626,404,3141,3545,40392,343041,383433,12/01/2016 12:00:00 AM,125,263,236
Piedmont,Amherst County,51009,324,1321,1645,435,3179,3614,41936,337534,379470,11/01/2015 12:00:00 AM,129,256,231
Piedmont,Amherst County,51009,324,1323,1647,435,3187,3622,41872,342399,384271,11/01/2014 12:00:00 AM,129,259,233
Piedmont,Amherst County,51009,324,1329,1653,421,3194,3615,40626,339789,380415,12/01/2015 12:00:00 AM,125,256,230
Piedmont,Amherst County,51009,326,1296,1622,414,3157,3571,40614,345255,385869,10/01/2016 12:00:00 AM,125,266,238
Piedmont,Amherst County,51009,326,1301,1627,453,3115,3568,42816,327911,370727,02/01/2015 12:00:00 AM,131,252,228
Piedmont,Amherst County,51009,326,1306,1632,443,3142,3585,43757,333236,376993,12/01/2014 12:00:00 AM,134,255,231
Piedmont,Amherst County,51009,327,1329,1656,413,3206,3619,39229,345660,384889,02/01/2017 12:00:00 AM,120,260,232
Piedmont,Amherst County,51009,328,1423,1751,443,3285,3728,39433,335346,374779,02/01/2014 12:00:00 AM,120,236,214
Piedmont,Amherst County,51009,328,1563,1891,470,3702,4172,48581,428858,477439,02/01/2012 12:00:00 AM,148,274,252
Piedmont,Amherst County,51009,333,1579,1912,475,3716,4191,49100,427331,476431,01/01/2012 12:00:00 AM,147,271,249
Piedmont,Amherst County,51009,336,1451,1787,453,3382,3835,42407,348534,390941,12/01/2013 12:00:00 AM,126,240,219
Piedmont,Amherst County,51009,337,1420,1757,456,3288,3744,41370,330711,372081,01/01/2014 12:00:00 AM,123,233,212
Piedmont,Amherst County,51009,337,1558,1895,488,3675,4163,50689,431635,482324,03/01/2012 12:00:00 AM,150,277,255
Piedmont,Amherst County,51009,340,1530,1870,456,3583,4039,46375,412632,459007,09/01/2013 12:00:00 AM,136,270,245
Piedmont,Amherst County,51009,340,1541,1881,478,3582,4060,49267,421484,470751,06/01/2012 12:00:00 AM,145,274,250
Piedmont,Amherst County,51009,342,1536,1878,491,3588,4079,51418,424490,475908,05/01/2012 12:00:00 AM,150,276,253
Piedmont,Amherst County,51009,344,1541,1885,488,3615,4103,50509,423764,474273,04/01/2012 12:00:00 AM,147,275,252
Piedmont,Amherst County,51009,344,1554,1898,504,3571,4075,54495,418470,472965,08/01/2012 12:00:00 AM,158,269,249
Piedmont,Amherst County,51009,346,1479,1825,471,3435,3906,44952,356460,401412,11/01/2013 12:00:00 AM,130,241,220
Piedmont,Amherst County,51009,346,1508,1854,474,3489,3963,49784,399428,449212,10/01/2013 12:00:00 AM,144,265,242
Piedmont,Amherst County,51009,346,1546,1892,504,3593,4097,58451,440762,499213,07/01/2012 12:00:00 AM,169,285,264
Piedmont,Amherst County,51009,346,1552,1898,455,3643,4098,45730,423861,469591,08/01/2013 12:00:00 AM,132,273,247
Piedmont,Amherst County,51009,347,1556,1903,522,3569,4091,57833,416911,474744,09/01/2012 12:00:00 AM,167,268,249
Piedmont,Amherst County,51009,348,1572,1920,489,3692,4181,51452,427895,479347,06/01/2013 12:00:00 AM,148,272,250
Piedmont,Amherst County,51009,352,1558,1910,473,3699,4172,48997,427726,476723,07/01/2013 12:00:00 AM,139,275,250
Piedmont,Amherst County,51009,354,1583,1937,500,3676,4176,53537,427327,480864,05/01/2013 12:00:00 AM,151,270,248
Piedmont,Amherst County,51009,356,1575,1931,517,3586,4103,56887,416564,473451,11/01/2012 12:00:00 AM,160,264,245
Piedmont,Amherst County,51009,359,1558,1917,536,3545,4081,58681,412063,470744,10/01/2012 12:00:00 AM,163,264,246
Piedmont,Amherst County,51009,362,1572,1934,535,3564,4099,57981,410925,468906,12/01/2012 12:00:00 AM,160,261,242
Piedmont,Amherst County,51009,364,1561,1925,518,3575,4093,54857,413045,467902,04/01/2013 12:00:00 AM,151,265,243
Piedmont,Amherst County,51009,365,1561,1926,529,3559,4088,55822,412132,467954,03/01/2013 12:00:00 AM,153,264,243
Piedmont,Amherst County,51009,371,1567,1938,545,3545,4090,57276,399241,456517,01/01/2013 12:00:00 AM,154,255,236
Piedmont,Amherst County,51009,372,1563,1935,549,3514,4063,59048,401031,460079,02/01/2013 12:00:00 AM,159,257,238
Piedmont,Appomattox County,51011,186,788,974,243,1815,2058,21713,205175,226888,02/01/2019 12:00:00 AM,117,260,233
Piedmont,Appomattox County,51011,188,817,1005,244,1878,2122,21102,214062,235164,01/01/2019 12:00:00 AM,112,262,234
Piedmont,Appomattox County,51011,190,798,988,249,1817,2066,21960,201840,223800,11/01/2019 12:00:00 AM,116,253,227
Piedmont,Appomattox County,51011,190,812,1002,250,1872,2122,21735,207829,229564,08/01/2019 12:00:00 AM,114,256,229
Piedmont,Appomattox County,51011,190,814,1004,252,1859,2111,22596,210886,233482,10/01/2019 12:00:00 AM,119,259,233
Piedmont,Appomattox County,51011,191,793,984,245,1826,2071,22083,206267,228350,06/01/2019 12:00:00 AM,116,260,232
Piedmont,Appomattox County,51011,192,812,1004,259,1839,2098,24419,209305,233724,12/01/2019 12:00:00 AM,127,258,233
Piedmont,Appomattox County,51011,193,786,979,253,1804,2057,23429,203605,227034,04/01/2019 12:00:00 AM,121,259,232
Piedmont,Appomattox County,51011,193,808,1001,250,1866,2116,23057,213242,236299,03/01/2019 12:00:00 AM,119,264,236
Piedmont,Appomattox County,51011,193,809,1002,253,1814,2067,22122,204091,226213,01/01/2020 12:00:00 AM,115,252,226
Piedmont,Appomattox County,51011,194,794,988,254,1829,2083,24103,208601,232704,05/01/2019 12:00:00 AM,124,263,236
Piedmont,Appomattox County,51011,194,794,988,255,1792,2047,22939,200660,223599,02/01/2020 12:00:00 AM,118,253,226
Piedmont,Appomattox County,51011,195,793,988,257,1843,2100,23241,206194,229435,07/01/2019 12:00:00 AM,119,260,232
Piedmont,Appomattox County,51011,196,808,1004,256,1853,2109,22102,209838,231940,09/01/2019 12:00:00 AM,113,260,231
Piedmont,Appomattox County,51011,197,825,1022,258,1840,2098,47453,313351,360804,03/01/2020 12:00:00 AM,241,380,353
Piedmont,Appomattox County,51011,198,813,1011,252,1884,2136,23471,219971.86,243442.86,10/01/2018 12:00:00 AM,119,271,241
Piedmont,Appomattox County,51011,198,824,1022,263,1919,2182,23216,224128,247344,03/01/2018 12:00:00 AM,117,272,242
Piedmont,Appomattox County,51011,199,800,999,259,1868,2127,24058,206338,230396,12/01/2018 12:00:00 AM,121,258,231
Piedmont,Appomattox County,51011,200,867,1067,256,1943,2199,47581,334621,382202,04/01/2020 12:00:00 AM,238,386,358
Piedmont,Appomattox County,51011,200,874,1074,254,1954,2208,47344,332001,379345,05/01/2020 12:00:00 AM,237,380,353
Piedmont,Appomattox County,51011,200,887,1087,250,2055,2305,56656,447689,504345,02/01/2021 12:00:00 AM,283,505,464
Piedmont,Appomattox County,51011,201,821,1022,258,1901,2159,23535,214960,238495,11/01/2018 12:00:00 AM,117,262,233
Piedmont,Appomattox County,51011,201,869,1070,270,2101,2371,25480,250802,276282,05/01/2017 12:00:00 AM,127,289,258
Piedmont,Appomattox County,51011,202,869,1071,259,1937,2196,47945,332183,380128,06/01/2020 12:00:00 AM,237,382,355
Piedmont,Appomattox County,51011,203,851,1054,269,1993,2262,24461,237535,261996,02/01/2018 12:00:00 AM,120,279,249
Piedmont,Appomattox County,51011,203,869,1072,257,1969,2226,59491,440851,500342,06/01/2021 12:00:00 AM,293,507,467
Piedmont,Appomattox County,51011,203,881,1084,255,1975,2230,60811,448060,508871,05/01/2021 12:00:00 AM,300,509,469
Piedmont,Appomattox County,51011,203,887,1090,252,2037,2289,57949,418318,476267,03/01/2021 12:00:00 AM,285,472,437
Piedmont,Appomattox County,51011,204,826,1030,272,1931,2203,24411,226070,250481,04/01/2018 12:00:00 AM,120,274,243
Piedmont,Appomattox County,51011,204,878,1082,256,1989,2245,60243,444876,505119,04/01/2021 12:00:00 AM,295,507,467
Piedmont,Appomattox County,51011,205,815,1020,262,1888,2150,23102,218238,241340,09/01/2018 12:00:00 AM,113,268,237
Piedmont,Appomattox County,51011,206,822,1028,265,1919,2184,22858,224418,247276,08/01/2018 12:00:00 AM,111,273,241
Piedmont,Appomattox County,51011,207,857,1064,276,2066,2342,25402,241800,267202,04/01/2017 12:00:00 AM,123,282,251
Piedmont,Appomattox County,51011,207,865,1072,280,2101,2381,26036,253310,279346,03/01/2017 12:00:00 AM,126,293,261
Piedmont,Appomattox County,51011,207,879,1086,271,1955,2226,50514,335936,386450,07/01/2020 12:00:00 AM,244,382,356
Piedmont,Appomattox County,51011,207,886,1093,272,2027,2299,61424,418602,480026,01/01/2021 12:00:00 AM,297,472,439
Piedmont,Appomattox County,51011,208,819,1027,266,1913,2179,22992,221591,244583,07/01/2018 12:00:00 AM,111,271,238
Piedmont,Appomattox County,51011,208,852,1060,275,2036,2311,24681,236372,261053,11/01/2017 12:00:00 AM,119,277,246
Piedmont,Appomattox County,51011,208,875,1083,276,2104,2380,26288,255160,281448,06/01/2017 12:00:00 AM,126,292,260
Piedmont,Appomattox County,51011,209,812,1021,273,1895,2168,24876,219856,244732,05/01/2018 12:00:00 AM,119,271,240
Piedmont,Appomattox County,51011,209,916,1125,312,2179,2491,29546,253289,282835,09/01/2015 12:00:00 AM,141,277,251
Piedmont,Appomattox County,51011,210,861,1071,273,2049,2322,24147,238802,262949,12/01/2017 12:00:00 AM,115,277,246
Piedmont,Appomattox County,51011,210,861,1071,278,2029,2307,24479,234989,259468,01/01/2018 12:00:00 AM,117,273,242
Piedmont,Appomattox County,51011,210,891,1101,274,1986,2260,50764,337851,388615,08/01/2020 12:00:00 AM,242,379,353
Piedmont,Appomattox County,51011,211,825,1036,272,1923,2195,23764,229354,253118,06/01/2018 12:00:00 AM,113,278,244
Piedmont,Appomattox County,51011,211,846,1057,284,2015,2299,25077,235085,260162,10/01/2017 12:00:00 AM,119,278,246
Piedmont,Appomattox County,51011,211,891,1102,277,2067,2344,54134,371510,425644,12/01/2020 12:00:00 AM,257,417,386
Piedmont,Appomattox County,51011,211,893,1104,278,2046,2324,54091,371333,425424,11/01/2020 12:00:00 AM,256,416,385
Piedmont,Appomattox County,51011,211,899,1110,321,2109,2430,28774,244930,273704,05/01/2015 12:00:00 AM,136,272,247
Piedmont,Appomattox County,51011,211,900,1111,276,2046,2322,50624,347007,397631,09/01/2020 12:00:00 AM,240,386,358
Piedmont,Appomattox County,51011,211,908,1119,317,2135,2452,28276,251572,279848,06/01/2015 12:00:00 AM,134,277,250
Piedmont,Appomattox County,51011,212,879,1091,283,2108,2391,26817,250792,277609,07/01/2017 12:00:00 AM,126,285,254
Piedmont,Appomattox County,51011,212,891,1103,291,2129,2420,27612,251978,279590,01/01/2017 12:00:00 AM,130,283,253
Piedmont,Appomattox County,51011,213,858,1071,285,2066,2351,26264,246114,272378,08/01/2017 12:00:00 AM,123,287,254
Piedmont,Appomattox County,51011,213,883,1096,286,2123,2409,26960,249438,276398,02/01/2017 12:00:00 AM,127,282,252
Piedmont,Appomattox County,51011,214,874,1088,314,2083,2397,29485,242797,272282,07/01/2016 12:00:00 AM,138,278,250
Piedmont,Appomattox County,51011,214,878,1092,309,2120,2429,27330,252421,279751,12/01/2016 12:00:00 AM,128,287,256
Piedmont,Appomattox County,51011,214,905,1119,280,2079,2359,54321,378672,432993,10/01/2020 12:00:00 AM,254,418,387
Piedmont,Appomattox County,51011,214,911,1125,319,2157,2476,29609,249582,279191,08/01/2015 12:00:00 AM,138,274,248
Piedmont,Appomattox County,51011,215,908,1123,324,2183,2507,31777,249351,281128,11/01/2015 12:00:00 AM,148,275,250
Piedmont,Appomattox County,51011,215,909,1124,325,2115,2440,30038,245487,275525,04/01/2015 12:00:00 AM,140,270,245
Piedmont,Appomattox County,51011,216,903,1119,323,2147,2470,31129,246463,277592,10/01/2015 12:00:00 AM,144,273,248
Piedmont,Appomattox County,51011,217,844,1061,292,2053,2345,26543,243470,270013,09/01/2017 12:00:00 AM,122,288,254
Piedmont,Appomattox County,51011,217,883,1100,319,2107,2426,30198,246346,276544,06/01/2016 12:00:00 AM,139,279,251
Piedmont,Appomattox County,51011,217,893,1110,337,2104,2441,34253,247232,281485,03/01/2016 12:00:00 AM,158,277,254
Piedmont,Appomattox County,51011,219,877,1096,315,2099,2414,29301,251291,280592,10/01/2016 12:00:00 AM,134,287,256
Piedmont,Appomattox County,51011,219,886,1105,319,2123,2442,30165,247214,277379,08/01/2016 12:00:00 AM,138,279,251
Piedmont,Appomattox County,51011,219,889,1108,333,2070,2403,31208,236530,267738,02/01/2015 12:00:00 AM,143,266,242
Piedmont,Appomattox County,51011,219,896,1115,321,2155,2476,30607,252392,282999,09/01/2016 12:00:00 AM,140,282,254
Piedmont,Appomattox County,51011,219,901,1120,332,2120,2452,30679,246921,277600,07/01/2015 12:00:00 AM,140,274,248
Piedmont,Appomattox County,51011,219,904,1123,327,2167,2494,31261,246703,277964,12/01/2015 12:00:00 AM,143,273,248
Piedmont,Appomattox County,51011,219,906,1125,328,2100,2428,30092,242979,273071,03/01/2015 12:00:00 AM,137,268,243
Piedmont,Appomattox County,51011,219,906,1125,335,2171,2506,32170,245368,277538,01/01/2016 12:00:00 AM,147,271,247
Piedmont,Appomattox County,51011,220,881,1101,324,2097,2421,30619,249259,279878,11/01/2016 12:00:00 AM,139,283,254
Piedmont,Appomattox County,51011,220,895,1115,338,2134,2472,34967,244501,279468,02/01/2016 12:00:00 AM,159,273,251
Piedmont,Appomattox County,51011,222,889,1111,345,2106,2451,33506,243964,277470,04/01/2016 12:00:00 AM,151,274,250
Piedmont,Appomattox County,51011,224,907,1131,345,2097,2442,32058,234535,266593,01/01/2015 12:00:00 AM,143,259,236
Piedmont,Appomattox County,51011,225,875,1100,346,2077,2423,34261,240731,274992,05/01/2016 12:00:00 AM,152,275,250
Piedmont,Appomattox County,51011,226,989,1215,360,2205,2565,32012,242271,274283,09/01/2014 12:00:00 AM,142,245,226
Piedmont,Appomattox County,51011,228,948,1176,369,2243,2612,37186,262759,299945,01/01/2012 12:00:00 AM,163,277,255
Piedmont,Appomattox County,51011,231,1008,1239,368,2274,2642,33697,251448,285145,08/01/2014 12:00:00 AM,146,249,230
Piedmont,Appomattox County,51011,232,926,1158,363,2106,2469,35409,243370,278779,12/01/2014 12:00:00 AM,153,263,241
Piedmont,Appomattox County,51011,232,966,1198,379,2278,2657,39116,270119,309235,03/01/2012 12:00:00 AM,169,280,258
Piedmont,Appomattox County,51011,232,971,1203,361,2193,2554,34697,251173,285870,10/01/2014 12:00:00 AM,150,259,238
Piedmont,Appomattox County,51011,233,955,1188,368,2153,2521,36003,247706,283709,11/01/2014 12:00:00 AM,155,259,239
Piedmont,Appomattox County,51011,234,1016,1250,369,2310,2679,32329,259901,292230,06/01/2014 12:00:00 AM,138,256,234
Piedmont,Appomattox County,51011,235,1007,1242,375,2286,2661,33596,251854,285450,07/01/2014 12:00:00 AM,143,250,230
Piedmont,Appomattox County,51011,235,996,1231,377,2317,2694,38392,280740,319132,05/01/2012 12:00:00 AM,163,282,259
Piedmont,Appomattox County,51011,236,961,1197,385,2255,2640,39172,267534,306706,02/01/2012 12:00:00 AM,166,278,256
Piedmont,Appomattox County,51011,237,1020,1257,397,2294,2691,41361,285747,327108,10/01/2013 12:00:00 AM,175,280,260
Piedmont,Appomattox County,51011,238,1016,1254,389,2293,2682,38245,283966,322211,09/01/2013 12:00:00 AM,161,279,257
Piedmont,Appomattox County,51011,238,1021,1259,380,2324,2704,35254,259465,294719,05/01/2014 12:00:00 AM,148,254,234
Piedmont,Appomattox County,51011,238,1031,1269,388,2322,2710,35483,263900,299383,11/01/2013 12:00:00 AM,149,256,236
Piedmont,Appomattox County,51011,238,980,1218,393,2286,2679,40165,276742,316907,04/01/2012 12:00:00 AM,169,282,260
Piedmont,Appomattox County,51011,240,993,1233,395,2294,2689,41773,276471,318244,06/01/2012 12:00:00 AM,174,278,258
Piedmont,Appomattox County,51011,241,1023,1264,403,2305,2708,38655,287685,326340,08/01/2013 12:00:00 AM,160,281,258
Piedmont,Appomattox County,51011,242,1000,1242,402,2266,2668,40466,281636,322102,10/01/2012 12:00:00 AM,167,282,259
Piedmont,Appomattox County,51011,243,1030,1273,402,2309,2711,37203,255958,293161,03/01/2014 12:00:00 AM,153,249,230
Piedmont,Appomattox County,51011,244,1009,1253,419,2259,2678,42139,281240,323379,07/01/2013 12:00:00 AM,173,279,258
Piedmont,Appomattox County,51011,244,1034,1278,398,2321,2719,36763,262135,298898,12/01/2013 12:00:00 AM,151,254,234
Piedmont,Appomattox County,51011,244,992,1236,388,2280,2668,38714,279819,318533,09/01/2012 12:00:00 AM,159,282,258
Piedmont,Appomattox County,51011,244,996,1240,395,2303,2698,40556,279807,320363,07/01/2012 12:00:00 AM,166,281,258
Piedmont,Appomattox County,51011,246,1012,1258,421,2279,2700,44099,287216,331315,06/01/2013 12:00:00 AM,179,284,263
Piedmont,Appomattox County,51011,246,1017,1263,412,2279,2691,38751,253247,291998,04/01/2014 12:00:00 AM,158,249,231
Piedmont,Appomattox County,51011,246,993,1239,427,2246,2673,43363,279760,323123,05/01/2013 12:00:00 AM,176,282,261
Piedmont,Appomattox County,51011,246,997,1243,406,2313,2719,41860,285103,326963,08/01/2012 12:00:00 AM,170,286,263
Piedmont,Appomattox County,51011,248,1029,1277,409,2324,2733,37621,264769,302390,02/01/2014 12:00:00 AM,152,257,237
Piedmont,Appomattox County,51011,249,1037,1286,416,2339,2755,37619,258980,296599,01/01/2014 12:00:00 AM,151,250,231
Piedmont,Appomattox County,51011,251,1005,1256,424,2288,2712,43676,278761,322437,11/01/2012 12:00:00 AM,174,277,257
Piedmont,Appomattox County,51011,255,994,1249,446,2264,2710,46220,280838,327058,12/01/2012 12:00:00 AM,181,283,262
Piedmont,Appomattox County,51011,255,999,1254,443,2256,2699,45949,274913,320862,01/01/2013 12:00:00 AM,180,275,256
Piedmont,Appomattox County,51011,256,1005,1261,452,2235,2687,46911,277021,323932,04/01/2013 12:00:00 AM,183,276,257
Piedmont,Appomattox County,51011,257,998,1255,457,2248,2705,48657,277942,326599,02/01/2013 12:00:00 AM,189,278,260
Piedmont,Appomattox County,51011,258,997,1255,452,2228,2680,47104,275771,322875,03/01/2013 12:00:00 AM,183,277,257
Piedmont,Augusta County,51015,357,1759,2116,452,3960,4412,42050,435358,477408,07/01/2019 12:00:00 AM,118,248,226
Piedmont,Augusta County,51015,362,1770,2132,452,3986,4438,42093,435620,477713,08/01/2019 12:00:00 AM,116,246,224
Piedmont,Augusta County,51015,362,1785,2147,471,4071,4542,44926,442285.83,487211.83,06/01/2019 12:00:00 AM,124,248,227
Piedmont,Augusta County,51015,364,1793,2157,477,4081,4558,45642,448540,494182,05/01/2019 12:00:00 AM,125,250,229
Piedmont,Augusta County,51015,364,1819,2183,467,4143,4610,44423,458223,502646,04/01/2019 12:00:00 AM,122,252,230
Piedmont,Augusta County,51015,365,1734,2099,485,3897,4382,45872,421276,467148,01/01/2020 12:00:00 AM,126,243,223
Piedmont,Augusta County,51015,366,1735,2101,481,3876,4357,46123,423125,469248,11/01/2019 12:00:00 AM,126,244,223
Piedmont,Augusta County,51015,368,1722,2090,484,3836,4320,45976,425526,471502,02/01/2020 12:00:00 AM,125,247,226
Piedmont,Augusta County,51015,370,1774,2144,485,3975,4460,47248,435610,482858,02/01/2019 12:00:00 AM,128,246,225
Piedmont,Augusta County,51015,371,1756,2127,479,3948,4427,44258,432135,476393,09/01/2019 12:00:00 AM,119,246,224
Piedmont,Augusta County,51015,371,1777,2148,480,3985,4465,46231,439057,485288,10/01/2019 12:00:00 AM,125,247,226
Piedmont,Augusta County,51015,372,1755,2127,492,3932,4424,48215,432425,480640,12/01/2019 12:00:00 AM,130,246,226
Piedmont,Augusta County,51015,375,1760,2135,493,3902,4395,90919,670412,761331,03/01/2020 12:00:00 AM,242,381,357
Piedmont,Augusta County,51015,377,1843,2220,500,4185,4685,48488,459426,507914,03/01/2019 12:00:00 AM,129,249,229
Piedmont,Augusta County,51015,378,1921,2299,498,4216,4714,91113,729095,820208,04/01/2020 12:00:00 AM,241,380,357
Piedmont,Augusta County,51015,378,2254,2632,548,5356,5904,51428,604555,655983,02/01/2015 12:00:00 AM,136,268,249
Piedmont,Augusta County,51015,381,2165,2546,546,5150,5696,52272,582175,634447,06/01/2015 12:00:00 AM,137,269,249
Piedmont,Augusta County,51015,381,2189,2570,548,5200,5748,52067,593433,645500,05/01/2015 12:00:00 AM,137,271,251
Piedmont,Augusta County,51015,383,1857,2240,501,4226,4727,50328,487433,537761,01/01/2019 12:00:00 AM,131,262,240
Piedmont,Augusta County,51015,383,2035,2418,539,4799,5338,49666,528722,578388,12/01/2016 12:00:00 AM,130,260,239
Piedmont,Augusta County,51015,383,2107,2490,543,4972,5515,52565,561959,614524,10/01/2015 12:00:00 AM,137,267,247
Piedmont,Augusta County,51015,383,2596,2979,581,5957,6538,59786,722131,781917,10/01/2013 12:00:00 AM,156,278,262
Piedmont,Augusta County,51015,384,1853,2237,505,4215,4720,50516,473580,524096,12/01/2018 12:00:00 AM,132,256,234
Piedmont,Augusta County,51015,384,2157,2541,561,5083,5644,53829,577395,631224,07/01/2015 12:00:00 AM,140,268,248
Piedmont,Augusta County,51015,384,2221,2605,551,5267,5818,53750,599803,653553,04/01/2015 12:00:00 AM,140,270,251
Piedmont,Augusta County,51015,385,2139,2524,545,5037,5582,51930,572235,624165,09/01/2015 12:00:00 AM,135,268,247
Piedmont,Augusta County,51015,386,2057,2443,561,4789,5350,53765,532259,586024,10/01/2016 12:00:00 AM,139,259,240
Piedmont,Augusta County,51015,386,2119,2505,566,4970,5536,55620,551171,606791,12/01/2015 12:00:00 AM,144,260,242
Piedmont,Augusta County,51015,386,2123,2509,567,5014,5581,56790,560222,617012,11/01/2015 12:00:00 AM,147,264,246
Piedmont,Augusta County,51015,386,2152,2538,551,5106,5657,52375,576426,628801,08/01/2015 12:00:00 AM,136,268,248
Piedmont,Augusta County,51015,386,2287,2673,550,5402,5952,52270,608509,660779,01/01/2015 12:00:00 AM,135,266,247
Piedmont,Augusta County,51015,387,1844,2231,514,4234,4748,55318,503913,559231,11/01/2018 12:00:00 AM,143,273,251
Piedmont,Augusta County,51015,387,1983,2370,529,4633,5162,55494,539577,595071,09/01/2017 12:00:00 AM,143,272,251
Piedmont,Augusta County,51015,388,1985,2373,519,4318,4837,97201,745949,843150,05/01/2020 12:00:00 AM,251,376,355
Piedmont,Augusta County,51015,388,2047,2435,525,4772,5297,49580,544235,593815,03/01/2017 12:00:00 AM,128,266,244
Piedmont,Augusta County,51015,388,2049,2437,554,4809,5363,53339,528219,581558,05/01/2016 12:00:00 AM,137,258,239
Piedmont,Augusta County,51015,388,2219,2607,571,5307,5878,55596,600515,656111,03/01/2015 12:00:00 AM,143,271,252
Piedmont,Augusta County,51015,389,1910,2299,523,4410,4933,55140,504197,559337,05/01/2018 12:00:00 AM,142,264,243
Piedmont,Augusta County,51015,389,1987,2376,537,4602,5139,55226,531021,586247,10/01/2017 12:00:00 AM,142,267,247
Piedmont,Augusta County,51015,389,2004,2393,537,4663,5200,52929,532538,585467,04/01/2017 12:00:00 AM,136,266,245
Piedmont,Augusta County,51015,389,2034,2423,563,4773,5336,53161,523988,577149,07/01/2016 12:00:00 AM,137,258,238
Piedmont,Augusta County,51015,389,2635,3024,590,6039,6629,54427,673723,728150,12/01/2013 12:00:00 AM,140,256,241
Piedmont,Augusta County,51015,390,1996,2386,542,4630,5172,56718,528201,584919,11/01/2017 12:00:00 AM,145,265,245
Piedmont,Augusta County,51015,390,2043,2433,561,4833,5394,53036,535913,588949,11/01/2016 12:00:00 AM,136,262,242
Piedmont,Augusta County,51015,390,2328,2718,563,5489,6052,56464,622015,678479,12/01/2014 12:00:00 AM,145,267,250
Piedmont,Augusta County,51015,391,1863,2254,522,4260,4782,53449,483619,537068,07/01/2018 12:00:00 AM,137,260,238
Piedmont,Augusta County,51015,391,2042,2433,541,4807,5348,49526,527437,576963,01/01/2017 12:00:00 AM,127,258,237
Piedmont,Augusta County,51015,392,1919,2311,526,4457,4983,53066,503722,556788,04/01/2018 12:00:00 AM,135,262,241
Piedmont,Augusta County,51015,392,1983,2375,544,4648,5192,54172,527269,581441,07/01/2017 12:00:00 AM,138,266,245
Piedmont,Augusta County,51015,392,2040,2432,563,4803,5366,53166,529413,582579,06/01/2016 12:00:00 AM,136,260,240
Piedmont,Augusta County,51015,392,2111,2503,578,4914,5492,54347,548948,603295,02/01/2016 12:00:00 AM,139,260,241
Piedmont,Augusta County,51015,393,1962,2355,538,4546,5084,52433,514651,567084,01/01/2018 12:00:00 AM,133,262,241
Piedmont,Augusta County,51015,393,1970,2363,555,4582,5137,56533,520708,577241,12/01/2017 12:00:00 AM,144,264,244
Piedmont,Augusta County,51015,393,1991,2384,529,4298,4827,96392,741644,838036,06/01/2020 12:00:00 AM,245,372,352
Piedmont,Augusta County,51015,394,2079,2473,546,4860,5406,51187,545209,596396,02/01/2017 12:00:00 AM,130,262,241
Piedmont,Augusta County,51015,394,2644,3038,597,6056,6653,57126,672479,729605,11/01/2013 12:00:00 AM,145,254,240
Piedmont,Augusta County,51015,395,1861,2256,524,4264,4788,52177,483456,535633,08/01/2018 12:00:00 AM,132,260,237
Piedmont,Augusta County,51015,395,1884,2279,524,4372,4896,53864,494764,548628,06/01/2018 12:00:00 AM,136,263,241
Piedmont,Augusta County,51015,395,2001,2396,549,4676,5225,55578,539088,594666,05/01/2017 12:00:00 AM,141,269,248
Piedmont,Augusta County,51015,395,2050,2445,568,4809,5377,53627,531835,585462,08/01/2016 12:00:00 AM,136,259,239
Piedmont,Augusta County,51015,395,2091,2486,594,4866,5460,58050,534063,592113,03/01/2016 12:00:00 AM,147,255,238
Piedmont,Augusta County,51015,395,2118,2513,513,4563,5076,116049,962621,1078670,02/01/2021 12:00:00 AM,294,454,429
Piedmont,Augusta County,51015,396,1848,2244,531,4249,4780,55113,475884,530997,10/01/2018 12:00:00 AM,139,258,237
Piedmont,Augusta County,51015,396,2039,2435,552,4789,5341,56726,546509,603235,08/01/2017 12:00:00 AM,143,268,248
Piedmont,Augusta County,51015,396,2076,2472,579,4866,5445,54939,533337,588276,04/01/2016 12:00:00 AM,139,257,238
Piedmont,Augusta County,51015,396,2592,2988,628,5992,6620,64926,724813,789739,08/01/2013 12:00:00 AM,164,280,264
Piedmont,Augusta County,51015,396,2618,3014,607,5988,6595,55962,662137,718099,01/01/2014 12:00:00 AM,141,253,238
Piedmont,Augusta County,51015,397,2120,2517,598,4969,5567,57570,551800,609370,01/01/2016 12:00:00 AM,145,260,242
Piedmont,Augusta County,51015,397,2585,2982,616,5960,6576,63157,717262,780419,09/01/2013 12:00:00 AM,159,277,262
Piedmont,Augusta County,51015,398,1960,2358,541,4558,5099,56296,514316,570612,02/01/2018 12:00:00 AM,141,262,242
Piedmont,Augusta County,51015,398,2044,2442,586,4751,5337,57551,526025,583576,09/01/2016 12:00:00 AM,145,257,239
Piedmont,Augusta County,51015,400,1951,2351,538,4514,5052,54098,512469,566567,03/01/2018 12:00:00 AM,135,263,241
Piedmont,Augusta County,51015,400,2587,2987,615,5930,6545,56440,663674,720114,02/01/2014 12:00:00 AM,141,257,241
Piedmont,Augusta County,51015,401,1998,2399,555,4657,5212,58040,537347,595387,06/01/2017 12:00:00 AM,145,269,248
Piedmont,Augusta County,51015,401,2103,2504,532,4468,5000,117199,938011,1055210,03/01/2021 12:00:00 AM,292,446,421
Piedmont,Augusta County,51015,402,1833,2235,551,4216,4767,57178,468351,525529,09/01/2018 12:00:00 AM,142,256,235
Piedmont,Augusta County,51015,402,2069,2471,545,4495,5040,100460,778184,878644,09/01/2020 12:00:00 AM,250,376,356
Piedmont,Augusta County,51015,403,2025,2428,554,4387,4941,103057,758091,861148,07/01/2020 12:00:00 AM,256,374,355
Piedmont,Augusta County,51015,404,2388,2792,610,5674,6284,57748,622574,680322,09/01/2014 12:00:00 AM,143,261,244
Piedmont,Augusta County,51015,405,2045,2450,554,4450,5004,100563,755952,856515,08/01/2020 12:00:00 AM,248,370,350
Piedmont,Augusta County,51015,405,2309,2714,589,5498,6087,58582,622501,681083,11/01/2014 12:00:00 AM,145,270,251
Piedmont,Augusta County,51015,405,2415,2820,605,5717,6322,57216,627653,684869,08/01/2014 12:00:00 AM,141,260,243
Piedmont,Augusta County,51015,405,2507,2912,625,5776,6401,59232,641718,700950,05/01/2014 12:00:00 AM,146,256,241
Piedmont,Augusta County,51015,405,2510,2915,624,5767,6391,58052,630752,688804,06/01/2014 12:00:00 AM,143,251,236
Piedmont,Augusta County,51015,406,2532,2938,673,5953,6626,71152,724619,795771,10/01/2012 12:00:00 AM,175,286,271
Piedmont,Augusta County,51015,407,2456,2863,612,5710,6322,56845,628203,685048,07/01/2014 12:00:00 AM,140,256,239
Piedmont,Augusta County,51015,408,2503,2911,708,5880,6588,76356,719419,795775,08/01/2012 12:00:00 AM,187,287,273
Piedmont,Augusta County,51015,408,2517,2925,676,5889,6565,69898,717674,787572,12/01/2012 12:00:00 AM,171,285,269
Piedmont,Augusta County,51015,408,2557,2965,624,5871,6495,58613,653702,712315,04/01/2014 12:00:00 AM,144,256,240
Piedmont,Augusta County,51015,409,2047,2456,572,4429,5001,111550,805150,916700,10/01/2020 12:00:00 AM,273,393,373
Piedmont,Augusta County,51015,409,2061,2470,564,4441,5005,107702,825896,933598,11/01/2020 12:00:00 AM,263,401,378
Piedmont,Augusta County,51015,410,2597,3007,662,6017,6679,66233,731843,798076,05/01/2013 12:00:00 AM,162,282,265
Piedmont,Augusta County,51015,411,2467,2878,721,5799,6520,80885,710839,791724,06/01/2012 12:00:00 AM,197,288,275
Piedmont,Augusta County,51015,411,2520,2931,697,5938,6635,74946,726340,801286,09/01/2012 12:00:00 AM,182,288,273
Piedmont,Augusta County,51015,412,2329,2741,608,5537,6145,61603,626177,687780,10/01/2014 12:00:00 AM,150,269,251
Piedmont,Augusta County,51015,412,2555,2967,642,5825,6467,58729,651497,710226,03/01/2014 12:00:00 AM,143,255,239
Piedmont,Augusta County,51015,413,2595,3008,671,6019,6690,67604,736887,804491,03/01/2013 12:00:00 AM,164,284,267
Piedmont,Augusta County,51015,414,2583,2997,674,5995,6669,67367,723000,790367,02/01/2013 12:00:00 AM,163,280,264
Piedmont,Augusta County,51015,414,2600,3014,667,6017,6684,67417,726574,793991,07/01/2013 12:00:00 AM,163,279,263
Piedmont,Augusta County,51015,415,2564,2979,678,5971,6649,67831,715051,782882,01/01/2013 12:00:00 AM,163,279,263
Piedmont,Augusta County,51015,416,2466,2882,738,5775,6513,83157,705593,788750,05/01/2012 12:00:00 AM,200,286,274
Piedmont,Augusta County,51015,416,2530,2946,705,5928,6633,73309,725839,799148,11/01/2012 12:00:00 AM,176,287,271
Piedmont,Augusta County,51015,417,2594,3011,682,5994,6676,71145,729449,800594,04/01/2013 12:00:00 AM,171,281,266
Piedmont,Augusta County,51015,418,2022,2440,581,4215,4796,136345,956305,1092650,05/01/2021 12:00:00 AM,326,473,448
Piedmont,Augusta County,51015,419,2077,2496,575,4476,5051,124464,929545,1054009,01/01/2021 12:00:00 AM,297,448,422
Piedmont,Augusta County,51015,419,2454,2873,745,5731,6476,84630,701089,785719,04/01/2012 12:00:00 AM,202,286,273
Piedmont,Augusta County,51015,419,2460,2879,740,5758,6498,84448,728719,813167,07/01/2012 12:00:00 AM,202,296,282
Piedmont,Augusta County,51015,419,2464,2883,730,5766,6496,82661,697711,780372,03/01/2012 12:00:00 AM,197,283,271
Piedmont,Augusta County,51015,422,2015,2437,585,4206,4791,136697,960400,1097097,06/01/2021 12:00:00 AM,324,477,450
Piedmont,Augusta County,51015,422,2050,2472,585,4328,4913,137378,980387,1117765,04/01/2021 12:00:00 AM,326,478,452
Piedmont,Augusta County,51015,425,2594,3019,697,5986,6683,71220,726937,798157,06/01/2013 12:00:00 AM,168,280,264
Piedmont,Augusta County,51015,426,2076,2502,592,4478,5070,114182,821327,935509,12/01/2020 12:00:00 AM,268,396,374
Piedmont,Augusta County,51015,426,2446,2872,741,5745,6486,84180,696679,780859,02/01/2012 12:00:00 AM,198,285,272
Piedmont,Augusta County,51015,426,2452,2878,744,5759,6503,86146,693441,779587,01/01/2012 12:00:00 AM,202,283,271
Piedmont,Bath County,51017,18,107,125,22,239,261,1660,20372,22032,11/01/2017 12:00:00 AM,92,190,176
Piedmont,Bath County,51017,19,109,128,23,251,274,4547,45663,50210,11/01/2020 12:00:00 AM,239,419,392
Piedmont,Bath County,51017,19,111,130,23,255,278,1719,22582,24301,09/01/2017 12:00:00 AM,90,203,187
Piedmont,Bath County,51017,19,115,134,23,262,285,4547,48782,53329,10/01/2020 12:00:00 AM,239,424,398
Piedmont,Bath County,51017,19,118,137,23,282,305,4323,45610,49933,09/01/2020 12:00:00 AM,228,387,364
Piedmont,Bath County,51017,19,119,138,25,268,293,4583,47210,51793,12/01/2020 12:00:00 AM,241,397,375
Piedmont,Bath County,51017,19,120,139,23,269,292,5624,62043,67667,05/01/2021 12:00:00 AM,296,517,487
Piedmont,Bath County,51017,19,122,141,25,272,297,5897,56590,62487,01/01/2021 12:00:00 AM,310,464,443
Piedmont,Bath County,51017,19,126,145,23,285,308,5158,61093,66251,04/01/2021 12:00:00 AM,271,485,457
Piedmont,Bath County,51017,19,129,148,23,286,309,5181,59958,65139,03/01/2021 12:00:00 AM,273,465,440
Piedmont,Bath County,51017,19,130,149,23,284,307,5259,60411,65670,02/01/2021 12:00:00 AM,277,465,441
Piedmont,Bath County,51017,20,105,125,22,230,252,1278,22574,23852,01/01/2019 12:00:00 AM,64,215,191
Piedmont,Bath County,51017,20,106,126,21,241,262,1334,20276,21610,06/01/2017 12:00:00 AM,67,191,172
Piedmont,Bath County,51017,20,106,126,22,242,264,1355,23034,24389,02/01/2019 12:00:00 AM,68,217,194
Piedmont,Bath County,51017,20,107,127,24,240,264,1988,22444,24432,10/01/2017 12:00:00 AM,99,210,192
Piedmont,Bath County,51017,20,108,128,22,240,262,4186,40446,44632,03/01/2020 12:00:00 AM,209,375,349
Piedmont,Bath County,51017,20,109,129,21,241,262,1332,20174,21506,07/01/2017 12:00:00 AM,67,185,167
Piedmont,Bath County,51017,20,111,131,24,258,282,1786,24955,26741,04/01/2018 12:00:00 AM,89,225,204
Piedmont,Bath County,51017,20,112,132,24,261,285,1608,22662,24270,08/01/2017 12:00:00 AM,80,202,184
Piedmont,Bath County,51017,20,120,140,22,281,303,4202,50069,54271,04/01/2020 12:00:00 AM,210,417,388
Piedmont,Bath County,51017,21,100,121,23,222,245,1436,21513,22949,07/01/2018 12:00:00 AM,68,215,190
Piedmont,Bath County,51017,21,102,123,23,227,250,1435,22665,24100,12/01/2018 12:00:00 AM,68,222,196
Piedmont,Bath County,51017,21,107,128,25,252,277,2096,23166,25262,03/01/2018 12:00:00 AM,100,217,197
Piedmont,Bath County,51017,21,110,131,23,250,273,1448,24175,25623,03/01/2019 12:00:00 AM,69,220,196
Piedmont,Bath County,51017,21,112,133,23,271,294,4470,45085,49555,06/01/2020 12:00:00 AM,213,403,373
Piedmont,Bath County,51017,21,116,137,25,275,300,1984,25952,27936,02/01/2018 12:00:00 AM,94,224,204
Piedmont,Bath County,51017,21,117,138,25,278,303,4711,46542,51253,08/01/2020 12:00:00 AM,224,398,371
Piedmont,Bath County,51017,21,97,118,23,214,237,1366,20888,22254,11/01/2018 12:00:00 AM,65,215,189
Piedmont,Bath County,51017,21,99,120,23,229,252,1449,21810,23259,06/01/2018 12:00:00 AM,69,220,194
Piedmont,Bath County,51017,22,103,125,24,225,249,1493,23564,25057,10/01/2018 12:00:00 AM,68,229,200
Piedmont,Bath County,51017,22,103,125,27,238,265,1840,21721,23561,05/01/2018 12:00:00 AM,84,211,188
Piedmont,Bath County,51017,22,105,127,24,253,277,1579,25674,27253,10/01/2019 12:00:00 AM,72,245,215
Piedmont,Bath County,51017,22,106,128,23,257,280,1558,25951,27509,08/01/2019 12:00:00 AM,71,245,215
Piedmont,Bath County,51017,22,112,134,23,269,292,1558,26179,27737,06/01/2019 12:00:00 AM,71,234,207
Piedmont,Bath County,51017,22,115,137,23,263,286,1486,24383,25869,04/01/2019 12:00:00 AM,68,212,189
Piedmont,Bath County,51017,22,116,138,26,276,302,5321,47370,52691,07/01/2020 12:00:00 AM,242,408,382
Piedmont,Bath County,51017,22,118,140,24,275,299,4516,47500,52016,05/01/2020 12:00:00 AM,205,403,372
Piedmont,Bath County,51017,22,96,118,24,209,233,1564,21633,23197,09/01/2018 12:00:00 AM,71,225,197
Piedmont,Bath County,51017,22,97,119,24,231,255,1335,23594,24929,01/01/2020 12:00:00 AM,61,243,209
Piedmont,Bath County,51017,22,99,121,24,217,241,1433,21202,22635,08/01/2018 12:00:00 AM,65,214,187
Piedmont,Bath County,51017,22,99,121,24,235,259,1351,24690,26041,02/01/2020 12:00:00 AM,61,249,215
Piedmont,Bath County,51017,22,99,121,24,236,260,1463,24390,25853,11/01/2019 12:00:00 AM,67,246,214
Piedmont,Bath County,51017,23,105,128,25,244,269,1583,26129,27712,09/01/2019 12:00:00 AM,69,249,217
Piedmont,Bath County,51017,23,107,130,25,258,283,1782,26172,27954,07/01/2019 12:00:00 AM,77,245,215
Piedmont,Bath County,51017,23,108,131,24,245,269,1411,21793,23204,05/01/2017 12:00:00 AM,61,202,177
Piedmont,Bath County,51017,23,110,133,27,261,288,2265,24933,27198,12/01/2017 12:00:00 AM,98,227,204
Piedmont,Bath County,51017,23,110,133,27,266,293,2114,23037,25151,01/01/2018 12:00:00 AM,92,209,189
Piedmont,Bath County,51017,23,112,135,24,263,287,1573,25449,27022,05/01/2019 12:00:00 AM,68,227,200
Piedmont,Bath County,51017,23,115,138,34,254,288,7801,55858,63659,06/01/2021 12:00:00 AM,339,486,461
Piedmont,Bath County,51017,23,129,152,24,300,324,1104,29696,30800,10/01/2016 12:00:00 AM,48,230,203
Piedmont,Bath County,51017,23,138,161,24,329,353,1092,30877,31969,08/01/2016 12:00:00 AM,47,224,199
Piedmont,Bath County,51017,23,98,121,25,229,254,1743,23518,25261,12/01/2019 12:00:00 AM,76,240,209
Piedmont,Bath County,51017,24,112,136,25,256,281,1461,24874,26335,04/01/2017 12:00:00 AM,61,222,194
Piedmont,Bath County,51017,24,118,142,25,265,290,1437,26221,27658,03/01/2017 12:00:00 AM,60,222,195
Piedmont,Bath County,51017,24,130,154,29,309,338,1763,28650,30413,07/01/2016 12:00:00 AM,73,220,197
Piedmont,Bath County,51017,24,132,156,25,312,337,1179,29439,30618,09/01/2016 12:00:00 AM,49,223,196
Piedmont,Bath County,51017,25,134,159,28,315,343,1523,29789,31312,06/01/2016 12:00:00 AM,61,222,197
Piedmont,Bath County,51017,25,140,165,28,340,368,1308,33055,34363,03/01/2016 12:00:00 AM,52,236,208
Piedmont,Bath County,51017,25,145,170,29,358,387,1378,34908,36286,01/01/2016 12:00:00 AM,55,241,213
Piedmont,Bath County,51017,26,122,148,27,268,295,1582,27740,29322,02/01/2017 12:00:00 AM,61,227,198
Piedmont,Bath County,51017,26,122,148,27,271,298,1582,27373,28955,01/01/2017 12:00:00 AM,61,224,196
Piedmont,Bath County,51017,26,125,151,27,274,301,1664,26611,28275,11/01/2016 12:00:00 AM,64,213,187
Piedmont,Bath County,51017,26,132,158,29,323,352,1621,30539,32160,05/01/2016 12:00:00 AM,62,231,204
Piedmont,Bath County,51017,26,138,164,29,329,358,1621,32068,33689,04/01/2016 12:00:00 AM,62,232,205
Piedmont,Bath County,51017,26,141,167,29,347,376,1504,33682,35186,12/01/2015 12:00:00 AM,58,239,211
Piedmont,Bath County,51017,26,146,172,30,360,390,1572,35289,36861,02/01/2016 12:00:00 AM,60,242,214
Piedmont,Bath County,51017,27,125,152,28,271,299,1696,26908,28604,12/01/2016 12:00:00 AM,63,215,188
Piedmont,Bath County,51017,28,141,169,31,341,372,1851,32323,34174,11/01/2015 12:00:00 AM,66,229,202
Piedmont,Bath County,51017,28,154,182,31,374,405,1868,36541,38409,09/01/2015 12:00:00 AM,67,237,211
Piedmont,Bath County,51017,28,157,185,31,372,403,1934,37368,39302,08/01/2015 12:00:00 AM,69,238,212
Piedmont,Bath County,51017,29,146,175,33,350,383,1819,33129,34948,10/01/2015 12:00:00 AM,63,227,200
Piedmont,Bath County,51017,29,159,188,34,379,413,1890,38264,40154,04/01/2015 12:00:00 AM,65,241,214
Piedmont,Bath County,51017,29,163,192,34,389,423,1899,38951,40850,03/01/2015 12:00:00 AM,65,239,213
Piedmont,Bath County,51017,29,166,195,34,391,425,1859,37244,39103,01/01/2015 12:00:00 AM,64,224,201
Piedmont,Bath County,51017,29,167,196,34,396,430,1922,39092,41014,02/01/2015 12:00:00 AM,66,234,209
Piedmont,Bath County,51017,30,155,185,35,355,390,2005,35162,37167,12/01/2014 12:00:00 AM,67,227,201
Piedmont,Bath County,51017,30,155,185,38,376,414,2274,33989,36263,02/01/2014 12:00:00 AM,76,219,196
Piedmont,Bath County,51017,30,157,187,36,381,417,2247,36523,38770,05/01/2015 12:00:00 AM,75,233,207
Piedmont,Bath County,51017,30,169,199,38,417,455,2278,37593,39871,01/01/2014 12:00:00 AM,76,222,200
Piedmont,Bath County,51017,31,148,179,36,345,381,2099,33449,35548,11/01/2014 12:00:00 AM,68,226,199
Piedmont,Bath County,51017,31,162,193,36,388,424,2494,38554,41048,06/01/2015 12:00:00 AM,80,238,213
Piedmont,Bath County,51017,31,174,205,42,420,462,2953,39696,42649,12/01/2013 12:00:00 AM,95,228,208
Piedmont,Bath County,51017,31,175,206,44,426,470,3377,38261,41638,11/01/2013 12:00:00 AM,109,219,202
Piedmont,Bath County,51017,31,179,210,40,444,484,3071,44334,47405,10/01/2013 12:00:00 AM,99,248,226
Piedmont,Bath County,51017,31,185,216,38,464,502,2836,47660,50496,08/01/2013 12:00:00 AM,91,258,234
Piedmont,Bath County,51017,32,130,162,39,305,344,2263,29773,32036,07/01/2014 12:00:00 AM,71,229,198
Piedmont,Bath County,51017,32,137,169,39,317,356,2305,29947,32252,08/01/2014 12:00:00 AM,72,219,191
Piedmont,Bath County,51017,32,137,169,39,334,373,2262,31901,34163,06/01/2014 12:00:00 AM,71,233,202
Piedmont,Bath County,51017,32,141,173,39,337,376,2263,31589,33852,05/01/2014 12:00:00 AM,71,224,196
Piedmont,Bath County,51017,32,148,180,39,348,387,2593,32610,35203,04/01/2014 12:00:00 AM,81,220,196
Piedmont,Bath County,51017,32,150,182,40,359,399,2381,33300,35681,03/01/2014 12:00:00 AM,74,222,196
Piedmont,Bath County,51017,32,159,191,37,379,416,2450,37331,39781,07/01/2015 12:00:00 AM,77,235,208
Piedmont,Bath County,51017,32,183,215,42,455,497,3197,45596,48793,09/01/2013 12:00:00 AM,100,249,227
Piedmont,Bath County,51017,34,143,177,41,340,381,2417,31905,34322,09/01/2014 12:00:00 AM,71,223,194
Piedmont,Bath County,51017,34,149,183,41,345,386,2756,33440,36196,10/01/2014 12:00:00 AM,81,224,198
Piedmont,Bath County,51017,35,177,212,40,446,486,2296,48508,50804,05/01/2013 12:00:00 AM,66,274,240
Piedmont,Bath County,51017,35,181,216,44,452,496,2919,47358,50277,06/01/2013 12:00:00 AM,83,262,233
Piedmont,Bath County,51017,37,171,208,44,419,463,2725,46919,49644,04/01/2013 12:00:00 AM,74,274,239
Piedmont,Bath County,51017,37,179,216,50,445,495,3775,45886,49661,07/01/2013 12:00:00 AM,102,256,230
Piedmont,Bath County,51017,38,167,205,45,407,452,2795,44673,47468,03/01/2013 12:00:00 AM,74,268,232
Piedmont,Bath County,51017,39,170,209,46,413,459,2743,45004,47747,01/01/2013 12:00:00 AM,70,265,228
Piedmont,Bath County,51017,39,170,209,46,418,464,2791,45110,47901,02/01/2013 12:00:00 AM,72,265,229
Piedmont,Bath County,51017,41,167,208,49,393,442,3062,42113,45175,12/01/2012 12:00:00 AM,75,252,217
Piedmont,Bath County,51017,41,168,209,51,396,447,3512,43106,46618,10/01/2012 12:00:00 AM,86,257,223
Piedmont,Bath County,51017,41,171,212,53,403,456,3735,43387,47122,11/01/2012 12:00:00 AM,91,254,222
Piedmont,Bath County,51017,41,172,213,50,399,449,3883,48998,52881,07/01/2012 12:00:00 AM,95,285,248
Piedmont,Bath County,51017,42,163,205,50,373,423,3388,41114,44502,09/01/2012 12:00:00 AM,81,252,217
Piedmont,Bath County,51017,42,167,209,59,395,454,4336,42380,46716,05/01/2012 12:00:00 AM,103,254,224
Piedmont,Bath County,51017,42,169,211,51,393,444,3732,43144,46876,08/01/2012 12:00:00 AM,89,255,222
Piedmont,Bath County,51017,42,169,211,58,393,451,4554,43293,47847,04/01/2012 12:00:00 AM,108,256,227
Piedmont,Bath County,51017,43,162,205,60,380,440,4336,40609,44945,02/01/2012 12:00:00 AM,101,251,219
Piedmont,Bath County,51017,43,168,211,60,392,452,4547,41900,46447,06/01/2012 12:00:00 AM,106,249,220
Piedmont,Bath County,51017,44,159,203,62,381,443,4727,38242,42969,01/01/2012 12:00:00 AM,107,241,212
Piedmont,Bath County,51017,45,163,208,66,386,452,5425,41049,46474,03/01/2012 12:00:00 AM,121,252,223
Piedmont,Bedford City,51515,0,1,1,0,1,1,0,189,189,02/01/2014 12:00:00 AM,,189,189
Piedmont,Bedford City,51515,1,0,1,1,0,1,153,0,153,04/01/2014 12:00:00 AM,153,,153
Piedmont,Bedford City,51515,1,0,1,2,0,2,347,0,347,12/01/2013 12:00:00 AM,347,,347
Piedmont,Bedford City,51515,107,445,552,166,986,1152,17206,120941,138147,10/01/2013 12:00:00 AM,161,272,250
Piedmont,Bedford City,51515,107,450,557,168,999,1167,17653,122380,140033,04/01/2012 12:00:00 AM,165,272,251
Piedmont,Bedford City,51515,107,475,582,161,1047,1208,16549,131455,148004,08/01/2013 12:00:00 AM,155,277,254
Piedmont,Bedford City,51515,109,462,571,166,1016,1182,16623,125480,142103,09/01/2013 12:00:00 AM,153,272,249
Piedmont,Bedford City,51515,110,466,576,168,1035,1203,18390,126336,144726,11/01/2012 12:00:00 AM,167,271,251
Piedmont,Bedford City,51515,111,454,565,180,1007,1187,18355,122694,141049,05/01/2012 12:00:00 AM,165,270,250
Piedmont,Bedford City,51515,111,469,580,168,1035,1203,18108,127849,145957,10/01/2012 12:00:00 AM,163,273,252
Piedmont,Bedford City,51515,112,453,565,173,993,1166,19104,124000,143104,03/01/2013 12:00:00 AM,171,274,253
Piedmont,Bedford City,51515,112,460,572,170,1007,1177,17550,122168,139718,01/01/2013 12:00:00 AM,157,266,244
Piedmont,Bedford City,51515,112,465,577,177,1004,1181,19244,125362,144606,05/01/2013 12:00:00 AM,172,270,251
Piedmont,Bedford City,51515,112,469,581,175,1025,1200,18655,127553,146208,09/01/2012 12:00:00 AM,167,272,252
Piedmont,Bedford City,51515,113,458,571,173,1002,1175,18377,124417,142794,12/01/2012 12:00:00 AM,163,272,250
Piedmont,Bedford City,51515,113,460,573,187,1021,1208,20465,121876,142341,03/01/2012 12:00:00 AM,181,265,248
Piedmont,Bedford City,51515,113,464,577,176,1023,1199,18046,130572,148618,07/01/2013 12:00:00 AM,160,281,258
Piedmont,Bedford City,51515,114,454,568,178,985,1163,19729,122207,141936,04/01/2013 12:00:00 AM,173,269,250
Piedmont,Bedford City,51515,114,461,575,190,1020,1210,20758,123383,144141,02/01/2012 12:00:00 AM,182,268,251
Piedmont,Bedford City,51515,115,452,567,179,988,1167,19502,122769,142271,02/01/2013 12:00:00 AM,170,272,251
Piedmont,Bedford City,51515,116,456,572,186,985,1171,19499,123604,143103,06/01/2013 12:00:00 AM,168,271,250
Piedmont,Bedford City,51515,118,455,573,188,1011,1199,19776,123370,143146,07/01/2012 12:00:00 AM,168,271,250
Piedmont,Bedford City,51515,118,473,591,199,1035,1234,21486,125573,147059,01/01/2012 12:00:00 AM,182,265,249
Piedmont,Bedford City,51515,119,464,583,189,1015,1204,19578,125619,145197,08/01/2012 12:00:00 AM,165,271,249
Piedmont,Bedford City,51515,120,458,578,196,1024,1220,19372,125376,144748,06/01/2012 12:00:00 AM,161,274,250
Piedmont,Bedford City,51515,47,141,188,91,374,465,9911,42596,52507,11/01/2013 12:00:00 AM,211,302,279
Piedmont,Bedford County,51019,379,2202,2581,560,5249,5809,60252,640527,700779,07/01/2012 12:00:00 AM,159,291,272
Piedmont,Bedford County,51019,381,2234,2615,591,5297,5888,65888,643464,709352,10/01/2012 12:00:00 AM,173,288,271
Piedmont,Bedford County,51019,384,2212,2596,573,5258,5831,62540,641783,704323,08/01/2012 12:00:00 AM,163,290,271
Piedmont,Bedford County,51019,384,2217,2601,584,5236,5820,64384,637955,702339,09/01/2012 12:00:00 AM,168,288,270
Piedmont,Bedford County,51019,387,2210,2597,583,5256,5839,62938,632832,695770,06/01/2012 12:00:00 AM,163,286,268
Piedmont,Bedford County,51019,388,2206,2594,601,5243,5844,66094,633368,699462,05/01/2012 12:00:00 AM,170,287,270
Piedmont,Bedford County,51019,390,2201,2591,607,5234,5841,68769,631525,700294,03/01/2012 12:00:00 AM,176,287,270
Piedmont,Bedford County,51019,391,2191,2582,615,5222,5837,69937,627858,697795,02/01/2012 12:00:00 AM,179,287,270
Piedmont,Bedford County,51019,391,2207,2598,603,5257,5860,66599,636962,703561,04/01/2012 12:00:00 AM,170,289,271
Piedmont,Bedford County,51019,398,2237,2635,633,5281,5914,71047,629589,700636,01/01/2013 12:00:00 AM,179,281,266
Piedmont,Bedford County,51019,398,2241,2639,637,5257,5894,71603,640899,712502,02/01/2013 12:00:00 AM,180,286,270
Piedmont,Bedford County,51019,399,2202,2601,643,5184,5827,72145,626727,698872,12/01/2012 12:00:00 AM,181,285,269
Piedmont,Bedford County,51019,400,2224,2624,647,5214,5861,73768,633681,707449,11/01/2012 12:00:00 AM,184,285,270
Piedmont,Bedford County,51019,403,2173,2576,648,5169,5817,73646,620045,693691,01/01/2012 12:00:00 AM,183,285,269
Piedmont,Bedford County,51019,407,2240,2647,668,5209,5877,76517,633181,709698,03/01/2013 12:00:00 AM,188,283,268
Piedmont,Bedford County,51019,412,2249,2661,679,5229,5908,77762,638067,715829,04/01/2013 12:00:00 AM,189,284,269
Piedmont,Bedford County,51019,413,2242,2655,650,5244,5894,75197,635571,710768,07/01/2013 12:00:00 AM,182,283,268
Piedmont,Bedford County,51019,414,2225,2639,645,5213,5858,73258,625949,699207,08/01/2013 12:00:00 AM,177,281,265
Piedmont,Bedford County,51019,415,2243,2658,673,5261,5934,76872,645181,722053,06/01/2013 12:00:00 AM,185,288,272
Piedmont,Bedford County,51019,415,2251,2666,671,5247,5918,78063,640769,718832,05/01/2013 12:00:00 AM,188,285,270
Piedmont,Bedford County,51019,416,2192,2608,656,5157,5813,76169,616768,692937,09/01/2013 12:00:00 AM,183,281,266
Piedmont,Bedford County,51019,416,2238,2654,652,5234,5886,74809,622844,697653,10/01/2013 12:00:00 AM,180,278,263
Piedmont,Bedford County,51019,420,1857,2277,524,4259,4783,44525,472464,516989,02/01/2019 12:00:00 AM,106,254,227
Piedmont,Bedford County,51019,424,1960,2384,525,4481,5006,45420,503294,548714,04/01/2019 12:00:00 AM,107,257,230
Piedmont,Bedford County,51019,425,2075,2500,527,4965,5492,49756,569812,619568,02/01/2017 12:00:00 AM,117,275,248
Piedmont,Bedford County,51019,426,1967,2393,537,4538,5075,47916,532410,580326,01/01/2019 12:00:00 AM,112,271,243
Piedmont,Bedford County,51019,428,1906,2334,545,4317,4862,49578,481010,530588,02/01/2020 12:00:00 AM,116,252,227
Piedmont,Bedford County,51019,430,1929,2359,527,4406,4933,46409,486836,533245,05/01/2019 12:00:00 AM,108,252,226
Piedmont,Bedford County,51019,432,1948,2380,537,4524,5061,45253,511574,556827,03/01/2019 12:00:00 AM,105,263,234
Piedmont,Bedford County,51019,433,1887,2320,550,4247,4797,49909,475513,525422,11/01/2019 12:00:00 AM,115,252,226
Piedmont,Bedford County,51019,433,1934,2367,521,4430,4951,45264,495382,540646,06/01/2019 12:00:00 AM,105,256,228
Piedmont,Bedford County,51019,434,1941,2375,553,4388,4941,102606,753290,855896,03/01/2020 12:00:00 AM,236,388,360
Piedmont,Bedford County,51019,435,2170,2605,525,4829,5354,120320,1024875.95,1145195.95,02/01/2021 12:00:00 AM,277,472,440
Piedmont,Bedford County,51019,436,1909,2345,528,4314,4842,45446,477228,522674,07/01/2019 12:00:00 AM,104,250,223
Piedmont,Bedford County,51019,437,1901,2338,534,4304,4838,46641,484995,531636,08/01/2019 12:00:00 AM,107,255,227
Piedmont,Bedford County,51019,437,1901,2338,557,4312,4869,49487,483500,532987,01/01/2020 12:00:00 AM,113,254,228
Piedmont,Bedford County,51019,437,1990,2427,550,4575,5125,52710,515681,568391,10/01/2018 12:00:00 AM,121,259,234
Piedmont,Bedford County,51019,438,1902,2340,551,4265,4816,48955,477138,526093,09/01/2019 12:00:00 AM,112,251,225
Piedmont,Bedford County,51019,439,2007,2446,552,4765,5317,48042,539568,587610,03/01/2018 12:00:00 AM,109,269,240
Piedmont,Bedford County,51019,440,2022,2462,556,4897,5453,50501,557768,608269,08/01/2017 12:00:00 AM,115,276,247
Piedmont,Bedford County,51019,440,2040,2480,553,4787,5340,48264,539616,587880,06/01/2018 12:00:00 AM,110,265,237
Piedmont,Bedford County,51019,441,2011,2452,559,4749,5308,51104,535995,587099,05/01/2018 12:00:00 AM,116,267,239
Piedmont,Bedford County,51019,442,1912,2354,567,4364,4931,51786,488988,540774,12/01/2019 12:00:00 AM,117,256,230
Piedmont,Bedford County,51019,442,2141,2583,562,4699,5261,113130,866906,980036,11/01/2020 12:00:00 AM,256,405,379
Piedmont,Bedford County,51019,443,1884,2327,562,4240,4802,50910,484220,535130,10/01/2019 12:00:00 AM,115,257,230
Piedmont,Bedford County,51019,443,1996,2439,553,4610,5163,50293,520550,570843,12/01/2018 12:00:00 AM,114,261,234
Piedmont,Bedford County,51019,443,2010,2453,553,4642,5195,50979,518591,569570,11/01/2018 12:00:00 AM,115,258,232
Piedmont,Bedford County,51019,443,2018,2461,548,4723,5271,48445,531892,580337,08/01/2018 12:00:00 AM,109,264,236
Piedmont,Bedford County,51019,443,2065,2508,563,4633,5196,105009,799245,904254,04/01/2020 12:00:00 AM,237,387,361
Piedmont,Bedford County,51019,444,2005,2449,552,4663,5215,50449,526902,577351,09/01/2018 12:00:00 AM,114,263,236
Piedmont,Bedford County,51019,444,2018,2462,560,4770,5330,49633,541222,590855,04/01/2018 12:00:00 AM,112,268,240
Piedmont,Bedford County,51019,444,2021,2465,553,4838,5391,47217,536171,583388,01/01/2018 12:00:00 AM,106,265,237
Piedmont,Bedford County,51019,444,2152,2596,548,4761,5309,123900,999592,1123492,03/01/2021 12:00:00 AM,279,464,433
Piedmont,Bedford County,51019,444,2153,2597,544,4777,5321,129847,1072369,1202216,04/01/2021 12:00:00 AM,292,498,463
Piedmont,Bedford County,51019,445,2015,2460,551,4742,5293,49034,536052,585086,07/01/2018 12:00:00 AM,110,266,238
Piedmont,Bedford County,51019,445,2133,2578,576,4766,5342,107174,819777,926951,06/01/2020 12:00:00 AM,241,384,360
Piedmont,Bedford County,51019,446,2134,2580,568,4705,5273,126510,976706,1103216,01/01/2021 12:00:00 AM,284,458,428
Piedmont,Bedford County,51019,447,2108,2555,573,4717,5290,107424,814401,921825,05/01/2020 12:00:00 AM,240,386,361
Piedmont,Bedford County,51019,448,2019,2467,568,4806,5374,49792,542796,592588,02/01/2018 12:00:00 AM,111,269,240
Piedmont,Bedford County,51019,448,2140,2588,573,4725,5298,111991,872553,984544,12/01/2020 12:00:00 AM,250,408,380
Piedmont,Bedford County,51019,448,2177,2625,580,4863,5443,107945,832031,939976,07/01/2020 12:00:00 AM,241,382,358
Piedmont,Bedford County,51019,449,2004,2453,571,4860,5431,54793,551954,606747,07/01/2017 12:00:00 AM,122,275,247
Piedmont,Bedford County,51019,449,2170,2619,571,4767,5338,109459,868037,977496,10/01/2020 12:00:00 AM,244,400,373
Piedmont,Bedford County,51019,450,2061,2511,550,4965,5515,50908,559919,610827,03/01/2017 12:00:00 AM,113,272,243
Piedmont,Bedford County,51019,450,2204,2654,581,4872,5453,107327,853356,960683,08/01/2020 12:00:00 AM,239,387,362
Piedmont,Bedford County,51019,451,2000,2451,570,4832,5402,51761,541631,593392,09/01/2017 12:00:00 AM,115,271,242
Piedmont,Bedford County,51019,451,2014,2465,567,4862,5429,51513,553559,605072,05/01/2017 12:00:00 AM,114,275,245
Piedmont,Bedford County,51019,451,2025,2476,567,4870,5437,53656,541436,595092,12/01/2017 12:00:00 AM,119,267,240
Piedmont,Bedford County,51019,451,2183,2634,579,4829,5408,108155,824878,933033,09/01/2020 12:00:00 AM,240,378,354
Piedmont,Bedford County,51019,452,2035,2487,567,4942,5509,53058,569833.01,622891.01,06/01/2017 12:00:00 AM,117,280,250
Piedmont,Bedford County,51019,452,2132,2584,579,4709,5288,140369,1065150,1205519,05/01/2021 12:00:00 AM,311,500,467
Piedmont,Bedford County,51019,454,2087,2541,566,5046,5612,51383,571736,623119,01/01/2017 12:00:00 AM,113,274,245
Piedmont,Bedford County,51019,455,2014,2469,570,4880,5450,54249,561837,616086,04/01/2017 12:00:00 AM,119,279,250
Piedmont,Bedford County,51019,458,2004,2462,584,4834,5418,53931,543990,597921,10/01/2017 12:00:00 AM,118,271,243
Piedmont,Bedford County,51019,461,2139,2600,596,4743,5339,139719,1067218,1206937,06/01/2021 12:00:00 AM,303,499,464
Piedmont,Bedford County,51019,462,2084,2546,600,5044,5644,55582,567468,623050,12/01/2016 12:00:00 AM,120,272,245
Piedmont,Bedford County,51019,464,2012,2476,594,4856,5450,56946,535294,592240,11/01/2017 12:00:00 AM,123,266,239
Piedmont,Bedford County,51019,466,2082,2548,621,5030,5651,58924,565734,624658,11/01/2016 12:00:00 AM,126,272,245
Piedmont,Bedford County,51019,470,2094,2564,617,5103,5720,58602,566771,625373,10/01/2016 12:00:00 AM,125,271,244
Piedmont,Bedford County,51019,473,2528,3001,709,5821,6530,73398,644860,718258,11/01/2013 12:00:00 AM,155,255,239
Piedmont,Bedford County,51019,477,2112,2589,647,5149,5796,62971,571183,634154,07/01/2016 12:00:00 AM,132,270,245
Piedmont,Bedford County,51019,477,2163,2640,647,5272,5919,65259,596725,661984,06/01/2016 12:00:00 AM,137,276,251
Piedmont,Bedford County,51019,482,2212,2694,674,5313,5987,67576,587183,654759,12/01/2015 12:00:00 AM,140,265,243
Piedmont,Bedford County,51019,482,2263,2745,684,5466,6150,67245,614642,681887,05/01/2015 12:00:00 AM,140,272,248
Piedmont,Bedford County,51019,483,2092,2575,651,5076,5727,63137,564222,627359,09/01/2016 12:00:00 AM,131,270,244
Piedmont,Bedford County,51019,484,2091,2575,664,5074,5738,64841,561809,626650,08/01/2016 12:00:00 AM,134,269,243
Piedmont,Bedford County,51019,485,2199,2684,666,5382,6048,67187,612809,679996,05/01/2016 12:00:00 AM,139,279,253
Piedmont,Bedford County,51019,486,2216,2702,674,5299,5973,66412,590707,657119,02/01/2016 12:00:00 AM,137,267,243
Piedmont,Bedford County,51019,486,2221,2707,684,5338,6022,68099,585912,654011,11/01/2015 12:00:00 AM,140,264,242
Piedmont,Bedford County,51019,486,2265,2751,699,5443,6142,68745,606644,675389,06/01/2015 12:00:00 AM,141,268,246
Piedmont,Bedford County,51019,488,2194,2682,678,5269,5947,67777,573520,641297,01/01/2016 12:00:00 AM,139,261,239
Piedmont,Bedford County,51019,488,2196,2684,689,5328,6017,69285,594621,663906,04/01/2016 12:00:00 AM,142,271,247
Piedmont,Bedford County,51019,489,2224,2713,691,5360,6051,69295,596172,665467,03/01/2016 12:00:00 AM,142,268,245
Piedmont,Bedford County,51019,489,2250,2739,695,5417,6112,68627,601979,670606,07/01/2015 12:00:00 AM,140,268,245
Piedmont,Bedford County,51019,489,2270,2759,707,5477,6184,68936,614048,682984,04/01/2015 12:00:00 AM,141,271,248
Piedmont,Bedford County,51019,490,2246,2736,676,5414,6090,64772,596646,661418,09/01/2015 12:00:00 AM,132,266,242
Piedmont,Bedford County,51019,490,2252,2742,698,5446,6144,66920,602907,669827,08/01/2015 12:00:00 AM,137,268,244
Piedmont,Bedford County,51019,495,2297,2792,713,5538,6251,70432,618165,688597,03/01/2015 12:00:00 AM,142,269,247
Piedmont,Bedford County,51019,497,2202,2699,685,5306,5991,65894,582194,648088,10/01/2015 12:00:00 AM,133,264,240
Piedmont,Bedford County,51019,505,2302,2807,722,5588,6310,69653,625829,695482,02/01/2015 12:00:00 AM,138,272,248
Piedmont,Bedford County,51019,514,2367,2881,751,5729,6480,74292,640544,714836,11/01/2014 12:00:00 AM,145,271,248
Piedmont,Bedford County,51019,514,2535,3049,787,5920,6707,75810,645315,721125,06/01/2014 12:00:00 AM,147,255,237
Piedmont,Bedford County,51019,514,2556,3070,782,5953,6735,76904,656034,732938,05/01/2014 12:00:00 AM,150,257,239
Piedmont,Bedford County,51019,514,2596,3110,774,6036,6810,76808,663682,740490,04/01/2014 12:00:00 AM,149,256,238
Piedmont,Bedford County,51019,517,2396,2913,767,5797,6564,75388,644216,719604,10/01/2014 12:00:00 AM,146,269,247
Piedmont,Bedford County,51019,518,2340,2858,753,5693,6446,74051,631047,705098,12/01/2014 12:00:00 AM,143,270,247
Piedmont,Bedford County,51019,519,2310,2829,750,5622,6372,72707,614121,686828,01/01/2015 12:00:00 AM,140,266,243
Piedmont,Bedford County,51019,519,2469,2988,779,5930,6709,74246,634638,708884,09/01/2014 12:00:00 AM,143,257,237
Piedmont,Bedford County,51019,519,2499,3018,779,5939,6718,74553,641380,715933,08/01/2014 12:00:00 AM,144,257,237
Piedmont,Bedford County,51019,519,2588,3107,796,5982,6778,79933,664320,744253,03/01/2014 12:00:00 AM,154,257,240
Piedmont,Bedford County,51019,520,2587,3107,800,5998,6798,81946,664787,746733,02/01/2014 12:00:00 AM,158,257,240
Piedmont,Bedford County,51019,521,2514,3035,790,5914,6704,77230,637551,714781,07/01/2014 12:00:00 AM,148,254,236
Piedmont,Bedford County,51019,524,2646,3170,809,6147,6956,83348,674854,758202,12/01/2013 12:00:00 AM,159,255,239
Piedmont,Bedford County,51019,525,2630,3155,806,6099,6905,80576,670574,751150,01/01/2014 12:00:00 AM,153,255,238
Piedmont,Botetourt County,51023,100,570,670,126,1370,1496,11634,149806,161440,11/01/2017 12:00:00 AM,116,263,241
Piedmont,Botetourt County,51023,100,598,698,120,1490,1610,10009,169370,179379,06/01/2017 12:00:00 AM,100,283,257
Piedmont,Botetourt County,51023,101,547,648,134,1316,1450,12455,146850,159305,11/01/2018 12:00:00 AM,123,268,246
Piedmont,Botetourt County,51023,101,559,660,134,1329,1463,12661,145667,158328,10/01/2018 12:00:00 AM,125,261,240
Piedmont,Botetourt County,51023,101,569,670,127,1369,1496,11326,151350,162676,12/01/2017 12:00:00 AM,112,266,243
Piedmont,Botetourt County,51023,101,673,774,132,1678,1810,12279,189438,201717,07/01/2016 12:00:00 AM,122,281,261
Piedmont,Botetourt County,51023,102,528,630,130,1228,1358,10839,134049,144888,01/01/2020 12:00:00 AM,106,254,230
Piedmont,Botetourt County,51023,102,535,637,122,1244,1366,10406,133606,144012,11/01/2019 12:00:00 AM,102,250,226
Piedmont,Botetourt County,51023,102,535,637,124,1259,1383,10401,134865,145266,12/01/2019 12:00:00 AM,102,252,228
Piedmont,Botetourt County,51023,102,552,654,123,1344,1467,9395,157553,166948,01/01/2019 12:00:00 AM,92,285,255
Piedmont,Botetourt County,51023,102,555,657,122,1304,1426,10093,142015,152108,09/01/2019 12:00:00 AM,99,256,232
Piedmont,Botetourt County,51023,102,572,674,124,1417,1541,10953,157921,168874,10/01/2017 12:00:00 AM,107,276,251
Piedmont,Botetourt County,51023,102,628,730,119,1340,1459,27629,302440,330069,06/01/2021 12:00:00 AM,271,482,452
Piedmont,Botetourt County,51023,102,661,763,142,1647,1789,15079,179928,195007,06/01/2016 12:00:00 AM,148,272,256
Piedmont,Botetourt County,51023,103,600,703,133,1373,1506,24313,235458,259771,06/01/2020 12:00:00 AM,236,392,370
Piedmont,Botetourt County,51023,103,625,728,120,1337,1457,28240,304901,333141,05/01/2021 12:00:00 AM,274,488,458
Piedmont,Botetourt County,51023,103,633,736,117,1349,1466,26942,286467,313409,02/01/2021 12:00:00 AM,262,453,426
Piedmont,Botetourt County,51023,103,653,756,145,1619,1764,13784,179110,192894,05/01/2016 12:00:00 AM,134,274,255
Piedmont,Botetourt County,51023,104,537,641,124,1232,1356,10692,133977,144669,10/01/2019 12:00:00 AM,103,249,226
Piedmont,Botetourt County,51023,104,619,723,122,1341,1463,28055,299571,327626,04/01/2021 12:00:00 AM,270,484,453
Piedmont,Botetourt County,51023,104,620,724,134,1424,1558,25218,240380,265598,07/01/2020 12:00:00 AM,242,388,367
Piedmont,Botetourt County,51023,104,626,730,118,1345,1463,27048,279878,306926,03/01/2021 12:00:00 AM,260,447,420
Piedmont,Botetourt County,51023,104,702,806,125,1681,1806,11423,185255,196678,07/01/2015 12:00:00 AM,110,264,244
Piedmont,Botetourt County,51023,104,726,830,124,1728,1852,10855,192994,203849,08/01/2015 12:00:00 AM,104,266,246
Piedmont,Botetourt County,51023,105,586,691,127,1449,1576,10941,163472,174413,08/01/2017 12:00:00 AM,104,279,252
Piedmont,Botetourt County,51023,105,592,697,136,1370,1506,25323,232506,257829,05/01/2020 12:00:00 AM,241,393,370
Piedmont,Botetourt County,51023,106,506,612,133,1238,1371,10458,135399,145857,02/01/2019 12:00:00 AM,99,268,238
Piedmont,Botetourt County,51023,106,514,620,139,1194,1333,12143,130261,142404,02/01/2020 12:00:00 AM,115,253,230
Piedmont,Botetourt County,51023,106,520,626,141,1238,1379,25921,207890,233811,03/01/2020 12:00:00 AM,245,400,374
Piedmont,Botetourt County,51023,106,535,641,138,1312,1450,12217,144878,157095,12/01/2018 12:00:00 AM,115,271,245
Piedmont,Botetourt County,51023,106,575,681,137,1344,1481,25151,229999,255150,04/01/2020 12:00:00 AM,237,400,375
Piedmont,Botetourt County,51023,106,625,731,126,1343,1469,28285,280547,308832,01/01/2021 12:00:00 AM,267,449,422
Piedmont,Botetourt County,51023,106,639,745,126,1395,1521,25094,250796,275890,12/01/2020 12:00:00 AM,237,392,370
Piedmont,Botetourt County,51023,106,672,778,153,1648,1801,15046,180805,195851,04/01/2016 12:00:00 AM,142,269,252
Piedmont,Botetourt County,51023,106,704,810,136,1648,1784,11643,179104,190747,04/01/2014 12:00:00 AM,110,254,235
Piedmont,Botetourt County,51023,106,727,833,126,1745,1871,10315,190937,201252,09/01/2015 12:00:00 AM,97,263,242
Piedmont,Botetourt County,51023,107,541,648,129,1292,1421,10217,134352,144569,07/01/2019 12:00:00 AM,95,248,223
Piedmont,Botetourt County,51023,107,616,723,136,1407,1543,24909,240004,264913,08/01/2020 12:00:00 AM,233,390,366
Piedmont,Botetourt County,51023,107,687,794,141,1623,1764,12156,178423,190579,06/01/2014 12:00:00 AM,114,260,240
Piedmont,Botetourt County,51023,107,690,797,133,1637,1770,11875,177420,189295,05/01/2014 12:00:00 AM,111,257,238
Piedmont,Botetourt County,51023,107,704,811,133,1687,1820,12809,188891,201700,06/01/2015 12:00:00 AM,120,268,249
Piedmont,Botetourt County,51023,107,705,812,135,1717,1852,13320,187485,200805,01/01/2016 12:00:00 AM,124,266,247
Piedmont,Botetourt County,51023,108,545,653,136,1293,1429,11622,135733,147355,08/01/2019 12:00:00 AM,108,249,226
Piedmont,Botetourt County,51023,108,592,700,129,1463,1592,10819,164089,174908,09/01/2017 12:00:00 AM,100,277,250
Piedmont,Botetourt County,51023,108,678,786,151,1658,1809,14648,184160,198808,03/01/2016 12:00:00 AM,136,272,253
Piedmont,Botetourt County,51023,108,680,788,148,1623,1771,12763,176844,189607,07/01/2014 12:00:00 AM,118,260,241
Piedmont,Botetourt County,51023,109,722,831,137,1760,1897,12410,193097,205507,10/01/2015 12:00:00 AM,114,267,247
Piedmont,Botetourt County,51023,110,529,639,141,1307,1448,11966,140102,152068,05/01/2019 12:00:00 AM,109,265,238
Piedmont,Botetourt County,51023,110,535,645,140,1304,1444,11714,136204,147918,03/01/2019 12:00:00 AM,106,255,229
Piedmont,Botetourt County,51023,110,540,650,138,1307,1445,11066,139482,150548,06/01/2019 12:00:00 AM,101,258,232
Piedmont,Botetourt County,51023,110,618,728,144,1419,1563,26022,241468,267490,09/01/2020 12:00:00 AM,237,391,367
Piedmont,Botetourt County,51023,110,633,743,133,1377,1510,26379,252342,278721,11/01/2020 12:00:00 AM,240,399,375
Piedmont,Botetourt County,51023,110,685,795,153,1680,1833,15615,185630,201245,02/01/2016 12:00:00 AM,142,271,253
Piedmont,Botetourt County,51023,110,692,802,140,1661,1801,13927,183460,197387,05/01/2015 12:00:00 AM,127,265,246
Piedmont,Botetourt County,51023,110,714,824,140,1744,1884,12876,194969,207845,12/01/2015 12:00:00 AM,117,273,252
Piedmont,Botetourt County,51023,111,673,784,153,1615,1768,14734,175907,190641,08/01/2014 12:00:00 AM,133,261,243
Piedmont,Botetourt County,51023,111,683,794,142,1631,1773,14396,185790,200186,04/01/2015 12:00:00 AM,130,272,252
Piedmont,Botetourt County,51023,111,701,812,145,1710,1855,14692,200852,215544,11/01/2014 12:00:00 AM,132,287,265
Piedmont,Botetourt County,51023,112,532,644,142,1300,1442,12324,135340,147664,04/01/2019 12:00:00 AM,110,254,229
Piedmont,Botetourt County,51023,112,686,798,153,1639,1792,15233,179204,194437,09/01/2014 12:00:00 AM,136,261,244
Piedmont,Botetourt County,51023,112,688,800,146,1654,1800,15001,190650,205651,02/01/2015 12:00:00 AM,134,277,257
Piedmont,Botetourt County,51023,112,696,808,142,1678,1820,13935,194537,208472,12/01/2014 12:00:00 AM,124,280,258
Piedmont,Botetourt County,51023,112,702,814,144,1689,1833,14507,191766,206273,01/01/2015 12:00:00 AM,130,273,253
Piedmont,Botetourt County,51023,112,715,827,144,1669,1813,12253,179634,191887,03/01/2014 12:00:00 AM,109,251,232
Piedmont,Botetourt County,51023,113,679,792,147,1616,1763,14719,184044,198763,03/01/2015 12:00:00 AM,130,271,251
Piedmont,Botetourt County,51023,113,713,826,147,1746,1893,14614,191338,205952,11/01/2015 12:00:00 AM,129,268,249
Piedmont,Botetourt County,51023,114,629,743,143,1397,1540,28356,255484,283840,10/01/2020 12:00:00 AM,249,406,382
Piedmont,Botetourt County,51023,115,714,829,152,1720,1872,16213,199828,216041,10/01/2014 12:00:00 AM,141,280,261
Piedmont,Botetourt County,51023,115,734,849,153,1688,1841,13581,182411,195992,02/01/2014 12:00:00 AM,118,249,231
Piedmont,Botetourt County,51023,117,665,782,164,1487,1651,16044,172551,188595,05/01/2012 12:00:00 AM,137,259,241
Piedmont,Botetourt County,51023,118,660,778,164,1474,1638,16272,170939,187211,04/01/2012 12:00:00 AM,138,259,241
Piedmont,Botetourt County,51023,119,667,786,162,1504,1666,16462,175029,191491,03/01/2012 12:00:00 AM,138,262,244
Piedmont,Botetourt County,51023,119,692,811,151,1591,1742,14593,182900,197493,05/01/2013 12:00:00 AM,123,264,244
Piedmont,Botetourt County,51023,119,699,818,154,1595,1749,14772,183060,197832,04/01/2013 12:00:00 AM,124,262,242
Piedmont,Botetourt County,51023,119,733,852,162,1667,1829,14423,178042,192465,12/01/2013 12:00:00 AM,121,243,226
Piedmont,Botetourt County,51023,120,669,789,161,1525,1686,16765,176710,193475,01/01/2012 12:00:00 AM,140,264,245
Piedmont,Botetourt County,51023,120,677,797,169,1521,1690,16750,174392,191142,06/01/2012 12:00:00 AM,140,258,240
Piedmont,Botetourt County,51023,121,732,853,162,1679,1841,14202,175850,190052,01/01/2014 12:00:00 AM,117,240,223
Piedmont,Botetourt County,51023,122,735,857,161,1666,1827,14046,179036,193082,11/01/2013 12:00:00 AM,115,244,225
Piedmont,Botetourt County,51023,123,661,784,165,1499,1664,16899,175740,192639,02/01/2012 12:00:00 AM,137,266,246
Piedmont,Botetourt County,51023,123,664,787,177,1491,1668,18352,171738,190090,07/01/2012 12:00:00 AM,149,259,242
Piedmont,Botetourt County,51023,124,745,869,163,1675,1838,16662,196838,213500,10/01/2013 12:00:00 AM,134,264,246
Piedmont,Botetourt County,51023,126,663,789,179,1488,1667,18259,168711,186970,09/01/2012 12:00:00 AM,145,254,237
Piedmont,Botetourt County,51023,126,695,821,171,1577,1748,17688,180293,197981,03/01/2013 12:00:00 AM,140,259,241
Piedmont,Botetourt County,51023,127,658,785,181,1495,1676,18686,169489,188175,10/01/2012 12:00:00 AM,147,258,240
Piedmont,Botetourt County,51023,127,666,793,181,1495,1676,17580,173109,190689,11/01/2012 12:00:00 AM,138,260,240
Piedmont,Botetourt County,51023,127,692,819,163,1580,1743,16101,180017,196118,06/01/2013 12:00:00 AM,127,260,239
Piedmont,Botetourt County,51023,127,714,841,168,1614,1782,16096,183538,199634,07/01/2013 12:00:00 AM,127,257,237
Piedmont,Botetourt County,51023,129,657,786,185,1469,1654,17973,167536,185509,12/01/2012 12:00:00 AM,139,255,236
Piedmont,Botetourt County,51023,129,659,788,185,1487,1672,19805,167101,186906,08/01/2012 12:00:00 AM,154,254,237
Piedmont,Botetourt County,51023,129,668,797,177,1528,1705,18742,174931,193673,02/01/2013 12:00:00 AM,145,262,243
Piedmont,Botetourt County,51023,130,659,789,183,1481,1664,19354,166451,185805,01/01/2013 12:00:00 AM,149,253,235
Piedmont,Botetourt County,51023,131,725,856,178,1631,1809,17961,192192,210153,09/01/2013 12:00:00 AM,137,265,246
Piedmont,Botetourt County,51023,131,729,860,173,1645,1818,17242,192900,210142,08/01/2013 12:00:00 AM,132,265,244
Piedmont,Botetourt County,51023,88,566,654,113,1341,1454,9802,145152,154954,05/01/2018 12:00:00 AM,111,256,237
Piedmont,Botetourt County,51023,91,609,700,108,1489,1597,9306,168190,177496,04/01/2017 12:00:00 AM,102,276,254
Piedmont,Botetourt County,51023,91,663,754,111,1639,1750,9702,185470,195172,10/01/2016 12:00:00 AM,107,280,259
Piedmont,Botetourt County,51023,92,623,715,115,1518,1633,9906,172957,182863,03/01/2017 12:00:00 AM,108,278,256
Piedmont,Botetourt County,51023,93,650,743,115,1623,1738,10573,183258,193831,11/01/2016 12:00:00 AM,114,282,261
Piedmont,Botetourt County,51023,94,583,677,120,1364,1484,9860,150425,160285,02/01/2018 12:00:00 AM,105,258,237
Piedmont,Botetourt County,51023,95,573,668,121,1352,1473,9858,147420,157278,03/01/2018 12:00:00 AM,104,257,235
Piedmont,Botetourt County,51023,95,580,675,130,1374,1504,12288,147785,160073,06/01/2018 12:00:00 AM,129,255,237
Piedmont,Botetourt County,51023,95,648,743,116,1606,1722,10461,182725,193186,12/01/2016 12:00:00 AM,110,282,260
Piedmont,Botetourt County,51023,95,669,764,124,1668,1792,11607,188579,200186,09/01/2016 12:00:00 AM,122,282,262
Piedmont,Botetourt County,51023,96,580,676,124,1373,1497,11013,149251,160264,04/01/2018 12:00:00 AM,115,257,237
Piedmont,Botetourt County,51023,96,634,730,116,1566,1682,10055,172005,182060,01/01/2017 12:00:00 AM,105,271,249
Piedmont,Botetourt County,51023,97,557,654,137,1335,1472,12919,143969,156888,07/01/2018 12:00:00 AM,133,258,240
Piedmont,Botetourt County,51023,97,571,668,123,1356,1479,10791,146945,157736,01/01/2018 12:00:00 AM,111,257,236
Piedmont,Botetourt County,51023,97,639,736,121,1577,1698,11039,176587,187626,02/01/2017 12:00:00 AM,114,276,255
Piedmont,Botetourt County,51023,97,674,771,124,1686,1810,11446,188688,200134,08/01/2016 12:00:00 AM,118,280,260
Piedmont,Botetourt County,51023,98,555,653,131,1320,1451,12171,142474,154645,09/01/2018 12:00:00 AM,124,257,237
Piedmont,Botetourt County,51023,98,584,682,115,1451,1566,9809,164719,174528,07/01/2017 12:00:00 AM,100,282,256
Piedmont,Botetourt County,51023,98,605,703,119,1498,1617,10331,171441,181772,05/01/2017 12:00:00 AM,105,283,259
Piedmont,Botetourt County,51023,99,558,657,137,1338,1475,13265,144019,157284,08/01/2018 12:00:00 AM,134,258,239
Piedmont,Buena Vista City,51530,100,384,484,135,922,1057,11902,106607,118509,04/01/2012 12:00:00 AM,119,278,245
Piedmont,Buena Vista City,51530,100,393,493,137,950,1087,12166,111581,123747,07/01/2012 12:00:00 AM,122,284,251
Piedmont,Buena Vista City,51530,100,420,520,134,1063,1197,13099,127250,140349,06/01/2013 12:00:00 AM,131,303,270
Piedmont,Buena Vista City,51530,78,275,353,97,614,711,6293,66954,73247,02/01/2020 12:00:00 AM,81,243,207
Piedmont,Buena Vista City,51530,79,278,357,97,603,700,17867,103820,121687,03/01/2020 12:00:00 AM,226,373,341
Piedmont,Buena Vista City,51530,79,278,357,98,633,731,6563,70165,76728,12/01/2019 12:00:00 AM,83,252,215
Piedmont,Buena Vista City,51530,79,282,361,100,645,745,6898,70487,77385,11/01/2019 12:00:00 AM,87,250,214
Piedmont,Buena Vista City,51530,79,283,362,98,633,731,6394,67120,73514,01/01/2020 12:00:00 AM,81,237,203
Piedmont,Buena Vista City,51530,79,302,381,97,668,765,18403,116235,134638,04/01/2020 12:00:00 AM,233,385,353
Piedmont,Buena Vista City,51530,80,304,384,99,656,755,18460,115339,133799,05/01/2020 12:00:00 AM,231,379,348
Piedmont,Buena Vista City,51530,81,278,359,105,622,727,7419,69631,77050,10/01/2019 12:00:00 AM,92,250,215
Piedmont,Buena Vista City,51530,82,301,383,112,677,789,8397,76658,85055,07/01/2019 12:00:00 AM,102,255,222
Piedmont,Buena Vista City,51530,82,307,389,98,670,768,18313,115100,133413,06/01/2020 12:00:00 AM,223,375,343
Piedmont,Buena Vista City,51530,82,311,393,105,736,841,8780,81763,90543,02/01/2019 12:00:00 AM,107,263,230
Piedmont,Buena Vista City,51530,82,313,395,114,727,841,9751,83323,93074,04/01/2019 12:00:00 AM,119,266,236
Piedmont,Buena Vista City,51530,82,318,400,100,692,792,19726,124610,144336,10/01/2020 12:00:00 AM,241,392,361
Piedmont,Buena Vista City,51530,82,318,400,106,753,859,8756,84280,93036,03/01/2019 12:00:00 AM,107,265,233
Piedmont,Buena Vista City,51530,82,322,404,98,690,788,19047,119890,138937,07/01/2020 12:00:00 AM,232,372,344
Piedmont,Buena Vista City,51530,82,323,405,98,723,821,21895,154224,176119,02/01/2021 12:00:00 AM,267,477,435
Piedmont,Buena Vista City,51530,83,282,365,115,645,760,8747,74201,82948,08/01/2019 12:00:00 AM,105,263,227
Piedmont,Buena Vista City,51530,83,302,385,113,686,799,9172,76612,85784,06/01/2019 12:00:00 AM,111,254,223
Piedmont,Buena Vista City,51530,83,305,388,113,696,809,9368,77900,87268,05/01/2019 12:00:00 AM,113,255,225
Piedmont,Buena Vista City,51530,83,314,397,103,756,859,8722,83734,92456,12/01/2018 12:00:00 AM,105,267,233
Piedmont,Buena Vista City,51530,83,324,407,104,786,890,8582,91468,100050,01/01/2019 12:00:00 AM,103,282,246
Piedmont,Buena Vista City,51530,83,329,412,102,725,827,23375,161592,184967,04/01/2021 12:00:00 AM,282,491,449
Piedmont,Buena Vista City,51530,84,284,368,111,646,757,7842,74688,82530,09/01/2019 12:00:00 AM,93,263,224
Piedmont,Buena Vista City,51530,84,319,403,106,703,809,24223,156981,181204,06/01/2021 12:00:00 AM,288,492,450
Piedmont,Buena Vista City,51530,84,325,409,101,712,813,18851,124943,143794,08/01/2020 12:00:00 AM,224,384,352
Piedmont,Buena Vista City,51530,84,327,411,102,724,826,19500,126659,146159,09/01/2020 12:00:00 AM,232,387,356
Piedmont,Buena Vista City,51530,84,349,433,104,851,955,8516,97762,106278,09/01/2016 12:00:00 AM,101,280,245
Piedmont,Buena Vista City,51530,84,363,447,108,912,1020,8336,101904,110240,04/01/2015 12:00:00 AM,99,281,247
Piedmont,Buena Vista City,51530,85,311,396,111,675,786,24837,138809,163646,01/01/2021 12:00:00 AM,292,446,413
Piedmont,Buena Vista City,51530,85,314,399,105,685,790,20392,127801,148193,11/01/2020 12:00:00 AM,240,407,371
Piedmont,Buena Vista City,51530,85,317,402,109,692,801,20833,125232,146065,12/01/2020 12:00:00 AM,245,395,363
Piedmont,Buena Vista City,51530,85,335,420,104,743,847,23709,158763,182472,03/01/2021 12:00:00 AM,279,474,434
Piedmont,Buena Vista City,51530,85,348,433,99,852,951,7655,102656,110311,04/01/2016 12:00:00 AM,90,295,255
Piedmont,Buena Vista City,51530,85,364,449,107,891,998,8590,98376,106966,05/01/2015 12:00:00 AM,101,270,238
Piedmont,Buena Vista City,51530,86,304,390,103,715,818,8693,81869,90562,07/01/2017 12:00:00 AM,101,269,232
Piedmont,Buena Vista City,51530,86,321,407,106,710,816,25363,157929,183292,05/01/2021 12:00:00 AM,295,492,450
Piedmont,Buena Vista City,51530,86,337,423,109,797,906,10025,89443,99468,01/01/2017 12:00:00 AM,117,265,235
Piedmont,Buena Vista City,51530,86,347,433,108,827,935,9517,96272,105789,10/01/2016 12:00:00 AM,111,277,244
Piedmont,Buena Vista City,51530,86,349,435,100,859,959,7317,101181,108498,06/01/2016 12:00:00 AM,85,290,249
Piedmont,Buena Vista City,51530,86,351,437,105,850,955,8234,95308,103542,10/01/2015 12:00:00 AM,96,272,237
Piedmont,Buena Vista City,51530,86,364,450,113,907,1020,9292,101510,110802,03/01/2015 12:00:00 AM,108,279,246
Piedmont,Buena Vista City,51530,87,311,398,104,725,829,8675,82245,90920,07/01/2018 12:00:00 AM,100,264,228
Piedmont,Buena Vista City,51530,87,315,402,105,740,845,8584,84006,92590,10/01/2018 12:00:00 AM,99,267,230
Piedmont,Buena Vista City,51530,87,351,438,110,850,960,8497,100125,108622,08/01/2016 12:00:00 AM,98,285,248
Piedmont,Buena Vista City,51530,87,353,440,100,863,963,7480,101077,108557,05/01/2016 12:00:00 AM,86,286,247
Piedmont,Buena Vista City,51530,87,359,446,117,906,1023,9453,99416,108869,02/01/2015 12:00:00 AM,109,277,244
Piedmont,Buena Vista City,51530,87,369,456,119,934,1053,9565,100341,109906,01/01/2015 12:00:00 AM,110,272,241
Piedmont,Buena Vista City,51530,88,299,387,105,710,815,8873,79664,88537,06/01/2018 12:00:00 AM,101,266,229
Piedmont,Buena Vista City,51530,88,309,397,113,738,851,10086,83216,93302,11/01/2018 12:00:00 AM,115,269,235
Piedmont,Buena Vista City,51530,88,312,400,110,736,846,9244,82963,92207,08/01/2017 12:00:00 AM,105,266,231
Piedmont,Buena Vista City,51530,88,313,401,102,738,840,8499,83141,91640,05/01/2018 12:00:00 AM,97,266,229
Piedmont,Buena Vista City,51530,88,339,427,112,814,926,9828,93342,103170,11/01/2016 12:00:00 AM,112,275,242
Piedmont,Buena Vista City,51530,88,353,441,111,854,965,9100,93783,102883,09/01/2015 12:00:00 AM,103,266,233
Piedmont,Buena Vista City,51530,88,354,442,102,854,956,8110,103488,111598,03/01/2016 12:00:00 AM,92,292,252
Piedmont,Buena Vista City,51530,89,306,395,109,727,836,8829,79892,88721,04/01/2018 12:00:00 AM,99,261,225
Piedmont,Buena Vista City,51530,89,317,406,109,743,852,9770,85884,95654,06/01/2017 12:00:00 AM,110,271,236
Piedmont,Buena Vista City,51530,89,341,430,110,810,920,9809,90941,100750,02/01/2017 12:00:00 AM,110,267,234
Piedmont,Buena Vista City,51530,89,347,436,111,855,966,8633,98320,106953,07/01/2016 12:00:00 AM,97,283,245
Piedmont,Buena Vista City,51530,89,352,441,105,854,959,8280,98629,106909,01/01/2016 12:00:00 AM,93,280,242
Piedmont,Buena Vista City,51530,89,366,455,119,897,1016,8842,101018,109860,06/01/2015 12:00:00 AM,99,276,241
Piedmont,Buena Vista City,51530,89,379,468,123,947,1070,10881,103336,114217,12/01/2014 12:00:00 AM,122,273,244
Piedmont,Buena Vista City,51530,89,388,477,126,967,1093,11816,105879,117695,11/01/2014 12:00:00 AM,133,273,247
Piedmont,Buena Vista City,51530,90,336,426,111,791,902,9407,88783,98190,04/01/2017 12:00:00 AM,105,264,230
Piedmont,Buena Vista City,51530,90,359,449,115,876,991,8944,95899,104843,08/01/2015 12:00:00 AM,99,267,234
Piedmont,Buena Vista City,51530,90,360,450,116,881,997,8853,97675,106528,07/01/2015 12:00:00 AM,98,271,237
Piedmont,Buena Vista City,51530,90,398,488,124,978,1102,11155,106982,118137,10/01/2014 12:00:00 AM,124,269,242
Piedmont,Buena Vista City,51530,91,307,398,111,727,838,9411,82600,92011,08/01/2018 12:00:00 AM,103,269,231
Piedmont,Buena Vista City,51530,91,310,401,112,743,855,9145,81416,90561,03/01/2018 12:00:00 AM,100,263,226
Piedmont,Buena Vista City,51530,91,321,412,112,748,860,9943,86416,96359,05/01/2017 12:00:00 AM,109,269,234
Piedmont,Buena Vista City,51530,91,327,418,120,774,894,11135,87174,98309,12/01/2016 12:00:00 AM,122,267,235
Piedmont,Buena Vista City,51530,91,355,446,111,860,971,8875,103771,112646,02/01/2016 12:00:00 AM,98,292,253
Piedmont,Buena Vista City,51530,91,393,484,126,976,1102,10249,103468,113717,09/01/2014 12:00:00 AM,113,263,235
Piedmont,Buena Vista City,51530,92,307,399,115,732,847,9305,79917,89222,02/01/2018 12:00:00 AM,101,260,224
Piedmont,Buena Vista City,51530,92,309,401,116,730,846,9333,83557,92890,09/01/2017 12:00:00 AM,101,270,232
Piedmont,Buena Vista City,51530,92,326,418,113,765,878,9589,82599,92188,03/01/2017 12:00:00 AM,104,253,221
Piedmont,Buena Vista City,51530,92,348,440,116,844,960,9581,94322,103903,11/01/2015 12:00:00 AM,104,271,236
Piedmont,Buena Vista City,51530,93,304,397,112,721,833,9009,79596,88605,09/01/2018 12:00:00 AM,97,262,223
Piedmont,Buena Vista City,51530,93,307,400,116,733,849,10428,80858,91286,11/01/2017 12:00:00 AM,112,263,228
Piedmont,Buena Vista City,51530,93,312,405,116,745,861,9411,83766,93177,10/01/2017 12:00:00 AM,101,268,230
Piedmont,Buena Vista City,51530,93,347,440,115,835,950,9340,96217,105557,12/01/2015 12:00:00 AM,100,277,240
Piedmont,Buena Vista City,51530,93,378,471,126,892,1018,11375,100735,112110,01/01/2012 12:00:00 AM,122,266,238
Piedmont,Buena Vista City,51530,93,396,489,131,979,1110,10845,105528,116373,08/01/2014 12:00:00 AM,117,266,238
Piedmont,Buena Vista City,51530,93,409,502,129,1013,1142,11069,108470,119539,05/01/2014 12:00:00 AM,119,265,238
Piedmont,Buena Vista City,51530,93,411,504,120,1009,1129,9813,119972,129785,01/01/2013 12:00:00 AM,106,292,258
Piedmont,Buena Vista City,51530,94,391,485,131,977,1108,10599,104363,114962,07/01/2014 12:00:00 AM,113,267,237
Piedmont,Buena Vista City,51530,95,306,401,122,715,837,9900,79168,89068,01/01/2018 12:00:00 AM,104,259,222
Piedmont,Buena Vista City,51530,95,310,405,121,747,868,10572,81682,92254,12/01/2017 12:00:00 AM,111,263,228
Piedmont,Buena Vista City,51530,95,394,489,125,969,1094,10719,116297,127016,10/01/2012 12:00:00 AM,113,295,260
Piedmont,Buena Vista City,51530,95,403,498,135,1001,1136,12240,105013,117253,06/01/2014 12:00:00 AM,129,261,235
Piedmont,Buena Vista City,51530,95,420,515,130,1041,1171,10770,113326,124096,04/01/2014 12:00:00 AM,113,270,241
Piedmont,Buena Vista City,51530,95,429,524,132,1052,1184,11130,113644,124774,03/01/2014 12:00:00 AM,117,265,238
Piedmont,Buena Vista City,51530,96,393,489,127,970,1097,10692,117007,127699,09/01/2012 12:00:00 AM,111,298,261
Piedmont,Buena Vista City,51530,96,399,495,126,988,1114,10425,118239,128664,11/01/2012 12:00:00 AM,109,296,260
Piedmont,Buena Vista City,51530,96,401,497,126,982,1108,10773,118711,129484,12/01/2012 12:00:00 AM,112,296,261
Piedmont,Buena Vista City,51530,96,423,519,124,1060,1184,10885,128503,139388,03/01/2013 12:00:00 AM,113,304,269
Piedmont,Buena Vista City,51530,96,424,520,128,1046,1174,12603,120828,133431,10/01/2013 12:00:00 AM,131,285,257
Piedmont,Buena Vista City,51530,96,427,523,127,1061,1188,11933,123560,135493,09/01/2013 12:00:00 AM,124,289,259
Piedmont,Buena Vista City,51530,96,432,528,129,1067,1196,11099,114514,125613,11/01/2013 12:00:00 AM,116,265,238
Piedmont,Buena Vista City,51530,97,389,486,127,938,1065,10833,109913,120746,05/01/2012 12:00:00 AM,112,283,248
Piedmont,Buena Vista City,51530,97,412,509,124,1021,1145,10859,123476,134335,02/01/2013 12:00:00 AM,112,300,264
Piedmont,Buena Vista City,51530,97,418,515,132,1054,1186,12428,126813,139241,04/01/2013 12:00:00 AM,128,303,270
Piedmont,Buena Vista City,51530,97,427,524,136,1036,1172,11552,114164,125716,02/01/2014 12:00:00 AM,119,267,240
Piedmont,Buena Vista City,51530,97,427,524,137,1036,1173,12177,111984,124161,01/01/2014 12:00:00 AM,126,262,237
Piedmont,Buena Vista City,51530,97,431,528,125,1086,1211,11586,129224,140810,08/01/2013 12:00:00 AM,119,300,267
Piedmont,Buena Vista City,51530,98,378,476,139,890,1029,13037,103645,116682,02/01/2012 12:00:00 AM,133,274,245
Piedmont,Buena Vista City,51530,98,382,480,134,906,1040,12020,106257,118277,03/01/2012 12:00:00 AM,123,278,246
Piedmont,Buena Vista City,51530,98,424,522,135,1047,1182,11697,113231,124928,12/01/2013 12:00:00 AM,119,267,239
Piedmont,Buena Vista City,51530,99,393,492,135,961,1096,11843,112577,124420,08/01/2012 12:00:00 AM,120,286,253
Piedmont,Buena Vista City,51530,99,398,497,134,951,1085,12006,111713,123719,06/01/2012 12:00:00 AM,121,281,249
Piedmont,Buena Vista City,51530,99,424,523,130,1074,1204,12523,130560,143083,07/01/2013 12:00:00 AM,126,308,274
Piedmont,Buena Vista City,51530,99,425,524,133,1075,1208,12833,130476,143309,05/01/2013 12:00:00 AM,130,307,273
Piedmont,Campbell County,51031,493,2141,2634,690,4747,5437,64412,531009,595421,02/01/2019 12:00:00 AM,131,248,226
Piedmont,Campbell County,51031,494,2205,2699,656,4988,5644,60691,555365,616056,02/01/2020 12:00:00 AM,123,252,228
Piedmont,Campbell County,51031,498,2267,2765,691,5071,5762,62832,567174,630006,05/01/2019 12:00:00 AM,126,250,228
Piedmont,Campbell County,51031,498,2276,2774,669,5158,5827,62244,567738,629982,11/01/2019 12:00:00 AM,125,249,227
Piedmont,Campbell County,51031,499,2251,2750,675,5092,5767,64637,563778,628415,01/01/2020 12:00:00 AM,130,250,229
Piedmont,Campbell County,51031,499,2271,2770,679,5180,5859,65719,572809,638528,10/01/2019 12:00:00 AM,132,252,231
Piedmont,Campbell County,51031,502,2272,2774,687,5139,5826,66072,572946,639018,12/01/2019 12:00:00 AM,132,252,230
Piedmont,Campbell County,51031,504,2261,2765,669,5089,5758,123927,872120,996047,03/01/2020 12:00:00 AM,246,386,360
Piedmont,Campbell County,51031,505,2254,2759,702,4991,5693,65879,555025,620904,03/01/2019 12:00:00 AM,130,246,225
Piedmont,Campbell County,51031,506,2259,2765,705,5056,5761,67496,561411,628907,04/01/2019 12:00:00 AM,133,249,227
Piedmont,Campbell County,51031,508,2257,2765,682,5105,5787,65960,562727,628687,09/01/2019 12:00:00 AM,130,249,227
Piedmont,Campbell County,51031,509,2277,2786,702,5097,5799,66929,570027,636956,06/01/2019 12:00:00 AM,131,250,229
Piedmont,Campbell County,51031,511,2244,2755,710,5050,5760,67521,559593,627114,08/01/2019 12:00:00 AM,132,249,228
Piedmont,Campbell County,51031,511,2412,2923,680,5396,6076,128148,933653,1061801,04/01/2020 12:00:00 AM,251,387,363
Piedmont,Campbell County,51031,511,2466,2977,686,5522,6208,126691,954350,1081041,05/01/2020 12:00:00 AM,248,387,363
Piedmont,Campbell County,51031,515,2258,2773,720,5043,5763,69462,592519,661981,01/01/2019 12:00:00 AM,135,262,239
Piedmont,Campbell County,51031,516,2259,2775,708,5029,5737,65549,564998,630547,07/01/2019 12:00:00 AM,127,250,227
Piedmont,Campbell County,51031,519,2522,3041,690,5628,6318,127886,962835,1090721,06/01/2020 12:00:00 AM,246,382,359
Piedmont,Campbell County,51031,520,2321,2841,725,5240,5965,69998,600769,670767,11/01/2018 12:00:00 AM,135,259,236
Piedmont,Campbell County,51031,524,2304,2828,722,5200,5922,75123,594190.82,669313.82,10/01/2018 12:00:00 AM,143,258,237
Piedmont,Campbell County,51031,527,2591,3118,691,5737,6428,158335,1216097,1374432,02/01/2021 12:00:00 AM,300,469,441
Piedmont,Campbell County,51031,528,2546,3074,708,5570,6278,166586,1256991,1423577,05/01/2021 12:00:00 AM,316,494,463
Piedmont,Campbell County,51031,530,2589,3119,706,5732,6438,157445,1194899.18,1352344.18,03/01/2021 12:00:00 AM,297,462,434
Piedmont,Campbell County,51031,531,2292,2823,753,5151,5904,74779,583549,658328,12/01/2018 12:00:00 AM,141,255,233
Piedmont,Campbell County,51031,533,2360,2893,744,5351,6095,74164,597523,671687,07/01/2018 12:00:00 AM,139,253,232
Piedmont,Campbell County,51031,533,2570,3103,716,5639,6355,167561,1268438,1435999,04/01/2021 12:00:00 AM,314,494,463
Piedmont,Campbell County,51031,533,2571,3104,712,5748,6460,130629,987252,1117881,07/01/2020 12:00:00 AM,245,384,360
Piedmont,Campbell County,51031,536,2581,3117,717,5751,6468,131475,988985,1120460,09/01/2020 12:00:00 AM,245,383,359
Piedmont,Campbell County,51031,538,2382,2920,766,5426,6192,76956,611578,688534,06/01/2018 12:00:00 AM,143,257,236
Piedmont,Campbell County,51031,538,2390,2928,760,5427,6187,75360,615091,690451,08/01/2018 12:00:00 AM,140,257,236
Piedmont,Campbell County,51031,538,2550,3088,729,5590,6319,171407,1260378,1431785,06/01/2021 12:00:00 AM,319,494,464
Piedmont,Campbell County,51031,540,2349,2889,751,5292,6043,75965,596792,672757,09/01/2018 12:00:00 AM,141,254,233
Piedmont,Campbell County,51031,540,2582,3122,731,5776,6507,143148,1056322,1199470,10/01/2020 12:00:00 AM,265,409,384
Piedmont,Campbell County,51031,541,2385,2926,768,5456,6224,74903,613590,688493,04/01/2018 12:00:00 AM,138,257,235
Piedmont,Campbell County,51031,541,2399,2940,766,5483,6249,75875,625553,701428,05/01/2018 12:00:00 AM,140,261,239
Piedmont,Campbell County,51031,541,2414,2955,767,5487,6254,74649,628631,703280,02/01/2018 12:00:00 AM,138,260,238
Piedmont,Campbell County,51031,543,2568,3111,731,5729,6460,136459,982408,1118867,08/01/2020 12:00:00 AM,251,383,360
Piedmont,Campbell County,51031,543,2572,3115,738,5775,6513,141227,1063935,1205162,11/01/2020 12:00:00 AM,260,414,387
Piedmont,Campbell County,51031,544,2411,2955,757,5529,6286,74433,623829,698262,01/01/2018 12:00:00 AM,137,259,236
Piedmont,Campbell County,51031,545,2389,2934,772,5445,6217,75387,614989,690376,03/01/2018 12:00:00 AM,138,257,235
Piedmont,Campbell County,51031,545,2589,3134,740,5747,6487,145805,1041261,1187066,12/01/2020 12:00:00 AM,268,402,379
Piedmont,Campbell County,51031,547,2577,3124,750,5691,6441,164345,1191996,1356341,01/01/2021 12:00:00 AM,300,463,434
Piedmont,Campbell County,51031,548,2437,2985,770,5580,6350,77868,623672,701540,12/01/2017 12:00:00 AM,142,256,235
Piedmont,Campbell County,51031,551,2456,3007,765,5678,6443,76508,639404,715912,10/01/2017 12:00:00 AM,139,260,238
Piedmont,Campbell County,51031,555,2454,3009,782,5650,6432,81416,642917,724333,09/01/2017 12:00:00 AM,147,262,241
Piedmont,Campbell County,51031,557,2464,3021,781,5686,6467,80360,634946,715306,11/01/2017 12:00:00 AM,144,258,237
Piedmont,Campbell County,51031,559,2425,2984,815,5646,6461,81967,639695,721662,07/01/2017 12:00:00 AM,147,264,242
Piedmont,Campbell County,51031,562,2475,3037,795,5710,6505,80479,655760,736239,08/01/2017 12:00:00 AM,143,265,242
Piedmont,Campbell County,51031,565,2473,3038,821,5726,6547,82951,654561,737512,06/01/2017 12:00:00 AM,147,265,243
Piedmont,Campbell County,51031,567,2467,3034,822,5727,6549,84363,652607,736970,05/01/2017 12:00:00 AM,149,265,243
Piedmont,Campbell County,51031,574,2468,3042,833,5688,6521,84947,647625,732572,04/01/2017 12:00:00 AM,148,262,241
Piedmont,Campbell County,51031,575,2616,3191,845,6058,6903,86547,677819,764366,11/01/2016 12:00:00 AM,151,259,240
Piedmont,Campbell County,51031,576,2507,3083,845,5778,6623,86393,662616,749009,03/01/2017 12:00:00 AM,150,264,243
Piedmont,Campbell County,51031,581,2596,3177,850,5997,6847,87910,671981,759891,12/01/2016 12:00:00 AM,151,259,239
Piedmont,Campbell County,51031,591,2717,3308,895,6179,7074,90593,684011,774604,03/01/2016 12:00:00 AM,153,252,234
Piedmont,Campbell County,51031,592,2604,3196,857,5987,6844,87584,665587,753171,01/01/2017 12:00:00 AM,148,256,236
Piedmont,Campbell County,51031,592,2620,3212,866,6134,7000,89426,689405,778831,10/01/2016 12:00:00 AM,151,263,242
Piedmont,Campbell County,51031,592,2708,3300,893,6214,7107,91703,688023,779726,02/01/2016 12:00:00 AM,155,254,236
Piedmont,Campbell County,51031,595,2614,3209,894,5953,6847,89686,666656,756342,06/01/2016 12:00:00 AM,151,255,236
Piedmont,Campbell County,51031,595,2677,3272,889,6108,6997,88805,678180,766985,04/01/2016 12:00:00 AM,149,253,234
Piedmont,Campbell County,51031,596,2621,3217,893,6079,6972,89384,681122,770506,09/01/2016 12:00:00 AM,150,260,240
Piedmont,Campbell County,51031,597,2640,3237,901,6012,6913,90888,667427,758315,05/01/2016 12:00:00 AM,152,253,234
Piedmont,Campbell County,51031,599,2612,3211,900,5985,6885,91643,670600,762243,07/01/2016 12:00:00 AM,153,257,237
Piedmont,Campbell County,51031,604,2629,3233,919,6046,6965,93836,676264,770100,08/01/2016 12:00:00 AM,155,257,238
Piedmont,Campbell County,51031,608,2608,3216,904,6032,6936,92866,677614,770480,02/01/2017 12:00:00 AM,153,260,240
Piedmont,Campbell County,51031,609,2690,3299,934,6202,7136,95119,679663,774782,01/01/2016 12:00:00 AM,156,253,235
Piedmont,Campbell County,51031,612,2791,3403,919,6425,7344,96558,694707,791265,07/01/2015 12:00:00 AM,158,249,233
Piedmont,Campbell County,51031,612,2805,3417,921,6497,7418,95740,706315,802055,08/01/2015 12:00:00 AM,156,252,235
Piedmont,Campbell County,51031,613,2718,3331,932,6264,7196,95989,687320,783309,12/01/2015 12:00:00 AM,157,253,235
Piedmont,Campbell County,51031,615,2758,3373,949,6344,7293,99128,699531,798659,11/01/2015 12:00:00 AM,161,254,237
Piedmont,Campbell County,51031,625,2759,3384,950,6390,7340,98084,700782,798866,10/01/2015 12:00:00 AM,157,254,236
Piedmont,Campbell County,51031,626,2793,3419,961,6450,7411,101823,704427,806250,09/01/2015 12:00:00 AM,163,252,236
Piedmont,Campbell County,51031,627,2817,3444,951,6441,7392,101607,697144,798751,06/01/2015 12:00:00 AM,162,247,232
Piedmont,Campbell County,51031,628,2820,3448,954,6453,7407,98525,708253,806778,04/01/2015 12:00:00 AM,157,251,234
Piedmont,Campbell County,51031,629,2819,3448,949,6457,7406,98311,708340,806651,05/01/2015 12:00:00 AM,156,251,234
Piedmont,Campbell County,51031,645,2843,3488,986,6446,7432,106292,714083,820375,12/01/2014 12:00:00 AM,165,251,235
Piedmont,Campbell County,51031,650,2821,3471,1008,6454,7462,106619,705869,812488,03/01/2015 12:00:00 AM,164,250,234
Piedmont,Campbell County,51031,652,2864,3516,997,6501,7498,108273,730962,839235,11/01/2014 12:00:00 AM,166,255,239
Piedmont,Campbell County,51031,654,3131,3785,1030,6921,7951,101147,766994,868141,12/01/2013 12:00:00 AM,155,245,229
Piedmont,Campbell County,51031,658,2794,3452,1011,6397,7408,107051,701820,808871,02/01/2015 12:00:00 AM,163,251,234
Piedmont,Campbell County,51031,658,3094,3752,1008,6879,7887,97641,761127,858768,07/01/2014 12:00:00 AM,148,246,229
Piedmont,Campbell County,51031,659,2834,3493,1006,6436,7442,105662,703080,808742,01/01/2015 12:00:00 AM,160,248,232
Piedmont,Campbell County,51031,659,3051,3710,1022,6790,7812,101914,743250,845164,08/01/2014 12:00:00 AM,155,244,228
Piedmont,Campbell County,51031,661,2958,3619,1012,6670,7682,108588,752919,861507,10/01/2014 12:00:00 AM,164,255,238
Piedmont,Campbell County,51031,661,3005,3666,1037,6697,7734,104079,728573,832652,09/01/2014 12:00:00 AM,157,242,227
Piedmont,Campbell County,51031,662,3099,3761,1005,6871,7876,97410,764655,862065,06/01/2014 12:00:00 AM,147,247,229
Piedmont,Campbell County,51031,663,3125,3788,1036,6913,7949,101266,763224,864490,04/01/2014 12:00:00 AM,153,244,228
Piedmont,Campbell County,51031,665,3135,3800,1050,6923,7973,99591,761260,860851,01/01/2014 12:00:00 AM,150,243,227
Piedmont,Campbell County,51031,666,3146,3812,1068,6957,8025,104714,769670,874384,02/01/2014 12:00:00 AM,157,245,229
Piedmont,Campbell County,51031,667,3150,3817,1058,6931,7989,104710,774934,879644,11/01/2013 12:00:00 AM,157,246,230
Piedmont,Campbell County,51031,668,3100,3768,1050,6851,7901,104548,757394,861942,05/01/2014 12:00:00 AM,157,244,229
Piedmont,Campbell County,51031,671,3146,3817,1060,6940,8000,103232,769604,872836,03/01/2014 12:00:00 AM,154,245,229
Piedmont,Campbell County,51031,681,3157,3838,1107,6965,8072,122941,839476,962417,10/01/2013 12:00:00 AM,181,266,251
Piedmont,Campbell County,51031,681,3182,3863,1115,6996,8111,123152,842582,965734,09/01/2013 12:00:00 AM,181,265,250
Piedmont,Campbell County,51031,683,3083,3766,1147,6827,7974,125475,826193,951668,12/01/2012 12:00:00 AM,184,268,253
Piedmont,Campbell County,51031,686,3015,3701,1171,6777,7948,137334,861060,998394,07/01/2012 12:00:00 AM,200,286,270
Piedmont,Campbell County,51031,686,3205,3891,1121,7012,8133,121582,843475,965057,08/01/2013 12:00:00 AM,177,263,248
Piedmont,Campbell County,51031,688,3048,3736,1154,6802,7956,131213,820228,951441,10/01/2012 12:00:00 AM,191,269,255
Piedmont,Campbell County,51031,689,3063,3752,1157,6834,7991,129099,830007,959106,11/01/2012 12:00:00 AM,187,271,256
Piedmont,Campbell County,51031,690,3133,3823,1154,6901,8055,126927,827728,954655,04/01/2013 12:00:00 AM,184,264,250
Piedmont,Campbell County,51031,692,3028,3720,1164,6784,7948,130135,818681,948816,09/01/2012 12:00:00 AM,188,270,255
Piedmont,Campbell County,51031,693,2963,3656,1188,6651,7839,133254,794859,928113,04/01/2012 12:00:00 AM,192,268,254
Piedmont,Campbell County,51031,696,3001,3697,1182,6747,7929,134716,813179,947895,08/01/2012 12:00:00 AM,194,271,256
Piedmont,Campbell County,51031,697,3102,3799,1161,6884,8045,124378,826804,951182,01/01/2013 12:00:00 AM,178,267,250
Piedmont,Campbell County,51031,698,2943,3641,1190,6670,7860,132849,782160,915009,01/01/2012 12:00:00 AM,190,266,251
Piedmont,Campbell County,51031,700,3159,3859,1172,6950,8122,129220,832935,962155,05/01/2013 12:00:00 AM,185,264,249
Piedmont,Campbell County,51031,700,3164,3864,1171,6969,8140,128297,844825,973122,06/01/2013 12:00:00 AM,183,267,252
Piedmont,Campbell County,51031,700,3177,3877,1150,7002,8152,126549,841772,968321,07/01/2013 12:00:00 AM,181,265,250
Piedmont,Campbell County,51031,701,3114,3815,1180,6899,8079,128966,838661,967627,02/01/2013 12:00:00 AM,184,269,254
Piedmont,Campbell County,51031,702,2936,3638,1199,6635,7834,134671,784410,919081,03/01/2012 12:00:00 AM,192,267,253
Piedmont,Campbell County,51031,702,2995,3697,1205,6704,7909,132325,803302,935627,06/01/2012 12:00:00 AM,188,268,253
Piedmont,Campbell County,51031,703,2935,3638,1213,6626,7839,134647,788890,923537,02/01/2012 12:00:00 AM,192,269,254
Piedmont,Campbell County,51031,709,3111,3820,1186,6889,8075,130786,834249,965035,03/01/2013 12:00:00 AM,184,268,253
Piedmont,Campbell County,51031,710,2971,3681,1239,6657,7896,138310,795240,933550,05/01/2012 12:00:00 AM,195,268,254
Piedmont,Charlotte County,51037,221,771,992,269,1662,1931,53486,299933,353419,10/01/2020 12:00:00 AM,242,389,356
Piedmont,Charlotte County,51037,222,697,919,274,1522,1796,23468,172130,195598,02/01/2020 12:00:00 AM,106,247,213
Piedmont,Charlotte County,51037,222,728,950,274,1582,1856,51213,271091,322304,04/01/2020 12:00:00 AM,231,372,339
Piedmont,Charlotte County,51037,223,695,918,280,1514,1794,52082,258573,310655,03/01/2020 12:00:00 AM,234,372,338
Piedmont,Charlotte County,51037,223,710,933,276,1577,1853,24267,176227,200494,12/01/2019 12:00:00 AM,109,248,215
Piedmont,Charlotte County,51037,223,770,993,271,1660,1931,52521,307642,360163,11/01/2020 12:00:00 AM,236,400,363
Piedmont,Charlotte County,51037,224,723,947,271,1630,1901,22727,185348,208075,10/01/2019 12:00:00 AM,101,256,220
Piedmont,Charlotte County,51037,224,732,956,278,1594,1872,52299,273378,325677,05/01/2020 12:00:00 AM,233,373,341
Piedmont,Charlotte County,51037,224,756,980,274,1655,1929,63411,358262,421673,02/01/2021 12:00:00 AM,283,474,430
Piedmont,Charlotte County,51037,224,770,994,280,1643,1923,54684,295799,350483,12/01/2020 12:00:00 AM,244,384,353
Piedmont,Charlotte County,51037,224,776,1000,273,1709,1982,21868,186136,208004,04/01/2017 12:00:00 AM,98,240,208
Piedmont,Charlotte County,51037,225,709,934,277,1562,1839,23282,172027,195309,01/01/2020 12:00:00 AM,103,243,209
Piedmont,Charlotte County,51037,225,715,940,279,1593,1872,24216,180165,204381,11/01/2019 12:00:00 AM,108,252,217
Piedmont,Charlotte County,51037,225,731,956,281,1587,1868,53342,274174,327516,06/01/2020 12:00:00 AM,237,375,343
Piedmont,Charlotte County,51037,225,740,965,280,1609,1889,52617,277611,330228,07/01/2020 12:00:00 AM,234,375,342
Piedmont,Charlotte County,51037,225,742,967,281,1607,1888,66854,361671,428525,05/01/2021 12:00:00 AM,297,487,443
Piedmont,Charlotte County,51037,225,754,979,279,1647,1926,63084,339767,402851,01/01/2021 12:00:00 AM,280,451,411
Piedmont,Charlotte County,51037,226,753,979,281,1641,1922,66355,368401,434756,04/01/2021 12:00:00 AM,294,489,444
Piedmont,Charlotte County,51037,227,716,943,280,1616,1896,23277,179005,202282,09/01/2019 12:00:00 AM,103,250,215
Piedmont,Charlotte County,51037,227,737,964,279,1596,1875,51684,270409,322093,08/01/2020 12:00:00 AM,228,367,334
Piedmont,Charlotte County,51037,227,777,1004,276,1717,1993,22348,186748,209096,05/01/2017 12:00:00 AM,98,240,208
Piedmont,Charlotte County,51037,228,751,979,289,1592,1881,67785,359872,427657,06/01/2021 12:00:00 AM,297,479,437
Piedmont,Charlotte County,51037,228,757,985,279,1641,1920,51685,283431,335116,09/01/2020 12:00:00 AM,227,374,340
Piedmont,Charlotte County,51037,228,785,1013,278,1725,2003,21920,191887,213807,03/01/2017 12:00:00 AM,96,244,211
Piedmont,Charlotte County,51037,229,719,948,285,1609,1894,22835,182260,205095,06/01/2019 12:00:00 AM,100,253,216
Piedmont,Charlotte County,51037,229,748,977,284,1627,1911,63979,341121,405100,03/01/2021 12:00:00 AM,279,456,415
Piedmont,Charlotte County,51037,230,722,952,284,1622,1906,23783,181317,205100,07/01/2019 12:00:00 AM,103,251,215
Piedmont,Charlotte County,51037,231,689,920,282,1499,1781,22088,164526,186614,02/01/2019 12:00:00 AM,96,239,203
Piedmont,Charlotte County,51037,231,719,950,287,1609,1896,24083,180158,204241,08/01/2019 12:00:00 AM,104,251,215
Piedmont,Charlotte County,51037,231,804,1035,308,1782,2090,25793,193720,219513,08/01/2016 12:00:00 AM,112,241,212
Piedmont,Charlotte County,51037,232,797,1029,278,1778,2056,21407,190934,212341,02/01/2017 12:00:00 AM,92,240,206
Piedmont,Charlotte County,51037,233,709,942,293,1567,1860,22905,172632,195537,03/01/2019 12:00:00 AM,98,243,208
Piedmont,Charlotte County,51037,233,718,951,293,1589,1882,23081,177394,200475,04/01/2019 12:00:00 AM,99,247,211
Piedmont,Charlotte County,51037,234,709,943,293,1581,1874,24049,175761,199810,05/01/2019 12:00:00 AM,103,248,212
Piedmont,Charlotte County,51037,234,799,1033,319,1756,2075,26688,193909,220597,07/01/2016 12:00:00 AM,114,243,214
Piedmont,Charlotte County,51037,235,767,1002,287,1676,1963,23215,182897,206112,07/01/2017 12:00:00 AM,99,238,206
Piedmont,Charlotte County,51037,235,786,1021,295,1743,2038,23284,186932,210216,01/01/2017 12:00:00 AM,99,238,206
Piedmont,Charlotte County,51037,235,800,1035,323,1744,2067,27149,190558,217707,05/01/2016 12:00:00 AM,116,238,210
Piedmont,Charlotte County,51037,236,703,939,299,1561,1860,25801,174149,199950,01/01/2019 12:00:00 AM,109,248,213
Piedmont,Charlotte County,51037,236,773,1009,290,1695,1985,23867,183713,207580,08/01/2017 12:00:00 AM,101,238,206
Piedmont,Charlotte County,51037,236,781,1017,284,1712,1996,23672,188011,211683,06/01/2017 12:00:00 AM,100,241,208
Piedmont,Charlotte County,51037,238,805,1043,326,1747,2073,28623,192262,220885,06/01/2016 12:00:00 AM,120,239,212
Piedmont,Charlotte County,51037,238,812,1050,309,1796,2105,25983,197380,223363,09/01/2016 12:00:00 AM,109,243,213
Piedmont,Charlotte County,51037,239,718,957,297,1606,1903,25891,173920,199811,11/01/2018 12:00:00 AM,108,242,209
Piedmont,Charlotte County,51037,240,787,1027,302,1761,2063,23897,189541,213438,12/01/2016 12:00:00 AM,100,241,208
Piedmont,Charlotte County,51037,241,790,1031,309,1759,2068,26206,193330,219536,11/01/2016 12:00:00 AM,109,245,213
Piedmont,Charlotte County,51037,241,801,1042,306,1779,2085,25754,197468,223222,10/01/2016 12:00:00 AM,107,247,214
Piedmont,Charlotte County,51037,241,854,1095,330,1882,2212,26380,207678,234058,01/01/2015 12:00:00 AM,109,243,214
Piedmont,Charlotte County,51037,242,709,951,302,1588,1890,24721,173509,198230,08/01/2018 12:00:00 AM,102,245,208
Piedmont,Charlotte County,51037,242,772,1014,296,1684,1980,25152,182596,207748,09/01/2017 12:00:00 AM,104,237,205
Piedmont,Charlotte County,51037,243,840,1083,315,1882,2197,25285,205288,230573,07/01/2015 12:00:00 AM,104,244,213
Piedmont,Charlotte County,51037,244,711,955,306,1586,1892,26308,173024,199332,12/01/2018 12:00:00 AM,108,243,209
Piedmont,Charlotte County,51037,244,794,1038,342,1735,2077,30610,186230,216840,04/01/2016 12:00:00 AM,125,235,209
Piedmont,Charlotte County,51037,244,809,1053,342,1744,2086,30430,188885,219315,03/01/2016 12:00:00 AM,125,233,208
Piedmont,Charlotte County,51037,244,826,1070,325,1834,2159,26979,202179,229158,11/01/2015 12:00:00 AM,111,245,214
Piedmont,Charlotte County,51037,244,832,1076,326,1846,2172,26865,201974,228839,12/01/2015 12:00:00 AM,110,243,213
Piedmont,Charlotte County,51037,244,855,1099,366,1883,2249,30355,211568,241923,11/01/2014 12:00:00 AM,124,247,220
Piedmont,Charlotte County,51037,245,710,955,303,1594,1897,26188,175158,201346,09/01/2018 12:00:00 AM,107,247,211
Piedmont,Charlotte County,51037,245,718,963,305,1605,1910,29699,192861.59,222560.59,10/01/2018 12:00:00 AM,121,269,231
Piedmont,Charlotte County,51037,245,764,1009,300,1660,1960,26081,178328,204409,10/01/2017 12:00:00 AM,106,233,203
Piedmont,Charlotte County,51037,245,815,1060,344,1788,2132,30336,194718,225054,02/01/2016 12:00:00 AM,124,239,212
Piedmont,Charlotte County,51037,245,836,1081,318,1883,2201,26062,205449,231511,09/01/2015 12:00:00 AM,106,246,214
Piedmont,Charlotte County,51037,246,831,1077,340,1821,2161,27612,203523,231135,02/01/2015 12:00:00 AM,112,245,215
Piedmont,Charlotte County,51037,247,815,1062,340,1804,2144,28616,197584,226200,01/01/2016 12:00:00 AM,116,242,213
Piedmont,Charlotte County,51037,247,852,1099,360,1866,2226,26758,201848,228606,06/01/2014 12:00:00 AM,108,237,208
Piedmont,Charlotte County,51037,247,855,1102,325,1921,2246,26756,209350,236106,08/01/2015 12:00:00 AM,108,245,214
Piedmont,Charlotte County,51037,247,862,1109,354,1894,2248,28555,212269,240824,12/01/2014 12:00:00 AM,116,246,217
Piedmont,Charlotte County,51037,248,828,1076,330,1857,2187,27811,201480,229291,10/01/2015 12:00:00 AM,112,243,213
Piedmont,Charlotte County,51037,248,864,1112,355,1913,2268,26036,206682,232718,07/01/2014 12:00:00 AM,105,239,209
Piedmont,Charlotte County,51037,249,705,954,310,1539,1849,25818,170002,195820,06/01/2018 12:00:00 AM,104,241,205
Piedmont,Charlotte County,51037,250,697,947,313,1544,1857,28360,171751,200111,07/01/2018 12:00:00 AM,113,246,211
Piedmont,Charlotte County,51037,250,837,1087,333,1892,2225,28194,206986,235180,06/01/2015 12:00:00 AM,113,247,216
Piedmont,Charlotte County,51037,251,829,1080,337,1846,2183,27904,205467,233371,04/01/2015 12:00:00 AM,111,248,216
Piedmont,Charlotte County,51037,252,699,951,316,1529,1845,26227,168873,195100,05/01/2018 12:00:00 AM,104,242,205
Piedmont,Charlotte County,51037,252,726,978,313,1583,1896,25283,173005,198288,03/01/2018 12:00:00 AM,100,238,203
Piedmont,Charlotte County,51037,252,729,981,309,1594,1903,25483,172938,198421,02/01/2018 12:00:00 AM,101,237,202
Piedmont,Charlotte County,51037,253,709,962,316,1555,1871,26286,168615,194901,04/01/2018 12:00:00 AM,104,238,203
Piedmont,Charlotte County,51037,253,754,1007,308,1664,1972,25808,176890,202698,11/01/2017 12:00:00 AM,102,235,201
Piedmont,Charlotte County,51037,253,830,1083,352,1849,2201,29109,207941,237050,03/01/2015 12:00:00 AM,115,251,219
Piedmont,Charlotte County,51037,253,846,1099,375,1874,2249,30079,201205,231284,09/01/2014 12:00:00 AM,119,238,210
Piedmont,Charlotte County,51037,253,860,1113,385,1888,2273,32669,212957,245626,10/01/2014 12:00:00 AM,129,248,221
Piedmont,Charlotte County,51037,254,751,1005,311,1641,1952,25867,178270,204137,01/01/2018 12:00:00 AM,102,237,203
Piedmont,Charlotte County,51037,254,832,1086,339,1871,2210,28622,204612,233234,05/01/2015 12:00:00 AM,113,246,215
Piedmont,Charlotte County,51037,254,845,1099,375,1847,2222,28881,202347,231228,05/01/2014 12:00:00 AM,114,239,210
Piedmont,Charlotte County,51037,255,848,1103,383,1881,2264,30488,202462,232950,08/01/2014 12:00:00 AM,120,239,211
Piedmont,Charlotte County,51037,255,863,1118,383,1890,2273,31677,205411,237088,03/01/2014 12:00:00 AM,124,238,212
Piedmont,Charlotte County,51037,255,897,1152,367,1978,2345,28756,213575,242331,11/01/2013 12:00:00 AM,113,238,210
Piedmont,Charlotte County,51037,256,760,1016,314,1644,1958,27085,180203,207288,12/01/2017 12:00:00 AM,106,237,204
Piedmont,Charlotte County,51037,257,887,1144,378,1952,2330,30618,211461,242079,12/01/2013 12:00:00 AM,119,238,212
Piedmont,Charlotte County,51037,258,848,1106,383,1852,2235,29835,205149,234984,04/01/2014 12:00:00 AM,116,242,212
Piedmont,Charlotte County,51037,258,889,1147,390,1955,2345,31815,206463,238278,01/01/2014 12:00:00 AM,123,232,208
Piedmont,Charlotte County,51037,261,913,1174,391,2005,2396,34314,233789,268103,10/01/2013 12:00:00 AM,131,256,228
Piedmont,Charlotte County,51037,263,864,1127,402,1905,2307,33649,206929,240578,02/01/2014 12:00:00 AM,128,240,213
Piedmont,Charlotte County,51037,268,916,1184,409,1996,2405,37644,230828,268472,09/01/2013 12:00:00 AM,140,252,227
Piedmont,Charlotte County,51037,270,883,1153,415,1959,2374,39698,224889,264587,06/01/2013 12:00:00 AM,147,255,229
Piedmont,Charlotte County,51037,270,885,1155,413,1984,2397,38703,233084,271787,04/01/2013 12:00:00 AM,143,263,235
Piedmont,Charlotte County,51037,271,892,1163,420,1954,2374,39846,223322,263168,07/01/2013 12:00:00 AM,147,250,226
Piedmont,Charlotte County,51037,271,901,1172,410,1978,2388,37949,230370,268319,08/01/2013 12:00:00 AM,140,256,229
Piedmont,Charlotte County,51037,271,903,1174,432,2011,2443,41215,236314,277529,05/01/2012 12:00:00 AM,152,262,236
Piedmont,Charlotte County,51037,274,885,1159,420,1957,2377,39785,226895,266680,05/01/2013 12:00:00 AM,145,256,230
Piedmont,Charlotte County,51037,275,900,1175,437,2010,2447,41068,238186,279254,06/01/2012 12:00:00 AM,149,265,238
Piedmont,Charlotte County,51037,276,898,1174,437,2004,2441,42186,236033,278219,07/01/2012 12:00:00 AM,153,263,237
Piedmont,Charlotte County,51037,277,890,1167,448,1984,2432,44204,234804,279008,03/01/2013 12:00:00 AM,160,264,239
Piedmont,Charlotte County,51037,277,902,1179,431,2025,2456,40768,239798,280566,04/01/2012 12:00:00 AM,147,266,238
Piedmont,Charlotte County,51037,278,890,1168,441,1976,2417,42818,234080,276898,02/01/2013 12:00:00 AM,154,263,237
Piedmont,Charlotte County,51037,279,893,1172,448,1973,2421,43708,232846,276554,12/01/2012 12:00:00 AM,157,261,236
Piedmont,Charlotte County,51037,280,891,1171,454,1977,2431,43908,228073,271981,08/01/2012 12:00:00 AM,157,256,232
Piedmont,Charlotte County,51037,280,895,1175,444,1993,2437,43483,230925,274408,10/01/2012 12:00:00 AM,155,258,234
Piedmont,Charlotte County,51037,281,884,1165,458,1961,2419,44838,230635,275473,01/01/2013 12:00:00 AM,160,261,236
Piedmont,Charlotte County,51037,283,890,1173,454,1972,2426,45595,229297,274892,11/01/2012 12:00:00 AM,161,258,234
Piedmont,Charlotte County,51037,285,890,1175,461,1954,2415,44688,227038,271726,09/01/2012 12:00:00 AM,157,255,231
Piedmont,Charlotte County,51037,286,898,1184,437,2057,2494,40627,246211,286838,02/01/2012 12:00:00 AM,142,274,242
Piedmont,Charlotte County,51037,287,901,1188,441,2086,2527,40428,244354,284782,01/01/2012 12:00:00 AM,141,271,240
Piedmont,Charlotte County,51037,291,898,1189,465,2031,2496,44770,242369,287139,03/01/2012 12:00:00 AM,154,270,241
Piedmont,Charlottesville City,51540,524,1658,2182,728,3375,4103,162804,719080,881884,02/01/2021 12:00:00 AM,311,434,404
Piedmont,Charlottesville City,51540,531,1341,1872,876,2733,3609,79196,315221,394417,02/01/2019 12:00:00 AM,149,235,211
Piedmont,Charlottesville City,51540,531,1668,2199,770,3348,4118,167613,701693,869306,03/01/2021 12:00:00 AM,316,421,395
Piedmont,Charlottesville City,51540,533,1629,2162,850,3395,4245,79722,393436,473158,02/01/2017 12:00:00 AM,150,242,219
Piedmont,Charlottesville City,51540,537,1643,2180,815,3273,4088,182805,766864,949669,04/01/2021 12:00:00 AM,340,467,436
Piedmont,Charlottesville City,51540,542,1422,1964,875,2893,3768,77187,336641,413828,04/01/2019 12:00:00 AM,142,237,211
Piedmont,Charlottesville City,51540,542,1462,2004,860,3057,3917,76927,357508,434435,07/01/2019 12:00:00 AM,142,245,217
Piedmont,Charlottesville City,51540,543,1428,1971,867,2934,3801,78714,337512,416226,05/01/2019 12:00:00 AM,145,236,211
Piedmont,Charlottesville City,51540,543,1459,2002,883,3007,3890,80904,354353,435257,06/01/2019 12:00:00 AM,149,243,217
Piedmont,Charlottesville City,51540,547,1430,1977,886,2930,3816,80069,343692,423761,03/01/2019 12:00:00 AM,146,240,214
Piedmont,Charlottesville City,51540,548,1443,1991,888,2981,3869,82310,345915,428225,08/01/2019 12:00:00 AM,150,240,215
Piedmont,Charlottesville City,51540,549,1651,2200,853,3253,4106,194166,759892,954058,05/01/2021 12:00:00 AM,354,460,434
Piedmont,Charlottesville City,51540,551,1416,1967,900,2984,3884,79768,340243,420011,02/01/2020 12:00:00 AM,145,240,214
Piedmont,Charlottesville City,51540,552,1402,1954,910,2885,3795,82023,353233,435256,01/01/2019 12:00:00 AM,149,252,223
Piedmont,Charlottesville City,51540,552,1431,1983,901,2967,3868,82490,341818,424308,11/01/2018 12:00:00 AM,149,239,214
Piedmont,Charlottesville City,51540,553,1450,2003,879,3019,3898,83442,352113,435555,09/01/2019 12:00:00 AM,151,243,217
Piedmont,Charlottesville City,51540,553,1661,2214,843,3279,4122,188551,782495,971046,06/01/2021 12:00:00 AM,341,471,439
Piedmont,Charlottesville City,51540,555,1430,1985,911,2935,3846,80998,337948,418946,12/01/2018 12:00:00 AM,146,236,211
Piedmont,Charlottesville City,51540,555,1464,2019,893,3037,3930,86779,359470,446249,10/01/2019 12:00:00 AM,156,246,221
Piedmont,Charlottesville City,51540,557,1421,1978,923,2944,3867,82101,343250,425351,01/01/2020 12:00:00 AM,147,242,215
Piedmont,Charlottesville City,51540,558,1442,2000,906,2968,3874,82826,341011,423837,10/01/2018 12:00:00 AM,148,236,212
Piedmont,Charlottesville City,51540,559,1425,1984,917,2981,3898,160655,516241,676896,03/01/2020 12:00:00 AM,287,362,341
Piedmont,Charlottesville City,51540,559,1432,1991,912,3020,3932,84791,348502,433293,11/01/2019 12:00:00 AM,152,243,218
Piedmont,Charlottesville City,51540,560,1470,2030,903,3048,3951,82252,354604,436856,08/01/2018 12:00:00 AM,147,241,215
Piedmont,Charlottesville City,51540,561,1482,2043,888,3104,3992,80897,359111,440008,06/01/2018 12:00:00 AM,144,242,215
Piedmont,Charlottesville City,51540,561,1487,2048,912,3077,3989,83355,350583,433938,04/01/2018 12:00:00 AM,149,236,212
Piedmont,Charlottesville City,51540,561,1627,2188,890,3326,4216,84014,394232,478246,03/01/2017 12:00:00 AM,150,242,219
Piedmont,Charlottesville City,51540,563,1626,2189,871,3258,4129,188633,700493,889126,01/01/2021 12:00:00 AM,335,431,406
Piedmont,Charlottesville City,51540,564,1451,2015,909,3025,3934,85486,353021,438507,12/01/2019 12:00:00 AM,152,243,218
Piedmont,Charlottesville City,51540,564,1497,2061,909,3095,4004,84218,357326,441544,05/01/2018 12:00:00 AM,149,239,214
Piedmont,Charlottesville City,51540,565,1482,2047,889,3083,3972,81091,360426,441517,07/01/2018 12:00:00 AM,144,243,216
Piedmont,Charlottesville City,51540,568,1491,2059,938,3069,4007,85188,352655,437843,03/01/2018 12:00:00 AM,150,237,213
Piedmont,Charlottesville City,51540,570,1583,2153,919,3264,4183,86287,384285,470572,04/01/2017 12:00:00 AM,151,243,219
Piedmont,Charlottesville City,51540,570,1604,2174,910,3286,4196,84517,390311,474828,06/01/2017 12:00:00 AM,148,243,218
Piedmont,Charlottesville City,51540,571,1587,2158,913,3253,4166,85318,383609,468927,05/01/2017 12:00:00 AM,149,242,217
Piedmont,Charlottesville City,51540,571,1614,2185,942,3275,4217,166999,571804,738803,04/01/2020 12:00:00 AM,292,354,338
Piedmont,Charlottesville City,51540,571,1617,2188,899,3262,4161,169304,604896,774200,12/01/2020 12:00:00 AM,297,374,354
Piedmont,Charlottesville City,51540,571,1626,2197,911,3286,4197,170557,595817,766374,11/01/2020 12:00:00 AM,299,366,349
Piedmont,Charlottesville City,51540,572,1464,2036,934,3028,3962,82420,355017,437437,09/01/2018 12:00:00 AM,144,242,215
Piedmont,Charlottesville City,51540,572,1555,2127,914,3203,4117,87370,381945,469315,07/01/2017 12:00:00 AM,153,246,221
Piedmont,Charlottesville City,51540,572,1562,2134,910,3189,4099,87386,381253,468639,08/01/2017 12:00:00 AM,153,244,220
Piedmont,Charlottesville City,51540,574,1493,2067,913,3088,4001,80844,359746,440590,01/01/2018 12:00:00 AM,141,241,213
Piedmont,Charlottesville City,51540,576,1662,2238,905,3335,4240,170620,617813,788433,10/01/2020 12:00:00 AM,296,372,352
Piedmont,Charlottesville City,51540,577,1602,2179,913,3442,4355,83111,392909,476020,10/01/2016 12:00:00 AM,144,245,218
Piedmont,Charlottesville City,51540,577,1666,2243,908,3529,4437,84267,405254,489521,01/01/2017 12:00:00 AM,146,243,218
Piedmont,Charlottesville City,51540,578,1635,2213,921,3490,4411,83967,400684,484651,12/01/2016 12:00:00 AM,145,245,219
Piedmont,Charlottesville City,51540,578,1691,2269,951,3398,4349,167606,590981,758587,05/01/2020 12:00:00 AM,290,349,334
Piedmont,Charlottesville City,51540,579,1477,2056,955,3050,4005,84777,353578,438355,02/01/2018 12:00:00 AM,146,239,213
Piedmont,Charlottesville City,51540,580,1497,2077,945,3081,4026,90307,357521,447828,12/01/2017 12:00:00 AM,156,239,216
Piedmont,Charlottesville City,51540,580,1631,2211,912,3573,4485,82736,408245,490981,08/01/2016 12:00:00 AM,143,250,222
Piedmont,Charlottesville City,51540,582,1676,2258,954,3347,4301,170185,584580,754765,06/01/2020 12:00:00 AM,292,349,334
Piedmont,Charlottesville City,51540,582,1702,2284,926,3415,4341,162483,596605,759088,09/01/2020 12:00:00 AM,279,351,332
Piedmont,Charlottesville City,51540,583,1606,2189,924,3500,4424,82803,402133,484936,09/01/2016 12:00:00 AM,142,250,222
Piedmont,Charlottesville City,51540,584,1525,2109,940,3129,4069,88757,365447,454204,11/01/2017 12:00:00 AM,152,240,215
Piedmont,Charlottesville City,51540,585,1605,2190,923,3458,4381,83939,395731,479670,11/01/2016 12:00:00 AM,143,247,219
Piedmont,Charlottesville City,51540,588,1546,2134,932,3154,4086,89820,372251,462071,09/01/2017 12:00:00 AM,153,241,217
Piedmont,Charlottesville City,51540,588,1724,2312,937,3451,4388,165634,591687,757321,08/01/2020 12:00:00 AM,282,343,328
Piedmont,Charlottesville City,51540,589,1707,2296,949,3391,4340,168477,591491,759968,07/01/2020 12:00:00 AM,286,347,331
Piedmont,Charlottesville City,51540,591,1535,2126,941,3163,4104,89384,368312,457696,10/01/2017 12:00:00 AM,151,240,215
Piedmont,Charlottesville City,51540,592,1645,2237,952,3559,4511,87557,411811,499368,07/01/2016 12:00:00 AM,148,250,223
Piedmont,Charlottesville City,51540,600,1656,2256,963,3590,4553,86973,428110,515083,06/01/2016 12:00:00 AM,145,259,228
Piedmont,Charlottesville City,51540,604,1647,2251,959,3570,4529,87156,421514,508670,05/01/2016 12:00:00 AM,144,256,226
Piedmont,Charlottesville City,51540,611,1667,2278,983,3626,4609,89260,418019,507279,02/01/2016 12:00:00 AM,146,251,223
Piedmont,Charlottesville City,51540,612,1685,2297,988,3677,4665,91039,418897,509936,03/01/2016 12:00:00 AM,149,249,222
Piedmont,Charlottesville City,51540,615,1668,2283,990,3618,4608,91856,414484,506340,04/01/2016 12:00:00 AM,149,248,222
Piedmont,Charlottesville City,51540,620,1762,2382,985,3805,4790,94394,445781,540175,10/01/2015 12:00:00 AM,152,253,227
Piedmont,Charlottesville City,51540,622,1779,2401,1009,3824,4833,93895,450002,543897,09/01/2015 12:00:00 AM,151,253,227
Piedmont,Charlottesville City,51540,624,1806,2430,1014,3896,4910,95172,459791,554963,08/01/2015 12:00:00 AM,153,255,228
Piedmont,Charlottesville City,51540,626,1714,2340,1026,3680,4706,92715,421796,514511,01/01/2016 12:00:00 AM,148,246,220
Piedmont,Charlottesville City,51540,626,1841,2467,1030,3890,4920,100618,450779,551397,02/01/2015 12:00:00 AM,161,245,224
Piedmont,Charlottesville City,51540,628,1804,2432,1021,3865,4886,94912,450750,545662,07/01/2015 12:00:00 AM,151,250,224
Piedmont,Charlottesville City,51540,629,1925,2554,1031,4004,5035,99945,462395,562340,12/01/2014 12:00:00 AM,159,240,220
Piedmont,Charlottesville City,51540,629,1945,2574,999,4074,5073,97261,476991,574252,11/01/2014 12:00:00 AM,155,245,223
Piedmont,Charlottesville City,51540,631,1871,2502,1025,3950,4975,96295,453346,549641,01/01/2015 12:00:00 AM,153,242,220
Piedmont,Charlottesville City,51540,632,1728,2360,1019,3712,4731,95270,427729,522999,11/01/2015 12:00:00 AM,151,248,222
Piedmont,Charlottesville City,51540,632,1980,2612,991,4148,5139,96815,490363,587178,10/01/2014 12:00:00 AM,153,248,225
Piedmont,Charlottesville City,51540,634,2178,2812,1002,4326,5328,89428,511671,601099,04/01/2014 12:00:00 AM,141,235,214
Piedmont,Charlottesville City,51540,635,2093,2728,1022,4271,5293,93346,493803,587149,08/01/2014 12:00:00 AM,147,236,215
Piedmont,Charlottesville City,51540,636,1717,2353,1039,3679,4718,96361,426475,522836,12/01/2015 12:00:00 AM,152,248,222
Piedmont,Charlottesville City,51540,638,2048,2686,1036,4218,5254,96724,481461,578185,09/01/2014 12:00:00 AM,152,235,215
Piedmont,Charlottesville City,51540,639,1781,2420,1047,3805,4852,103563,441035,544598,05/01/2015 12:00:00 AM,162,248,225
Piedmont,Charlottesville City,51540,639,1806,2445,1055,3853,4908,100691,449427,550118,06/01/2015 12:00:00 AM,158,249,225
Piedmont,Charlottesville City,51540,640,2167,2807,1014,4351,5365,93101,517569,610670,06/01/2014 12:00:00 AM,145,239,218
Piedmont,Charlottesville City,51540,643,2158,2801,1024,4297,5321,93034,509577,602611,05/01/2014 12:00:00 AM,145,236,215
Piedmont,Charlottesville City,51540,644,1826,2470,1074,3839,4913,107520,441277,548797,03/01/2015 12:00:00 AM,167,242,222
Piedmont,Charlottesville City,51540,644,2177,2821,1030,4289,5319,93907,504917,598824,03/01/2014 12:00:00 AM,146,232,212
Piedmont,Charlottesville City,51540,646,1825,2471,1072,3836,4908,107293,445161,552454,04/01/2015 12:00:00 AM,166,244,224
Piedmont,Charlottesville City,51540,648,2127,2775,1052,4276,5328,97042,500488,597530,07/01/2014 12:00:00 AM,150,235,215
Piedmont,Charlottesville City,51540,665,2188,2853,1074,4299,5373,99948,503497,603445,02/01/2014 12:00:00 AM,150,230,212
Piedmont,Charlottesville City,51540,668,2188,2856,1070,4308,5378,97475,497742,595217,01/01/2014 12:00:00 AM,146,227,208
Piedmont,Charlottesville City,51540,668,2231,2899,1064,4393,5457,99465,510682,610147,11/01/2013 12:00:00 AM,149,229,210
Piedmont,Charlottesville City,51540,674,2426,3100,1098,4627,5725,119075,611858,730933,07/01/2012 12:00:00 AM,177,252,236
Piedmont,Charlottesville City,51540,675,2181,2856,1090,4286,5376,100229,495988,596217,12/01/2013 12:00:00 AM,148,227,209
Piedmont,Charlottesville City,51540,675,2384,3059,1117,4537,5654,118482,595172,713654,04/01/2013 12:00:00 AM,176,250,233
Piedmont,Charlottesville City,51540,680,2454,3134,1151,4674,5825,125264,615477,740741,08/01/2012 12:00:00 AM,184,251,236
Piedmont,Charlottesville City,51540,683,2346,3029,1137,4454,5591,118947,581830,700777,05/01/2013 12:00:00 AM,174,248,231
Piedmont,Charlottesville City,51540,683,2366,3049,1124,4499,5623,115674,592652,708326,06/01/2013 12:00:00 AM,169,250,232
Piedmont,Charlottesville City,51540,683,2440,3123,1140,4610,5750,125433,609864,735297,06/01/2012 12:00:00 AM,184,250,235
Piedmont,Charlottesville City,51540,684,2339,3023,1127,4521,5648,118667,591638,710305,08/01/2013 12:00:00 AM,173,253,235
Piedmont,Charlottesville City,51540,684,2416,3100,1143,4624,5767,126985,610591,737576,04/01/2012 12:00:00 AM,186,253,238
Piedmont,Charlottesville City,51540,689,2370,3059,1176,4548,5724,132750,591265,724015,01/01/2012 12:00:00 AM,193,249,237
Piedmont,Charlottesville City,51540,690,2394,3084,1144,4555,5699,125738,600470,726208,05/01/2012 12:00:00 AM,182,251,235
Piedmont,Charlottesville City,51540,691,2428,3119,1198,4598,5796,135172,602023,737195,09/01/2012 12:00:00 AM,196,248,236
Piedmont,Charlottesville City,51540,691,2451,3142,1192,4634,5826,132435,606118,738553,10/01/2012 12:00:00 AM,192,247,235
Piedmont,Charlottesville City,51540,695,2277,2972,1134,4439,5573,120827,571844,692671,10/01/2013 12:00:00 AM,174,251,233
Piedmont,Charlottesville City,51540,695,2281,2976,1129,4452,5581,119087,581249,700336,09/01/2013 12:00:00 AM,171,255,235
Piedmont,Charlottesville City,51540,695,2399,3094,1159,4551,5710,125546,596912,722458,03/01/2013 12:00:00 AM,181,249,234
Piedmont,Charlottesville City,51540,696,2350,3046,1162,4491,5653,121643,586961,708604,07/01/2013 12:00:00 AM,175,250,233
Piedmont,Charlottesville City,51540,696,2426,3122,1205,4588,5793,137284,602164,739448,11/01/2012 12:00:00 AM,197,248,237
Piedmont,Charlottesville City,51540,697,2392,3089,1179,4604,5783,134141,605377,739518,02/01/2012 12:00:00 AM,192,253,239
Piedmont,Charlottesville City,51540,700,2405,3105,1181,4621,5802,132876,606799,739675,03/01/2012 12:00:00 AM,190,252,238
Piedmont,Charlottesville City,51540,704,2430,3134,1172,4591,5763,125647,601149,726796,02/01/2013 12:00:00 AM,178,247,232
Piedmont,Charlottesville City,51540,707,2409,3116,1236,4550,5786,137891,597852,735743,12/01/2012 12:00:00 AM,195,248,236
Piedmont,Charlottesville City,51540,712,2401,3113,1224,4521,5745,133168,588797,721965,01/01/2013 12:00:00 AM,187,245,232
Piedmont,Covington City,51580,100,380,480,136,940,1076,12614,100380,112994,05/01/2016 12:00:00 AM,126,264,235
Piedmont,Covington City,51580,100,394,494,138,912,1050,11793,92399,104192,03/01/2018 12:00:00 AM,118,235,211
Piedmont,Covington City,51580,100,409,509,143,946,1089,14350,103533,117883,09/01/2017 12:00:00 AM,144,253,232
Piedmont,Covington City,51580,100,432,532,154,1011,1165,14859,108690,123549,07/01/2015 12:00:00 AM,149,252,232
Piedmont,Covington City,51580,100,433,533,153,1011,1164,15780,106854,122634,05/01/2015 12:00:00 AM,158,247,230
Piedmont,Covington City,51580,100,437,537,146,972,1118,13717,104302,118019,12/01/2013 12:00:00 AM,137,239,220
Piedmont,Covington City,51580,100,440,540,144,973,1117,13467,101305,114772,01/01/2014 12:00:00 AM,135,230,213
Piedmont,Covington City,51580,101,391,492,159,943,1102,13722,100896,114618,03/01/2016 12:00:00 AM,136,258,233
Piedmont,Covington City,51580,101,400,501,140,931,1071,12660,100290,112950,04/01/2018 12:00:00 AM,125,251,225
Piedmont,Covington City,51580,101,403,504,141,935,1076,12954,95660,108614,01/01/2018 12:00:00 AM,128,237,216
Piedmont,Covington City,51580,101,404,505,147,974,1121,13910,100171,114081,10/01/2015 12:00:00 AM,138,248,226
Piedmont,Covington City,51580,101,406,507,143,935,1078,12508,99450,111958,02/01/2018 12:00:00 AM,124,245,221
Piedmont,Covington City,51580,101,415,516,154,963,1117,14428,106687,121115,05/01/2017 12:00:00 AM,143,257,235
Piedmont,Covington City,51580,101,418,519,152,979,1131,13655,103817,117472,09/01/2015 12:00:00 AM,135,248,226
Piedmont,Covington City,51580,101,421,522,144,1013,1157,13675,117316,130991,01/01/2012 12:00:00 AM,135,279,251
Piedmont,Covington City,51580,101,424,525,151,946,1097,15793,101518,117311,11/01/2014 12:00:00 AM,156,239,223
Piedmont,Covington City,51580,101,434,535,151,1009,1160,13666,109428,123094,08/01/2015 12:00:00 AM,135,252,230
Piedmont,Covington City,51580,101,450,551,140,1007,1147,13535,117887,131422,10/01/2013 12:00:00 AM,134,262,239
Piedmont,Covington City,51580,102,400,502,151,958,1109,12868,98656,111524,11/01/2015 12:00:00 AM,126,247,222
Piedmont,Covington City,51580,102,404,506,144,936,1080,14782,97228,112010,10/01/2017 12:00:00 AM,145,241,221
Piedmont,Covington City,51580,102,414,516,149,961,1110,15343,98318,113661,11/01/2017 12:00:00 AM,150,237,220
Piedmont,Covington City,51580,102,421,523,145,1023,1168,13845,121354,135199,02/01/2012 12:00:00 AM,136,288,259
Piedmont,Covington City,51580,102,447,549,125,1032,1157,11197,124961,136158,06/01/2013 12:00:00 AM,110,280,248
Piedmont,Covington City,51580,102,448,550,151,989,1140,14585,107983,122568,02/01/2014 12:00:00 AM,143,241,223
Piedmont,Covington City,51580,102,456,558,152,1001,1153,15303,111135,126438,03/01/2014 12:00:00 AM,150,244,227
Piedmont,Covington City,51580,103,457,560,128,1043,1171,11518,124791,136309,07/01/2013 12:00:00 AM,112,273,243
Piedmont,Covington City,51580,104,415,519,149,964,1113,15040,100507,115547,12/01/2017 12:00:00 AM,145,242,223
Piedmont,Covington City,51580,104,421,525,150,962,1112,15064,104643,119707,10/01/2014 12:00:00 AM,145,249,228
Piedmont,Covington City,51580,105,443,548,155,979,1134,14511,104042,118553,11/01/2013 12:00:00 AM,138,235,216
Piedmont,Covington City,51580,105,454,559,153,989,1142,15030,109869,124899,04/01/2014 12:00:00 AM,143,242,223
Piedmont,Covington City,51580,106,448,554,129,1044,1173,12220,127811,140031,05/01/2013 12:00:00 AM,115,285,253
Piedmont,Covington City,51580,106,455,561,157,996,1153,15540,110985,126525,06/01/2014 12:00:00 AM,147,244,226
Piedmont,Covington City,51580,106,456,562,156,995,1151,15460,111793,127253,05/01/2014 12:00:00 AM,146,245,226
Piedmont,Covington City,51580,107,413,520,159,999,1158,16102,116203,132305,03/01/2012 12:00:00 AM,150,281,254
Piedmont,Covington City,51580,107,449,556,154,1097,1251,20936,148028,168964,07/01/2012 12:00:00 AM,196,330,304
Piedmont,Covington City,51580,108,435,543,162,1047,1209,16224,121878,138102,04/01/2012 12:00:00 AM,150,280,254
Piedmont,Covington City,51580,108,449,557,162,1078,1240,16143,125830,141973,05/01/2012 12:00:00 AM,149,280,255
Piedmont,Covington City,51580,109,432,541,161,974,1135,15112,105172,120284,09/01/2014 12:00:00 AM,139,243,222
Piedmont,Covington City,51580,109,447,556,161,1070,1231,16531,123562,140093,06/01/2012 12:00:00 AM,152,276,252
Piedmont,Covington City,51580,110,448,558,164,992,1156,15473,108324,123797,07/01/2014 12:00:00 AM,141,242,222
Piedmont,Covington City,51580,111,447,558,158,1088,1246,16397,124979,141376,08/01/2012 12:00:00 AM,148,280,253
Piedmont,Covington City,51580,111,458,569,149,1069,1218,15363,123035,138398,02/01/2013 12:00:00 AM,138,269,243
Piedmont,Covington City,51580,112,453,565,139,1043,1182,13628,124868,138496,04/01/2013 12:00:00 AM,122,276,245
Piedmont,Covington City,51580,112,457,569,159,1086,1245,16729,122860,139589,01/01/2013 12:00:00 AM,149,269,245
Piedmont,Covington City,51580,113,443,556,161,1066,1227,16495,124527,141022,09/01/2012 12:00:00 AM,146,281,254
Piedmont,Covington City,51580,113,446,559,164,999,1163,15272,109586,124858,08/01/2014 12:00:00 AM,135,246,223
Piedmont,Covington City,51580,113,460,573,155,1119,1274,16002,130260,146262,10/01/2012 12:00:00 AM,142,283,255
Piedmont,Covington City,51580,114,461,575,146,1086,1232,14916,126647,141563,03/01/2013 12:00:00 AM,131,275,246
Piedmont,Covington City,51580,118,457,575,167,1104,1271,17949,128737,146686,12/01/2012 12:00:00 AM,152,282,255
Piedmont,Covington City,51580,122,456,578,173,1101,1274,18419,126385,144804,11/01/2012 12:00:00 AM,151,277,251
Piedmont,Covington City,51580,78,379,457,104,859,963,10088,95545,105633,10/01/2019 12:00:00 AM,129,252,231
Piedmont,Covington City,51580,79,383,462,104,874,978,10331,98458,108789,12/01/2019 12:00:00 AM,131,257,235
Piedmont,Covington City,51580,80,382,462,108,868,976,8039,94874,102913,07/01/2019 12:00:00 AM,100,248,223
Piedmont,Covington City,51580,80,386,466,104,863,967,9734,94169,103903,01/01/2020 12:00:00 AM,122,244,223
Piedmont,Covington City,51580,80,388,468,111,869,980,9051,96391,105442,06/01/2019 12:00:00 AM,113,248,225
Piedmont,Covington City,51580,80,391,471,110,877,987,9408,97085,106493,05/01/2019 12:00:00 AM,118,248,226
Piedmont,Covington City,51580,81,373,454,107,847,954,10503,92451,102954,11/01/2019 12:00:00 AM,130,248,227
Piedmont,Covington City,51580,82,378,460,113,868,981,10086,93060,103146,09/01/2019 12:00:00 AM,123,246,224
Piedmont,Covington City,51580,82,378,460,118,853,971,10986,93895,104881,04/01/2019 12:00:00 AM,134,248,228
Piedmont,Covington City,51580,82,386,468,110,882,992,8491,95004,103495,08/01/2019 12:00:00 AM,104,246,221
Piedmont,Covington City,51580,83,379,462,107,842,949,10189,93538,103727,02/01/2020 12:00:00 AM,123,247,225
Piedmont,Covington City,51580,83,388,471,110,856,966,20132,146338,166470,03/01/2020 12:00:00 AM,243,377,353
Piedmont,Covington City,51580,84,381,465,121,865,986,10947,95759,106706,03/01/2019 12:00:00 AM,130,251,229
Piedmont,Covington City,51580,85,427,512,111,943,1054,20606,165029,185635,04/01/2020 12:00:00 AM,242,386,363
Piedmont,Covington City,51580,86,364,450,123,843,966,11024,90929,101953,02/01/2019 12:00:00 AM,128,250,227
Piedmont,Covington City,51580,87,429,516,115,954,1069,21155,162167,183322,05/01/2020 12:00:00 AM,243,378,355
Piedmont,Covington City,51580,88,432,520,117,948,1065,21282,164030,185312,06/01/2020 12:00:00 AM,242,380,356
Piedmont,Covington City,51580,88,435,523,109,946,1055,26004,212638,238642,04/01/2021 12:00:00 AM,296,489,456
Piedmont,Covington City,51580,89,377,466,131,858,989,12080,93559,105639,01/01/2019 12:00:00 AM,136,248,227
Piedmont,Covington City,51580,89,385,474,135,891,1026,13282,97235,110517,12/01/2018 12:00:00 AM,149,253,233
Piedmont,Covington City,51580,89,391,480,134,927,1061,13007,101189,114196,11/01/2018 12:00:00 AM,146,259,238
Piedmont,Covington City,51580,89,431,520,109,961,1070,24470,202056,226526,02/01/2021 12:00:00 AM,275,469,436
Piedmont,Covington City,51580,90,411,501,122,1008,1130,10272,111344,121616,09/01/2016 12:00:00 AM,114,271,243
Piedmont,Covington City,51580,90,432,522,111,939,1050,25003,195349,220352,03/01/2021 12:00:00 AM,278,452,422
Piedmont,Covington City,51580,91,427,518,116,950,1066,26035,195266,221301,01/01/2021 12:00:00 AM,286,457,427
Piedmont,Covington City,51580,91,431,522,115,923,1038,28156,210607,238763,05/01/2021 12:00:00 AM,309,489,457
Piedmont,Covington City,51580,92,395,487,129,921,1050,12020,99625,111645,08/01/2018 12:00:00 AM,131,252,229
Piedmont,Covington City,51580,92,398,490,133,969,1102,11176,104832,116008,11/01/2016 12:00:00 AM,121,263,237
Piedmont,Covington City,51580,92,404,496,127,997,1124,10892,106361,117253,08/01/2016 12:00:00 AM,118,263,236
Piedmont,Covington City,51580,93,391,484,133,919,1052,12489,100179,112668,09/01/2018 12:00:00 AM,134,256,233
Piedmont,Covington City,51580,93,392,485,129,909,1038,11499,103879,115378,07/01/2018 12:00:00 AM,124,265,238
Piedmont,Covington City,51580,93,393,486,134,932,1066,13410,101949,115359,10/01/2018 12:00:00 AM,144,259,237
Piedmont,Covington City,51580,93,401,494,134,933,1067,12481,98647,111128,02/01/2017 12:00:00 AM,134,246,225
Piedmont,Covington City,51580,93,446,539,124,990,1114,22807,170294,193101,07/01/2020 12:00:00 AM,245,382,358
Piedmont,Covington City,51580,94,390,484,131,909,1040,12581,98288,110869,06/01/2018 12:00:00 AM,134,252,229
Piedmont,Covington City,51580,94,398,492,138,958,1096,12222,104242,116464,12/01/2016 12:00:00 AM,130,262,237
Piedmont,Covington City,51580,94,400,494,135,944,1079,12321,103977,116298,01/01/2017 12:00:00 AM,131,260,235
Piedmont,Covington City,51580,94,410,504,133,967,1100,12067,109594,121661,08/01/2017 12:00:00 AM,128,267,241
Piedmont,Covington City,51580,94,434,528,120,959,1079,23441,173545,196986,12/01/2020 12:00:00 AM,249,400,373
Piedmont,Covington City,51580,95,396,491,135,960,1095,11512,103179,114691,04/01/2016 12:00:00 AM,121,261,234
Piedmont,Covington City,51580,95,397,492,132,910,1042,11695,95534,107229,05/01/2018 12:00:00 AM,123,241,218
Piedmont,Covington City,51580,95,404,499,143,980,1123,12033,106992,119025,10/01/2016 12:00:00 AM,127,265,239
Piedmont,Covington City,51580,95,413,508,138,960,1098,12317,104144,116461,03/01/2017 12:00:00 AM,130,252,229
Piedmont,Covington City,51580,95,435,530,142,1004,1146,14715,107746,122461,12/01/2014 12:00:00 AM,155,248,231
Piedmont,Covington City,51580,95,439,534,119,950,1069,27646,211416,239062,06/01/2021 12:00:00 AM,291,482,448
Piedmont,Covington City,51580,95,446,541,128,970,1098,22686,164115,186801,08/01/2020 12:00:00 AM,239,368,345
Piedmont,Covington City,51580,96,386,482,130,949,1079,11063,101181,112244,06/01/2016 12:00:00 AM,115,262,233
Piedmont,Covington City,51580,96,387,483,134,962,1096,10672,102918,113590,07/01/2016 12:00:00 AM,111,266,235
Piedmont,Covington City,51580,96,403,499,139,974,1113,11146,103223,114369,02/01/2016 12:00:00 AM,116,256,229
Piedmont,Covington City,51580,96,404,500,139,957,1096,11829,107327,119156,07/01/2017 12:00:00 AM,123,266,238
Piedmont,Covington City,51580,96,440,536,126,966,1092,24343,176662,201005,10/01/2020 12:00:00 AM,254,402,375
Piedmont,Covington City,51580,97,429,526,120,954,1074,23509,170568,194077,11/01/2020 12:00:00 AM,242,398,369
Piedmont,Covington City,51580,97,431,528,138,1011,1149,13381,107221,120602,06/01/2015 12:00:00 AM,138,249,228
Piedmont,Covington City,51580,97,448,545,127,987,1114,23449,169717,193166,09/01/2020 12:00:00 AM,242,379,354
Piedmont,Covington City,51580,97,452,549,128,1011,1139,12035,121103,133138,09/01/2013 12:00:00 AM,124,268,243
Piedmont,Covington City,51580,98,396,494,139,951,1090,11429,98440,109869,12/01/2015 12:00:00 AM,117,249,222
Piedmont,Covington City,51580,98,404,502,138,962,1100,11132,101503,112635,01/01/2016 12:00:00 AM,114,251,224
Piedmont,Covington City,51580,98,412,510,145,959,1104,12373,107788,120161,06/01/2017 12:00:00 AM,126,262,236
Piedmont,Covington City,51580,98,437,535,146,1017,1163,13445,108932,122377,01/01/2015 12:00:00 AM,137,249,229
Piedmont,Covington City,51580,98,457,555,122,1039,1161,10934,125785,136719,08/01/2013 12:00:00 AM,112,275,246
Piedmont,Covington City,51580,99,402,501,150,921,1071,13454,101405,114859,04/01/2017 12:00:00 AM,136,252,229
Piedmont,Covington City,51580,99,433,532,145,1010,1155,14743,105558,120301,04/01/2015 12:00:00 AM,149,244,226
Piedmont,Covington City,51580,99,436,535,142,1005,1147,14238,105049,119287,03/01/2015 12:00:00 AM,144,241,223
Piedmont,Covington City,51580,99,449,548,142,1043,1185,13334,113061,126395,02/01/2015 12:00:00 AM,135,252,231
Piedmont,Craig County,51045,33,166,199,43,361,404,2490,34135,36625,11/01/2019 12:00:00 AM,75,206,184
Piedmont,Craig County,51045,34,163,197,41,343,384,2419,34809,37228,02/01/2020 12:00:00 AM,71,214,189
Piedmont,Craig County,51045,34,168,202,44,371,415,2888,36622,39510,12/01/2019 12:00:00 AM,85,218,196
Piedmont,Craig County,51045,35,163,198,44,353,397,2800,36307,39107,01/01/2020 12:00:00 AM,80,223,198
Piedmont,Craig County,51045,35,168,203,46,365,411,2963,36397,39360,10/01/2019 12:00:00 AM,85,217,194
Piedmont,Craig County,51045,35,190,225,41,429,470,3189,45020,48209,12/01/2018 12:00:00 AM,91,237,214
Piedmont,Craig County,51045,36,168,204,47,382,429,3082,37519,40601,09/01/2019 12:00:00 AM,86,223,199
Piedmont,Craig County,51045,36,196,232,45,442,487,3532,43195,46727,11/01/2018 12:00:00 AM,98,220,201
Piedmont,Craig County,51045,37,165,202,45,342,387,8466,61030,69496,03/01/2020 12:00:00 AM,229,370,344
Piedmont,Craig County,51045,37,167,204,48,351,399,8955,64633,73588,12/01/2020 12:00:00 AM,242,387,361
Piedmont,Craig County,51045,37,183,220,47,410,457,3367,42747,46114,09/01/2018 12:00:00 AM,91,234,210
Piedmont,Craig County,51045,37,191,228,47,436,483,3690,41829,45519,10/01/2018 12:00:00 AM,100,219,200
Piedmont,Craig County,51045,37,193,230,44,439,483,3122,46415,49537,01/01/2019 12:00:00 AM,84,240,215
Piedmont,Craig County,51045,38,176,214,49,376,425,11137,79761,90898,02/01/2021 12:00:00 AM,293,453,425
Piedmont,Craig County,51045,38,182,220,46,420,466,2973,43730,46703,02/01/2019 12:00:00 AM,78,240,212
Piedmont,Craig County,51045,38,185,223,47,419,466,3444,40738,44182,04/01/2019 12:00:00 AM,91,220,198
Piedmont,Craig County,51045,39,168,207,49,376,425,3055,37505,40560,07/01/2019 12:00:00 AM,78,223,196
Piedmont,Craig County,51045,39,168,207,52,378,430,3480,37813,41293,08/01/2019 12:00:00 AM,89,225,199
Piedmont,Craig County,51045,39,171,210,48,360,408,9015,62581,71596,04/01/2020 12:00:00 AM,231,366,341
Piedmont,Craig County,51045,39,172,211,49,383,432,3426,38732,42158,06/01/2019 12:00:00 AM,88,225,200
Piedmont,Craig County,51045,39,186,225,48,422,470,3326,42486,45812,03/01/2019 12:00:00 AM,85,228,204
Piedmont,Craig County,51045,39,186,225,54,411,465,4639,40398,45037,08/01/2018 12:00:00 AM,119,217,200
Piedmont,Craig County,51045,40,157,197,52,322,374,10521,58651,69172,11/01/2020 12:00:00 AM,263,374,351
Piedmont,Craig County,51045,40,167,207,52,348,400,10176,63247,73423,10/01/2020 12:00:00 AM,254,379,355
Piedmont,Craig County,51045,40,174,214,49,366,415,9159,64429,73588,05/01/2020 12:00:00 AM,229,370,344
Piedmont,Craig County,51045,40,175,215,52,368,420,11907,80973,92880,01/01/2021 12:00:00 AM,298,463,432
Piedmont,Craig County,51045,40,175,215,53,393,446,3985,38436,42421,05/01/2019 12:00:00 AM,100,220,197
Piedmont,Craig County,51045,40,180,220,52,367,419,9654,64002,73656,09/01/2020 12:00:00 AM,241,356,335
Piedmont,Craig County,51045,40,188,228,51,402,453,11731,85236,96967,03/01/2021 12:00:00 AM,293,453,425
Piedmont,Craig County,51045,41,177,218,53,368,421,9829,61749,71578,08/01/2020 12:00:00 AM,240,349,328
Piedmont,Craig County,51045,41,180,221,53,378,431,9869,66628,76497,07/01/2020 12:00:00 AM,241,370,346
Piedmont,Craig County,51045,41,182,223,53,390,443,12872,87203,100075,06/01/2021 12:00:00 AM,314,479,449
Piedmont,Craig County,51045,41,186,227,53,396,449,12822,90717,103539,05/01/2021 12:00:00 AM,313,488,456
Piedmont,Craig County,51045,41,186,227,53,400,453,12363,91092,103455,04/01/2021 12:00:00 AM,302,490,456
Piedmont,Craig County,51045,41,190,231,56,422,478,4246,42128,46374,07/01/2018 12:00:00 AM,104,222,201
Piedmont,Craig County,51045,41,192,233,52,416,468,4310,42545,46855,04/01/2018 12:00:00 AM,105,222,201
Piedmont,Craig County,51045,42,188,230,51,419,470,3849,43094,46943,06/01/2018 12:00:00 AM,92,229,204
Piedmont,Craig County,51045,42,202,244,54,451,505,4330,47481,51811,03/01/2018 12:00:00 AM,103,235,212
Piedmont,Craig County,51045,43,177,220,53,376,429,10096,65582,75678,06/01/2020 12:00:00 AM,235,371,344
Piedmont,Craig County,51045,43,187,230,53,409,462,4516,42283,46799,05/01/2018 12:00:00 AM,105,226,203
Piedmont,Craig County,51045,43,223,266,60,525,585,4985,55820,60805,12/01/2016 12:00:00 AM,116,250,229
Piedmont,Craig County,51045,44,202,246,56,447,503,4997,45371,50368,02/01/2018 12:00:00 AM,114,225,205
Piedmont,Craig County,51045,44,212,256,61,503,564,6022,56200,62222,06/01/2017 12:00:00 AM,137,265,243
Piedmont,Craig County,51045,45,190,235,58,420,478,5165,45518,50683,01/01/2018 12:00:00 AM,115,240,216
Piedmont,Craig County,51045,45,221,266,58,536,594,5125,59468,64593,07/01/2017 12:00:00 AM,114,269,243
Piedmont,Craig County,51045,46,208,254,56,526,582,3790,56974,60764,01/01/2014 12:00:00 AM,82,274,239
Piedmont,Craig County,51045,46,208,254,61,468,529,6191,51865,58056,12/01/2017 12:00:00 AM,135,249,229
Piedmont,Craig County,51045,46,213,259,58,537,595,4198,56023,60221,02/01/2014 12:00:00 AM,91,263,233
Piedmont,Craig County,51045,46,215,261,61,483,544,5678,54995,60673,10/01/2017 12:00:00 AM,123,256,232
Piedmont,Craig County,51045,46,224,270,58,557,615,3938,60784,64722,03/01/2014 12:00:00 AM,86,271,240
Piedmont,Craig County,51045,47,205,252,60,513,573,4424,56058,60482,12/01/2013 12:00:00 AM,94,273,240
Piedmont,Craig County,51045,47,208,255,59,524,583,4161,55767,59928,11/01/2013 12:00:00 AM,89,268,235
Piedmont,Craig County,51045,47,208,255,65,503,568,5527,53597,59124,06/01/2016 12:00:00 AM,118,258,232
Piedmont,Craig County,51045,47,213,260,60,534,594,4265,58009,62274,04/01/2014 12:00:00 AM,91,272,240
Piedmont,Craig County,51045,47,213,260,65,494,559,6567,56847,63414,09/01/2017 12:00:00 AM,140,267,244
Piedmont,Craig County,51045,47,220,267,62,521,583,5850,59988,65838,08/01/2017 12:00:00 AM,124,273,247
Piedmont,Craig County,51045,47,222,269,73,533,606,6975,55456,62431,09/01/2015 12:00:00 AM,148,250,232
Piedmont,Craig County,51045,48,208,256,68,497,565,5918,52841,58759,07/01/2016 12:00:00 AM,123,254,230
Piedmont,Craig County,51045,48,213,261,61,534,595,4605,57993,62598,05/01/2014 12:00:00 AM,96,272,240
Piedmont,Craig County,51045,48,216,264,63,494,557,5570,53360,58930,02/01/2017 12:00:00 AM,116,247,223
Piedmont,Craig County,51045,48,220,268,78,522,600,7682,55097,62779,08/01/2015 12:00:00 AM,160,250,234
Piedmont,Craig County,51045,48,222,270,67,529,596,6475,58205,64680,04/01/2017 12:00:00 AM,135,262,240
Piedmont,Craig County,51045,49,201,250,66,452,518,6367,49323,55690,11/01/2017 12:00:00 AM,130,245,223
Piedmont,Craig County,51045,49,203,252,64,513,577,5626,59487,65113,10/01/2013 12:00:00 AM,115,293,258
Piedmont,Craig County,51045,49,209,258,68,505,573,5492,55018,60510,04/01/2016 12:00:00 AM,112,263,235
Piedmont,Craig County,51045,49,210,259,67,499,566,5469,55023,60492,05/01/2016 12:00:00 AM,112,262,234
Piedmont,Craig County,51045,49,212,261,70,518,588,6175,55218,61393,03/01/2016 12:00:00 AM,126,260,235
Piedmont,Craig County,51045,49,212,261,73,501,574,6671,53187,59858,11/01/2016 12:00:00 AM,136,251,229
Piedmont,Craig County,51045,49,222,271,66,534,600,6439,59311,65750,05/01/2017 12:00:00 AM,131,267,243
Piedmont,Craig County,51045,49,228,277,66,535,601,5322,56032,61354,01/01/2017 12:00:00 AM,109,246,221
Piedmont,Craig County,51045,50,207,257,67,520,587,5004,56425,61429,06/01/2014 12:00:00 AM,100,273,239
Piedmont,Craig County,51045,50,210,260,75,505,580,6973,54453,61426,10/01/2016 12:00:00 AM,139,259,236
Piedmont,Craig County,51045,50,213,263,73,525,598,6262,56341,62603,02/01/2016 12:00:00 AM,125,265,238
Piedmont,Craig County,51045,50,216,266,68,508,576,5755,57665,63420,03/01/2017 12:00:00 AM,115,267,238
Piedmont,Craig County,51045,50,216,266,70,530,600,5555,57895,63450,08/01/2014 12:00:00 AM,111,268,239
Piedmont,Craig County,51045,50,217,267,73,519,592,6730,55363,62093,08/01/2016 12:00:00 AM,135,255,233
Piedmont,Craig County,51045,50,218,268,81,523,604,8084,53709,61793,07/01/2015 12:00:00 AM,162,246,231
Piedmont,Craig County,51045,51,207,258,78,510,588,7343,50989,58332,05/01/2015 12:00:00 AM,144,246,226
Piedmont,Craig County,51045,51,213,264,68,530,598,5114,57898,63012,07/01/2014 12:00:00 AM,100,272,239
Piedmont,Craig County,51045,51,218,269,73,530,603,5862,57852,63714,09/01/2014 12:00:00 AM,115,265,237
Piedmont,Craig County,51045,52,201,253,79,474,553,7469,50145,57614,02/01/2015 12:00:00 AM,144,249,228
Piedmont,Craig County,51045,52,204,256,77,499,576,7303,56236,63539,12/01/2014 12:00:00 AM,140,276,248
Piedmont,Craig County,51045,52,207,259,84,504,588,8286,50286,58572,06/01/2015 12:00:00 AM,159,243,226
Piedmont,Craig County,51045,52,210,262,75,510,585,7091,57505,64596,10/01/2014 12:00:00 AM,136,274,247
Piedmont,Craig County,51045,52,211,263,73,512,585,6821,55737,62558,11/01/2014 12:00:00 AM,131,264,238
Piedmont,Craig County,51045,52,212,264,82,521,603,7904,54009,61913,01/01/2016 12:00:00 AM,152,255,235
Piedmont,Craig County,51045,52,214,266,75,510,585,6948,53448,60396,09/01/2016 12:00:00 AM,134,250,227
Piedmont,Craig County,51045,52,219,271,78,537,615,7243,55269,62512,10/01/2015 12:00:00 AM,139,252,231
Piedmont,Craig County,51045,53,195,248,62,470,532,4810,52085,56895,07/01/2013 12:00:00 AM,91,267,229
Piedmont,Craig County,51045,53,196,249,68,481,549,5761,56011,61772,09/01/2013 12:00:00 AM,109,286,248
Piedmont,Craig County,51045,53,202,255,61,489,550,4510,55454,59964,08/01/2013 12:00:00 AM,85,275,235
Piedmont,Craig County,51045,53,207,260,68,505,573,5828,57055,62883,04/01/2013 12:00:00 AM,110,276,242
Piedmont,Craig County,51045,53,208,261,87,515,602,8755,51866,60621,12/01/2015 12:00:00 AM,165,249,232
Piedmont,Craig County,51045,53,209,262,64,507,571,5142,57010,62152,05/01/2013 12:00:00 AM,97,273,237
Piedmont,Craig County,51045,54,209,263,76,512,588,6624,58035,64659,03/01/2013 12:00:00 AM,123,278,246
Piedmont,Craig County,51045,54,210,264,79,512,591,7075,56788,63863,02/01/2013 12:00:00 AM,131,270,242
Piedmont,Craig County,51045,54,213,267,81,513,594,7709,55101,62810,01/01/2015 12:00:00 AM,143,259,235
Piedmont,Craig County,51045,55,198,253,78,504,582,7190,59958,67148,04/01/2012 12:00:00 AM,131,303,265
Piedmont,Craig County,51045,55,198,253,78,508,586,7329,58278,65607,03/01/2012 12:00:00 AM,133,294,259
Piedmont,Craig County,51045,55,199,254,85,498,583,8460,53544,62004,09/01/2012 12:00:00 AM,154,269,244
Piedmont,Craig County,51045,55,203,258,87,498,585,8395,51912,60307,01/01/2013 12:00:00 AM,153,256,234
Piedmont,Craig County,51045,55,203,258,88,504,592,8764,53850,62614,11/01/2012 12:00:00 AM,159,265,243
Piedmont,Craig County,51045,55,206,261,67,494,561,5445,55943,61388,06/01/2013 12:00:00 AM,99,272,235
Piedmont,Craig County,51045,55,209,264,85,508,593,8187,49055,57242,04/01/2015 12:00:00 AM,149,235,217
Piedmont,Craig County,51045,55,212,267,83,513,596,7911,51024,58935,03/01/2015 12:00:00 AM,144,241,221
Piedmont,Craig County,51045,55,212,267,90,520,610,9182,54853,64035,11/01/2015 12:00:00 AM,167,259,240
Piedmont,Craig County,51045,56,207,263,87,511,598,8596,56263,64859,10/01/2012 12:00:00 AM,154,272,247
Piedmont,Craig County,51045,57,195,252,84,485,569,8572,59692,68264,07/01/2012 12:00:00 AM,150,306,271
Piedmont,Craig County,51045,57,202,259,79,503,582,7347,58431,65778,02/01/2012 12:00:00 AM,129,289,254
Piedmont,Craig County,51045,57,204,261,80,510,590,7845,57556,65401,01/01/2012 12:00:00 AM,138,282,251
Piedmont,Craig County,51045,57,205,262,92,509,601,9640,54327,63967,12/01/2012 12:00:00 AM,169,265,244
Piedmont,Craig County,51045,58,196,254,89,494,583,8754,56940,65694,06/01/2012 12:00:00 AM,151,291,259
Piedmont,Craig County,51045,58,201,259,87,505,592,8577,58267,66844,08/01/2012 12:00:00 AM,148,290,258
Piedmont,Craig County,51045,58,207,265,82,538,620,7488,63738,71226,05/01/2012 12:00:00 AM,129,308,269
Piedmont,Danville City,51590,1102,5115,6217,1450,10319,11769,132501,1283123,1415624,02/01/2017 12:00:00 AM,120,251,228
Piedmont,Danville City,51590,1140,5038,6178,1496,10128,11624,140272,1256304,1396576,03/01/2017 12:00:00 AM,123,249,226
Piedmont,Danville City,51590,1141,4646,5787,1537,9265,10802,143780,1142040,1285820,02/01/2019 12:00:00 AM,126,246,222
Piedmont,Danville City,51590,1144,4946,6090,1576,9763,11339,144886,1209744,1354630,05/01/2019 12:00:00 AM,127,245,222
Piedmont,Danville City,51590,1146,4863,6009,1562,9606,11168,142633,1190136.83,1332769.83,04/01/2019 12:00:00 AM,124,245,222
Piedmont,Danville City,51590,1146,4960,6106,1523,9973,11496,142751,1232907,1375658,04/01/2017 12:00:00 AM,125,249,225
Piedmont,Danville City,51590,1147,4920,6067,1580,9757,11337,144960,1210471,1355431,06/01/2019 12:00:00 AM,126,246,223
Piedmont,Danville City,51590,1150,4973,6123,1571,9863,11434,142080,1225643,1367723,07/01/2019 12:00:00 AM,124,246,223
Piedmont,Danville City,51590,1150,5183,6333,1510,10526,12036,135224,1280128,1415352,01/01/2017 12:00:00 AM,118,247,223
Piedmont,Danville City,51590,1152,4873,6025,1566,9696,11262,143875,1204474,1348349,03/01/2019 12:00:00 AM,125,247,224
Piedmont,Danville City,51590,1154,5007,6161,1553,10024,11577,144906,1257243,1402149,05/01/2017 12:00:00 AM,126,251,228
Piedmont,Danville City,51590,1163,4962,6125,1611,9893,11504,151856,1241269,1393125,08/01/2019 12:00:00 AM,131,250,227
Piedmont,Danville City,51590,1165,4927,6092,1621,9879,11500,155413,1232361,1387774,09/01/2018 12:00:00 AM,133,250,228
Piedmont,Danville City,51590,1166,4958,6124,1616,9808,11424,153833,1206271,1360104,11/01/2019 12:00:00 AM,132,243,222
Piedmont,Danville City,51590,1167,4767,5934,1582,9497,11079,154018,1209895,1363913,01/01/2019 12:00:00 AM,132,254,230
Piedmont,Danville City,51590,1167,4949,6116,1598,9790,11388,149504,1211978,1361482,09/01/2019 12:00:00 AM,128,245,223
Piedmont,Danville City,51590,1167,4950,6117,1611,9922,11533,204326,1587264.3,1791590.3,10/01/2018 12:00:00 AM,175,321,293
Piedmont,Danville City,51590,1167,5054,6221,1613,10062,11675,149725,1253387,1403112,06/01/2018 12:00:00 AM,128,248,226
Piedmont,Danville City,51590,1167,5137,6304,1565,10481,12046,144862,1270158,1415020,12/01/2016 12:00:00 AM,124,247,224
Piedmont,Danville City,51590,1169,5007,6176,1609,9951,11560,147333,1227770,1375103,01/01/2020 12:00:00 AM,126,245,223
Piedmont,Danville City,51590,1171,5067,6238,1621,10074,11695,149954,1248378.11,1398332.11,05/01/2018 12:00:00 AM,128,246,224
Piedmont,Danville City,51590,1174,4993,6167,1607,9920,11527,148267,1224273,1372540,02/01/2018 12:00:00 AM,126,245,223
Piedmont,Danville City,51590,1174,4996,6170,1602,9953,11555,147708,1223404.3,1371112.3,01/01/2018 12:00:00 AM,126,245,222
Piedmont,Danville City,51590,1175,4836,6011,1613,9701,11314,161302,1222871,1384173,12/01/2018 12:00:00 AM,137,253,230
Piedmont,Danville City,51590,1176,4838,6014,1624,9686,11310,159325,1214142,1373467,11/01/2018 12:00:00 AM,135,251,228
Piedmont,Danville City,51590,1176,4983,6159,1624,9868,11492,153619,1234909,1388528,10/01/2019 12:00:00 AM,131,248,225
Piedmont,Danville City,51590,1177,5008,6185,1627,10002,11629,151264,1245964,1397228,07/01/2018 12:00:00 AM,129,249,226
Piedmont,Danville City,51590,1177,5019,6196,1584,9989,11573,148627,1248349,1396976,07/01/2017 12:00:00 AM,126,249,225
Piedmont,Danville City,51590,1178,5045,6223,1630,10016,11646,150631,1238911,1389542,04/01/2018 12:00:00 AM,128,246,223
Piedmont,Danville City,51590,1178,5187,6365,1577,10605,12182,148066,1288068,1436134,11/01/2016 12:00:00 AM,126,248,226
Piedmont,Danville City,51590,1179,5016,6195,1591,10020,11611,150620,1259535,1410155,06/01/2017 12:00:00 AM,128,251,228
Piedmont,Danville City,51590,1179,5034,6213,1647,9975,11622,159057,1234727,1393784,12/01/2019 12:00:00 AM,135,245,224
Piedmont,Danville City,51590,1180,5013,6193,1651,9908,11559,155152,1221132,1376284,03/01/2018 12:00:00 AM,131,244,222
Piedmont,Danville City,51590,1181,4999,6180,1633,9863,11496,148846,1225231,1374077,02/01/2020 12:00:00 AM,126,245,222
Piedmont,Danville City,51590,1182,5017,6199,1652,10038,11690,155086,1250913,1405999,08/01/2018 12:00:00 AM,131,249,227
Piedmont,Danville City,51590,1187,5117,6304,1625,10034,11659,296431,1747564,2043995,03/01/2020 12:00:00 AM,250,342,324
Piedmont,Danville City,51590,1189,4984,6173,1632,9872,11504,154820,1215905,1370725,12/01/2017 12:00:00 AM,130,244,222
Piedmont,Danville City,51590,1194,5007,6201,1630,9912,11542,153746,1230318,1384064,11/01/2017 12:00:00 AM,129,246,223
Piedmont,Danville City,51590,1194,5052,6246,1614,10011,11625,150906,1262435,1413341,08/01/2017 12:00:00 AM,126,250,226
Piedmont,Danville City,51590,1195,5181,6376,1638,10628,12266,155082,1289859,1444941,10/01/2016 12:00:00 AM,130,249,227
Piedmont,Danville City,51590,1205,5056,6261,1646,10015,11661,153561,1253236,1406797,09/01/2017 12:00:00 AM,127,248,225
Piedmont,Danville City,51590,1205,5064,6269,1640,10067,11707,154086,1250736,1404822,10/01/2017 12:00:00 AM,128,247,224
Piedmont,Danville City,51590,1207,5319,6526,1669,10935,12604,158585,1383767,1542352,06/01/2016 12:00:00 AM,131,260,236
Piedmont,Danville City,51590,1209,5364,6573,1655,10524,12179,304078,1837988,2142066,04/01/2020 12:00:00 AM,252,343,326
Piedmont,Danville City,51590,1212,5283,6495,1681,10855,12536,160518,1333483,1494001,08/01/2016 12:00:00 AM,132,252,230
Piedmont,Danville City,51590,1213,5270,6483,1673,10792,12465,160356,1317759,1478115,09/01/2016 12:00:00 AM,132,250,228
Piedmont,Danville City,51590,1215,5325,6540,1683,10950,12633,159827,1375861,1535688,05/01/2016 12:00:00 AM,132,258,235
Piedmont,Danville City,51590,1220,5259,6479,1690,10841,12531,159697,1333973,1493670,07/01/2016 12:00:00 AM,131,254,231
Piedmont,Danville City,51590,1224,5294,6518,1720,10888,12608,164626,1334756,1499382,04/01/2016 12:00:00 AM,134,252,230
Piedmont,Danville City,51590,1225,5072,6297,1590,9964,11554,358909,2134569,2493478,02/01/2021 12:00:00 AM,293,421,396
Piedmont,Danville City,51590,1229,5494,6723,1682,10777,12459,307288,1870035,2177323,05/01/2020 12:00:00 AM,250,340,324
Piedmont,Danville City,51590,1240,5017,6257,1631,9857,11488,360804,2079302,2440106,03/01/2021 12:00:00 AM,291,414,390
Piedmont,Danville City,51590,1242,5559,6801,1701,10883,12584,312397,1894620,2207017,06/01/2020 12:00:00 AM,252,341,325
Piedmont,Danville City,51590,1248,4973,6221,1671,9646,11317,391305,2254863,2646168,05/01/2021 12:00:00 AM,314,453,425
Piedmont,Danville City,51590,1248,5269,6517,1787,10825,12612,172142,1317873,1490015,03/01/2016 12:00:00 AM,138,250,229
Piedmont,Danville City,51590,1252,4995,6247,1675,9727,11402,389059,2242691,2631750,04/01/2021 12:00:00 AM,311,449,421
Piedmont,Danville City,51590,1258,5524,6782,1726,10851,12577,316724,1895245,2211969,09/01/2020 12:00:00 AM,252,343,326
Piedmont,Danville City,51590,1260,4971,6231,1701,9636,11337,392662,2236047,2628709,06/01/2021 12:00:00 AM,312,450,422
Piedmont,Danville City,51590,1260,5347,6607,1813,10926,12739,176798,1337939,1514737,02/01/2016 12:00:00 AM,140,250,229
Piedmont,Danville City,51590,1260,5621,6881,1729,10985,12714,316137,1922120,2238257,07/01/2020 12:00:00 AM,251,342,325
Piedmont,Danville City,51590,1261,5721,6982,1858,11583,13441,186881,1438565,1625446,07/01/2015 12:00:00 AM,148,251,233
Piedmont,Danville City,51590,1262,5680,6942,1859,11487,13346,186286,1430866,1617152,06/01/2015 12:00:00 AM,148,252,233
Piedmont,Danville City,51590,1263,5225,6488,1718,10225,11943,336131,1899094,2235225,11/01/2020 12:00:00 AM,266,363,345
Piedmont,Danville City,51590,1264,5374,6638,1725,10535,12260,329333,1933608,2262941,10/01/2020 12:00:00 AM,261,360,341
Piedmont,Danville City,51590,1265,5151,6416,1715,10064,11779,328441,1855607,2184048,12/01/2020 12:00:00 AM,260,360,340
Piedmont,Danville City,51590,1269,5450,6719,1844,11062,12906,183369,1356541,1539910,12/01/2015 12:00:00 AM,144,249,229
Piedmont,Danville City,51590,1269,5557,6826,1738,10893,12631,318116,1892900,2211016,08/01/2020 12:00:00 AM,251,341,324
Piedmont,Danville City,51590,1270,5538,6808,1830,11228,13058,179579,1386580,1566159,11/01/2015 12:00:00 AM,141,250,230
Piedmont,Danville City,51590,1272,5362,6634,1851,10945,12796,180157,1341578,1521735,01/01/2016 12:00:00 AM,142,250,229
Piedmont,Danville City,51590,1277,5655,6932,1888,11418,13306,190022,1409255,1599277,04/01/2015 12:00:00 AM,149,249,231
Piedmont,Danville City,51590,1279,5612,6891,1864,11367,13231,184779,1406711,1591490,10/01/2015 12:00:00 AM,144,251,231
Piedmont,Danville City,51590,1281,5046,6327,1752,9861,11613,388086,2078763,2466849,01/01/2021 12:00:00 AM,303,412,390
Piedmont,Danville City,51590,1281,5586,6867,1902,11268,13170,190378,1382541,1572919,03/01/2015 12:00:00 AM,149,248,229
Piedmont,Danville City,51590,1282,5667,6949,1903,11440,13343,191628,1427782,1619410,05/01/2015 12:00:00 AM,149,252,233
Piedmont,Danville City,51590,1282,5922,7204,1958,11727,13685,191082,1424643,1615725,03/01/2014 12:00:00 AM,149,241,224
Piedmont,Danville City,51590,1285,5557,6842,1908,11215,13123,192255,1377152,1569407,02/01/2015 12:00:00 AM,150,248,229
Piedmont,Danville City,51590,1286,5699,6985,1904,11515,13419,191489,1434247,1625736,08/01/2015 12:00:00 AM,149,252,233
Piedmont,Danville City,51590,1287,5672,6959,1905,11457,13362,190457,1418045,1608502,09/01/2015 12:00:00 AM,148,250,231
Piedmont,Danville City,51590,1287,5837,7124,1962,11582,13544,189358,1418734,1608092,04/01/2014 12:00:00 AM,147,243,226
Piedmont,Danville City,51590,1288,5804,7092,1959,11573,13532,187049,1415128,1602177,05/01/2014 12:00:00 AM,145,244,226
Piedmont,Danville City,51590,1290,5591,6881,1919,11306,13225,196417,1397598,1594015,11/01/2014 12:00:00 AM,152,250,232
Piedmont,Danville City,51590,1290,6020,7310,1995,11984,13979,221081,1589704,1810785,08/01/2012 12:00:00 AM,171,264,248
Piedmont,Danville City,51590,1291,5987,7278,1984,11881,13865,209614,1573223,1782837,04/01/2013 12:00:00 AM,162,263,245
Piedmont,Danville City,51590,1294,5626,6920,1905,11358,13263,189162,1388871,1578033,01/01/2015 12:00:00 AM,146,247,228
Piedmont,Danville City,51590,1294,5896,7190,2045,11737,13782,225364,1563236,1788600,05/01/2012 12:00:00 AM,174,265,249
Piedmont,Danville City,51590,1294,6015,7309,2004,11918,13922,213388,1585038,1798426,05/01/2013 12:00:00 AM,165,264,246
Piedmont,Danville City,51590,1296,5946,7242,1991,11766,13757,211931,1557066,1768997,03/01/2013 12:00:00 AM,164,262,244
Piedmont,Danville City,51590,1297,5736,7033,1968,11483,13451,189813,1390513,1580326,06/01/2014 12:00:00 AM,146,242,225
Piedmont,Danville City,51590,1298,5669,6967,1951,11468,13419,186615,1380333,1566948,07/01/2014 12:00:00 AM,144,243,225
Piedmont,Danville City,51590,1299,5584,6883,1928,11288,13216,194527,1394846,1589373,12/01/2014 12:00:00 AM,150,250,231
Piedmont,Danville City,51590,1302,5839,7141,2029,11636,13665,223304,1533690,1756994,03/01/2012 12:00:00 AM,172,263,246
Piedmont,Danville City,51590,1303,5602,6905,1951,11381,13332,186274,1364802,1551076,08/01/2014 12:00:00 AM,143,244,225
Piedmont,Danville City,51590,1303,5915,7218,1990,11685,13675,194549,1427387,1621936,02/01/2014 12:00:00 AM,149,241,225
Piedmont,Danville City,51590,1305,5585,6890,1965,11280,13245,188609,1344985,1533594,09/01/2014 12:00:00 AM,145,241,223
Piedmont,Danville City,51590,1305,5874,7179,2057,11712,13769,226947,1553889,1780836,04/01/2012 12:00:00 AM,174,265,248
Piedmont,Danville City,51590,1305,5985,7290,2008,11894,13902,223297,1579882,1803179,10/01/2012 12:00:00 AM,171,264,247
Piedmont,Danville City,51590,1305,6002,7307,2040,11967,14007,227301,1593959,1821260,09/01/2012 12:00:00 AM,174,266,249
Piedmont,Danville City,51590,1309,5926,7235,2062,11780,13842,226751,1567212,1793963,06/01/2012 12:00:00 AM,173,264,248
Piedmont,Danville City,51590,1309,5947,7256,2049,11847,13896,224607,1572949,1797556,07/01/2012 12:00:00 AM,172,264,248
Piedmont,Danville City,51590,1312,5774,7086,2078,11523,13601,230060,1521078,1751138,02/01/2012 12:00:00 AM,175,263,247
Piedmont,Danville City,51590,1313,5821,7134,2052,11582,13634,227092,1522894,1749986,01/01/2012 12:00:00 AM,173,262,245
Piedmont,Danville City,51590,1314,5943,7257,2019,11732,13751,196470,1416773,1613243,01/01/2014 12:00:00 AM,150,238,222
Piedmont,Danville City,51590,1315,5967,7282,2059,11880,13939,229775,1570825,1800600,11/01/2012 12:00:00 AM,175,263,247
Piedmont,Danville City,51590,1317,5994,7311,1997,11816,13813,197131,1442234,1639365,11/01/2013 12:00:00 AM,150,241,224
Piedmont,Danville City,51590,1317,6072,7389,2030,11949,13979,214382,1596436,1810818,07/01/2013 12:00:00 AM,163,263,245
Piedmont,Danville City,51590,1321,6018,7339,2064,11936,14000,220301,1584163,1804464,06/01/2013 12:00:00 AM,167,263,246
Piedmont,Danville City,51590,1322,5933,7255,2057,11804,13861,222922,1548097,1771019,01/01/2013 12:00:00 AM,169,261,244
Piedmont,Danville City,51590,1324,5906,7230,2086,11725,13811,232193,1551443,1783636,12/01/2012 12:00:00 AM,175,263,247
Piedmont,Danville City,51590,1325,5940,7265,2088,11756,13844,225462,1556441,1781903,02/01/2013 12:00:00 AM,170,262,245
Piedmont,Danville City,51590,1326,5596,6922,1998,11294,13292,205608,1405152,1610760,10/01/2014 12:00:00 AM,155,251,233
Piedmont,Danville City,51590,1332,6019,7351,2047,11862,13909,223683,1562222,1785905,10/01/2013 12:00:00 AM,168,260,243
Piedmont,Danville City,51590,1333,5925,7258,2051,11673,13724,202893,1415650,1618543,12/01/2013 12:00:00 AM,152,239,223
Piedmont,Danville City,51590,1354,6090,7444,2097,11988,14085,224568,1598450,1823018,08/01/2013 12:00:00 AM,166,262,245
Piedmont,Danville City,51590,1356,6054,7410,2097,11911,14008,226588,1582941,1809529,09/01/2013 12:00:00 AM,167,261,244
Piedmont,Franklin County,51067,428,2425,2853,547,5506,6053,129043,1232437,1361480,05/01/2021 12:00:00 AM,302,508,477
Piedmont,Franklin County,51067,431,2441,2872,551,5541,6092,127315,1231607,1358922,04/01/2021 12:00:00 AM,295,505,473
Piedmont,Franklin County,51067,432,2409,2841,557,5450,6007,131646,1214919,1346565,06/01/2021 12:00:00 AM,305,504,474
Piedmont,Franklin County,51067,435,2469,2904,552,5592,6144,123599,1180005,1303604,02/01/2021 12:00:00 AM,284,478,449
Piedmont,Franklin County,51067,441,2440,2881,566,5536,6102,126749,1151702,1278451,03/01/2021 12:00:00 AM,287,472,444
Piedmont,Franklin County,51067,445,2444,2889,575,5539,6114,130371,1142000,1272371,01/01/2021 12:00:00 AM,293,467,440
Piedmont,Franklin County,51067,446,2195,2641,586,4986,5572,54888,563190,618078,09/01/2019 12:00:00 AM,123,257,234
Piedmont,Franklin County,51067,447,2217,2664,597,4989,5586,59597,569802,629399,10/01/2019 12:00:00 AM,133,257,236
Piedmont,Franklin County,51067,449,2206,2655,597,4963,5560,56272,557234,613506,11/01/2019 12:00:00 AM,125,253,231
Piedmont,Franklin County,51067,450,2146,2596,596,4861,5457,55145,550818,605963,01/01/2020 12:00:00 AM,123,257,233
Piedmont,Franklin County,51067,455,2146,2601,605,4888,5493,55325,556221,611546,02/01/2020 12:00:00 AM,122,259,235
Piedmont,Franklin County,51067,455,2199,2654,608,4966,5574,111880,846413,958293,03/01/2020 12:00:00 AM,246,385,361
Piedmont,Franklin County,51067,456,2184,2640,606,4958,5564,56955,564475.75,621430.75,08/01/2019 12:00:00 AM,125,258,235
Piedmont,Franklin County,51067,456,2200,2656,611,4972,5583,59796,570492,630288,12/01/2019 12:00:00 AM,131,259,237
Piedmont,Franklin County,51067,457,2453,2910,597,5601,6198,117062,1022292,1139354,11/01/2020 12:00:00 AM,256,417,392
Piedmont,Franklin County,51067,457,2464,2921,602,5617,6219,116348,1022302,1138650,12/01/2020 12:00:00 AM,255,415,390
Piedmont,Franklin County,51067,458,2189,2647,615,4972,5587,57952,570196,628148,07/01/2019 12:00:00 AM,127,260,237
Piedmont,Franklin County,51067,458,2362,2820,604,5320,5924,111016,909672,1020688,04/01/2020 12:00:00 AM,242,385,362
Piedmont,Franklin County,51067,460,2190,2650,606,4952,5558,56469,572067,628536,06/01/2019 12:00:00 AM,123,261,237
Piedmont,Franklin County,51067,462,2481,2943,604,5627,6231,118473,1012221,1130694,10/01/2020 12:00:00 AM,256,408,384
Piedmont,Franklin County,51067,463,2439,2902,608,5463,6071,112221,938736,1050957,05/01/2020 12:00:00 AM,242,385,362
Piedmont,Franklin County,51067,466,2493,2959,610,5579,6189,111999,959157,1071156,06/01/2020 12:00:00 AM,240,385,362
Piedmont,Franklin County,51067,467,2200,2667,619,4958,5577,58565,561781,620346,03/01/2019 12:00:00 AM,125,255,233
Piedmont,Franklin County,51067,467,2529,2996,617,5699,6316,114791,972673.47,1087464.47,08/01/2020 12:00:00 AM,246,385,363
Piedmont,Franklin County,51067,468,2127,2595,625,4790,5415,62637,540294,602931,02/01/2019 12:00:00 AM,134,254,232
Piedmont,Franklin County,51067,469,2210,2679,625,4981,5606,58760,568831,627591,05/01/2019 12:00:00 AM,125,257,234
Piedmont,Franklin County,51067,470,2188,2658,627,4947,5574,59267,562694,621961,04/01/2019 12:00:00 AM,126,257,234
Piedmont,Franklin County,51067,472,2478,2950,623,5640,6263,116172,969601,1085773,09/01/2020 12:00:00 AM,246,391,368
Piedmont,Franklin County,51067,472,2540,3012,622,5728,6350,114413,990412,1104825,07/01/2020 12:00:00 AM,242,390,367
Piedmont,Franklin County,51067,476,2477,2953,632,5817,6449,61095,689224,750319,03/01/2017 12:00:00 AM,128,278,254
Piedmont,Franklin County,51067,479,2214,2693,641,5043,5684,62964,601922,664886,01/01/2019 12:00:00 AM,131,272,247
Piedmont,Franklin County,51067,482,2438,2920,646,5776,6422,61420,680571,741991,04/01/2017 12:00:00 AM,127,279,254
Piedmont,Franklin County,51067,484,2425,2909,648,5734,6382,60265,671703,731968,05/01/2017 12:00:00 AM,125,277,252
Piedmont,Franklin County,51067,485,2206,2691,648,5014,5662,63256,572984,636240,12/01/2018 12:00:00 AM,130,260,236
Piedmont,Franklin County,51067,485,2519,3004,638,5983,6621,60468,693343,753811,12/01/2016 12:00:00 AM,125,275,251
Piedmont,Franklin County,51067,487,2565,3052,634,6054,6688,59591,700274,759865,02/01/2017 12:00:00 AM,122,273,249
Piedmont,Franklin County,51067,488,2437,2925,639,5778,6417,60312,678133,738445,06/01/2017 12:00:00 AM,124,278,252
Piedmont,Franklin County,51067,489,2281,2770,641,5294,5935,59213,615951,675164,06/01/2018 12:00:00 AM,121,270,244
Piedmont,Franklin County,51067,489,2388,2877,649,5633,6282,63339,657275.95,720614.95,07/01/2017 12:00:00 AM,130,275,250
Piedmont,Franklin County,51067,490,2217,2707,660,5025,5685,63779,585643,649422,11/01/2018 12:00:00 AM,130,264,240
Piedmont,Franklin County,51067,490,2301,2791,641,5360,6001,59562,616541,676103,05/01/2018 12:00:00 AM,122,268,242
Piedmont,Franklin County,51067,490,2534,3024,642,6010,6652,60589,701695,762284,01/01/2017 12:00:00 AM,124,277,252
Piedmont,Franklin County,51067,491,2288,2779,631,5322,5953,57617.11,617232,674849.11,03/01/2018 12:00:00 AM,117,270,243
Piedmont,Franklin County,51067,491,2431,2922,642,5671,6313,61834,665317,727151,08/01/2017 12:00:00 AM,126,274,249
Piedmont,Franklin County,51067,492,2232,2724,669,5084,5753,64364,591032,655396,10/01/2018 12:00:00 AM,131,265,241
Piedmont,Franklin County,51067,492,2343,2835,639,5487,6126,63446,633769,697215,10/01/2017 12:00:00 AM,129,270,246
Piedmont,Franklin County,51067,495,2239,2734,671,5147,5818,62816,594968,657784,09/01/2018 12:00:00 AM,127,266,241
Piedmont,Franklin County,51067,497,2245,2742,665,5158,5823,63122,598405,661527,07/01/2018 12:00:00 AM,127,267,241
Piedmont,Franklin County,51067,498,2301,2799,649,5329,5978,60060,615191,675251,04/01/2018 12:00:00 AM,121,267,241
Piedmont,Franklin County,51067,499,2239,2738,675,5134,5809,64976,592322,657298,08/01/2018 12:00:00 AM,130,265,240
Piedmont,Franklin County,51067,499,2314,2813,647,5431,6078,61874,617271,679145,12/01/2017 12:00:00 AM,124,267,241
Piedmont,Franklin County,51067,499,2384,2883,655,5610,6265,64402,650335,714737,09/01/2017 12:00:00 AM,129,273,248
Piedmont,Franklin County,51067,499,2549,3048,674,6062,6736,65085,697319,762404,06/01/2016 12:00:00 AM,130,274,250
Piedmont,Franklin County,51067,501,2321,2822,650,5468,6118,63287,626572,689859,11/01/2017 12:00:00 AM,126,270,244
Piedmont,Franklin County,51067,504,2597,3101,695,6164,6859,68156,696841,764997,04/01/2016 12:00:00 AM,135,268,247
Piedmont,Franklin County,51067,504,2677,3181,714,6362,7076,70577,723535,794112,01/01/2016 12:00:00 AM,140,270,250
Piedmont,Franklin County,51067,504,2751,3255,724,6421,7145,73513,746594,820107,05/01/2015 12:00:00 AM,146,271,252
Piedmont,Franklin County,51067,505,2248,2753,656,5197,5853,61417,599433,660850,02/01/2018 12:00:00 AM,122,267,240
Piedmont,Franklin County,51067,505,2528,3033,688,5997,6685,67320,697160,764480,07/01/2016 12:00:00 AM,133,276,252
Piedmont,Franklin County,51067,505,2564,3069,687,6090,6777,67146,692727,759873,05/01/2016 12:00:00 AM,133,270,248
Piedmont,Franklin County,51067,505,2638,3143,706,6273,6979,68962,717827,786789,03/01/2016 12:00:00 AM,137,272,250
Piedmont,Franklin County,51067,505,2654,3159,704,6325,7029,67634,723265,790899,02/01/2016 12:00:00 AM,134,273,250
Piedmont,Franklin County,51067,505,2767,3272,731,6461,7192,73727,749298,823025,06/01/2015 12:00:00 AM,146,271,252
Piedmont,Franklin County,51067,506,2297,2803,664,5366,6030,60954,628608,689562,01/01/2018 12:00:00 AM,120,274,246
Piedmont,Franklin County,51067,506,2507,3013,690,5937,6627,66957,682069,749026,09/01/2016 12:00:00 AM,132,272,249
Piedmont,Franklin County,51067,506,2510,3016,685,5954,6639,65377,694986,760363,11/01/2016 12:00:00 AM,129,277,252
Piedmont,Franklin County,51067,508,2720,3228,733,6427,7160,73077,738141,811218,12/01/2015 12:00:00 AM,144,271,251
Piedmont,Franklin County,51067,509,2525,3034,703,5993,6696,66825,691283,758108,10/01/2016 12:00:00 AM,131,274,250
Piedmont,Franklin County,51067,513,2727,3240,756,6417,7173,76919,741001,817920,11/01/2015 12:00:00 AM,150,272,252
Piedmont,Franklin County,51067,513,2730,3243,753,6426,7179,76212,745088,821300,10/01/2015 12:00:00 AM,149,273,253
Piedmont,Franklin County,51067,515,3030,3545,731,6990,7721,69390,796212,865602,08/01/2014 12:00:00 AM,135,263,244
Piedmont,Franklin County,51067,516,2515,3031,711,6002,6713,70735,696486,767221,08/01/2016 12:00:00 AM,137,277,253
Piedmont,Franklin County,51067,516,2799,3315,748,6521,7269,78799,761660,840459,04/01/2015 12:00:00 AM,153,272,254
Piedmont,Franklin County,51067,518,3009,3527,739,6937,7676,69248,786474,855722,09/01/2014 12:00:00 AM,134,261,243
Piedmont,Franklin County,51067,519,2738,3257,770,6416,7186,78910,741630,820540,08/01/2015 12:00:00 AM,152,271,252
Piedmont,Franklin County,51067,520,2750,3270,769,6406,7175,77473,738527,816000,07/01/2015 12:00:00 AM,149,269,250
Piedmont,Franklin County,51067,521,2797,3318,767,6508,7275,81817,760297,842114,03/01/2015 12:00:00 AM,157,272,254
Piedmont,Franklin County,51067,521,2833,3354,765,6597,7362,79122,770475,849597,02/01/2015 12:00:00 AM,152,272,253
Piedmont,Franklin County,51067,522,2905,3427,777,6727,7504,81418,779859,861277,01/01/2015 12:00:00 AM,156,268,251
Piedmont,Franklin County,51067,522,2978,3500,760,6815,7575,80159,807433,887592,10/01/2014 12:00:00 AM,154,271,254
Piedmont,Franklin County,51067,523,2731,3254,761,6409,7170,77697,747511,825208,09/01/2015 12:00:00 AM,149,274,254
Piedmont,Franklin County,51067,524,2962,3486,766,6799,7565,80917,808161,889078,11/01/2014 12:00:00 AM,154,273,255
Piedmont,Franklin County,51067,529,2981,3510,787,6840,7627,84136,810122,894258,12/01/2014 12:00:00 AM,159,272,255
Piedmont,Franklin County,51067,529,3060,3589,765,7036,7801,70812,801673,872485,07/01/2014 12:00:00 AM,134,262,243
Piedmont,Franklin County,51067,535,3323,3858,802,7495,8297,87989,941799,1029788,10/01/2013 12:00:00 AM,164,283,267
Piedmont,Franklin County,51067,537,3118,3655,783,7118,7901,73947,822971,896918,06/01/2014 12:00:00 AM,138,264,245
Piedmont,Franklin County,51067,537,3320,3857,806,7483,8289,81038,864704,945742,11/01/2013 12:00:00 AM,151,260,245
Piedmont,Franklin County,51067,544,3220,3764,823,7218,8041,82602,831856,914458,02/01/2014 12:00:00 AM,152,258,243
Piedmont,Franklin County,51067,544,3343,3887,827,7575,8402,89892,950793,1040685,09/01/2013 12:00:00 AM,165,284,268
Piedmont,Franklin County,51067,546,3154,3700,810,7162,7972,77337,829103,906440,05/01/2014 12:00:00 AM,142,263,245
Piedmont,Franklin County,51067,548,3192,3740,817,7204,8021,77774,826119,903893,04/01/2014 12:00:00 AM,142,259,242
Piedmont,Franklin County,51067,548,3199,3747,831,7168,7999,82764,819684,902448,03/01/2014 12:00:00 AM,151,256,241
Piedmont,Franklin County,51067,548,3352,3900,860,7673,8533,93514,957060,1050574,01/01/2013 12:00:00 AM,171,286,269
Piedmont,Franklin County,51067,549,3350,3899,849,7636,8485,93509,963960,1057469,03/01/2013 12:00:00 AM,170,288,271
Piedmont,Franklin County,51067,549,3359,3908,851,7590,8441,92366,948604,1040970,08/01/2013 12:00:00 AM,168,282,266
Piedmont,Franklin County,51067,551,3236,3787,836,7251,8087,83348,825567,908915,01/01/2014 12:00:00 AM,151,255,240
Piedmont,Franklin County,51067,552,3267,3819,831,7375,8206,84701,847973,932674,12/01/2013 12:00:00 AM,153,260,244
Piedmont,Franklin County,51067,553,3381,3934,871,7721,8592,96697,967517,1064214,02/01/2013 12:00:00 AM,175,286,271
Piedmont,Franklin County,51067,555,3353,3908,862,7665,8527,98003,959678,1057681,05/01/2013 12:00:00 AM,177,286,271
Piedmont,Franklin County,51067,557,3353,3910,886,7579,8465,100372,955336,1055708,07/01/2013 12:00:00 AM,180,285,270
Piedmont,Franklin County,51067,560,3292,3852,929,7567,8496,108722,955824,1064546,08/01/2012 12:00:00 AM,194,290,276
Piedmont,Franklin County,51067,560,3327,3887,872,7591,8463,96285,955134,1051419,04/01/2013 12:00:00 AM,172,287,270
Piedmont,Franklin County,51067,561,3255,3816,928,7533,8461,111353,959756,1071109,07/01/2012 12:00:00 AM,198,295,281
Piedmont,Franklin County,51067,564,3344,3908,885,7602,8487,101080,964877,1065957,06/01/2013 12:00:00 AM,179,289,273
Piedmont,Franklin County,51067,565,3327,3892,908,7619,8527,103246,960128,1063374,12/01/2012 12:00:00 AM,183,289,273
Piedmont,Franklin County,51067,569,3234,3803,949,7435,8384,110272,934782,1045054,06/01/2012 12:00:00 AM,194,289,275
Piedmont,Franklin County,51067,569,3312,3881,914,7578,8492,105131,951857,1056988,10/01/2012 12:00:00 AM,185,287,272
Piedmont,Franklin County,51067,572,3251,3823,950,7474,8424,112639,942154,1054793,04/01/2012 12:00:00 AM,197,290,276
Piedmont,Franklin County,51067,573,3211,3784,956,7398,8354,112391,932819,1045210,05/01/2012 12:00:00 AM,196,291,276
Piedmont,Franklin County,51067,574,3274,3848,940,7508,8448,108698,942580,1051278,09/01/2012 12:00:00 AM,189,288,273
Piedmont,Franklin County,51067,575,3295,3870,961,7567,8528,114824,949199,1064023,03/01/2012 12:00:00 AM,200,288,275
Piedmont,Franklin County,51067,579,3340,3919,938,7662,8600,106240,963101,1069341,11/01/2012 12:00:00 AM,183,288,273
Piedmont,Franklin County,51067,592,3306,3898,1008,7583,8591,117319,953369,1070688,02/01/2012 12:00:00 AM,198,288,275
Piedmont,Franklin County,51067,602,3314,3916,1010,7607,8617,117144,943460,1060604,01/01/2012 12:00:00 AM,195,285,271
Piedmont,Halifax County,51083,613,2356,2969,806,4908,5714,73832,583523,657355,12/01/2019 12:00:00 AM,120,248,221
Piedmont,Halifax County,51083,614,2349,2963,793,4915,5708,70564,574948,645512,11/01/2019 12:00:00 AM,115,245,218
Piedmont,Halifax County,51083,615,2320,2935,806,4797,5603,72234,561857,634091,01/01/2020 12:00:00 AM,117,242,216
Piedmont,Halifax County,51083,617,2303,2920,811,4800,5611,70807,561104,631911,06/01/2019 12:00:00 AM,115,244,216
Piedmont,Halifax County,51083,617,2332,2949,809,4841,5650,71648,565626,637274,02/01/2020 12:00:00 AM,116,243,216
Piedmont,Halifax County,51083,618,2196,2814,811,4538,5349,71299,533605,604904,02/01/2019 12:00:00 AM,115,243,215
Piedmont,Halifax County,51083,618,2328,2946,806,4852,5658,148289,837844,986133,03/01/2020 12:00:00 AM,240,360,335
Piedmont,Halifax County,51083,618,2428,3046,754,5060,5814,179315,1096771,1276086,02/01/2021 12:00:00 AM,290,452,419
Piedmont,Halifax County,51083,619,2300,2919,813,4793,5606,70389,559086,629475,04/01/2019 12:00:00 AM,114,243,216
Piedmont,Halifax County,51083,620,2382,3002,816,4948,5764,72856,592603,665459,10/01/2019 12:00:00 AM,118,249,222
Piedmont,Halifax County,51083,620,2468,3088,805,5104,5909,147919,886583,1034502,04/01/2020 12:00:00 AM,239,359,335
Piedmont,Halifax County,51083,621,2276,2897,820,4707,5527,72685,551188,623873,05/01/2019 12:00:00 AM,117,242,215
Piedmont,Halifax County,51083,621,2532,3153,792,5250,6042,146767,908894,1055661,05/01/2020 12:00:00 AM,236,359,335
Piedmont,Halifax County,51083,622,2369,2991,822,4992,5814,72389,585286,657675,08/01/2019 12:00:00 AM,116,247,220
Piedmont,Halifax County,51083,623,2287,2910,808,4760,5568,72211,549913,622124,03/01/2019 12:00:00 AM,116,240,214
Piedmont,Halifax County,51083,625,2365,2990,825,4941,5766,70397,579346,649743,09/01/2019 12:00:00 AM,113,245,217
Piedmont,Halifax County,51083,626,2340,2966,834,4870,5704,73580,572960,646540,07/01/2019 12:00:00 AM,118,245,218
Piedmont,Halifax County,51083,626,2448,3074,767,5069,5836,175193,1079880,1255073,03/01/2021 12:00:00 AM,280,441,408
Piedmont,Halifax County,51083,627,2550,3177,799,5253,6052,149150,918711,1067861,06/01/2020 12:00:00 AM,238,360,336
Piedmont,Halifax County,51083,628,2296,2924,816,4858,5674,74726,575472,650198,12/01/2018 12:00:00 AM,119,251,222
Piedmont,Halifax County,51083,630,2288,2918,811,4847,5658,73378,573187,646565,11/01/2018 12:00:00 AM,116,251,222
Piedmont,Halifax County,51083,631,2442,3073,800,5025,5825,156407,932472,1088879,12/01/2020 12:00:00 AM,248,382,354
Piedmont,Halifax County,51083,632,2325,2957,817,4871,5688,72108,594575,666683,01/01/2019 12:00:00 AM,114,256,225
Piedmont,Halifax County,51083,634,2394,3028,808,4963,5771,178933,1029098,1208031,01/01/2021 12:00:00 AM,282,430,399
Piedmont,Halifax County,51083,634,2426,3060,785,4994,5779,184118,1132574,1316692,04/01/2021 12:00:00 AM,290,467,430
Piedmont,Halifax County,51083,636,2488,3124,811,5075,5886,158058,944947,1103005,11/01/2020 12:00:00 AM,249,380,353
Piedmont,Halifax County,51083,636,2595,3231,814,5347,6161,150466,929672,1080138,08/01/2020 12:00:00 AM,237,358,334
Piedmont,Halifax County,51083,638,2296,2934,819,4903,5722,80573,649970.62,730543.62,10/01/2018 12:00:00 AM,126,283,249
Piedmont,Halifax County,51083,638,2595,3233,818,5363,6181,151376,927297,1078673,07/01/2020 12:00:00 AM,237,357,334
Piedmont,Halifax County,51083,639,2405,3044,803,4922,5725,188849,1120299,1309148,06/01/2021 12:00:00 AM,296,466,430
Piedmont,Halifax County,51083,640,2393,3033,791,4896,5687,187020,1125289,1312309,05/01/2021 12:00:00 AM,292,470,433
Piedmont,Halifax County,51083,641,2284,2925,820,4922,5742,71144,576917,648061,08/01/2018 12:00:00 AM,111,253,222
Piedmont,Halifax County,51083,641,2545,3186,814,5211,6025,160447,950022,1110469,10/01/2020 12:00:00 AM,250,373,349
Piedmont,Halifax County,51083,642,2272,2914,820,4900,5720,71382,574857,646239,06/01/2018 12:00:00 AM,111,253,222
Piedmont,Halifax County,51083,644,2292,2936,840,4934,5774,74234,582905,657139,09/01/2018 12:00:00 AM,115,254,224
Piedmont,Halifax County,51083,644,2307,2951,823,4983,5806,71656,589782,661438,07/01/2018 12:00:00 AM,111,256,224
Piedmont,Halifax County,51083,644,2307,2951,829,5021,5850,72759,592444,665203,04/01/2018 12:00:00 AM,113,257,225
Piedmont,Halifax County,51083,644,2581,3225,824,5319,6143,152640,925229,1077869,09/01/2020 12:00:00 AM,237,358,334
Piedmont,Halifax County,51083,646,2293,2939,823,4988,5811,71120,587110,658230,05/01/2018 12:00:00 AM,110,256,224
Piedmont,Halifax County,51083,648,2449,3097,812,5240,6052,71008,620666,691674,04/01/2017 12:00:00 AM,110,253,223
Piedmont,Halifax County,51083,649,2368,3017,820,5135,5955,74592,613080,687672,10/01/2017 12:00:00 AM,115,259,228
Piedmont,Halifax County,51083,650,2310,2960,845,4994,5839,74287,582217,656504,03/01/2018 12:00:00 AM,114,252,222
Piedmont,Halifax County,51083,651,2473,3124,803,5296,6099,70592,631419,702011,02/01/2017 12:00:00 AM,108,255,225
Piedmont,Halifax County,51083,654,2380,3034,826,5156,5982,75698,613761,689459,11/01/2017 12:00:00 AM,116,258,227
Piedmont,Halifax County,51083,654,2458,3112,816,5302,6118,73029,631754,704783,03/01/2017 12:00:00 AM,112,257,226
Piedmont,Halifax County,51083,658,2387,3045,828,5135,5963,75377,611477,686854,09/01/2017 12:00:00 AM,115,256,226
Piedmont,Halifax County,51083,658,2543,3201,819,5469,6288,69260,639827,709087,12/01/2016 12:00:00 AM,105,252,222
Piedmont,Halifax County,51083,659,2319,2978,857,5028,5885,76894,592446,669340,02/01/2018 12:00:00 AM,117,255,225
Piedmont,Halifax County,51083,659,2353,3012,841,5106,5947,78822,600827,679649,12/01/2017 12:00:00 AM,120,255,226
Piedmont,Halifax County,51083,659,2545,3204,811,5525,6336,67186,646138,713324,01/01/2017 12:00:00 AM,102,254,223
Piedmont,Halifax County,51083,660,2456,3116,831,5269,6100,74472,628036,702508,05/01/2017 12:00:00 AM,113,256,225
Piedmont,Halifax County,51083,661,2412,3073,824,5187,6011,74996,618198,693194,08/01/2017 12:00:00 AM,113,256,226
Piedmont,Halifax County,51083,662,2361,3023,860,5148,6008,78187,608704,686891,01/01/2018 12:00:00 AM,118,258,227
Piedmont,Halifax County,51083,663,2418,3081,838,5191,6029,75410,619719,695129,06/01/2017 12:00:00 AM,114,256,226
Piedmont,Halifax County,51083,663,2563,3226,833,5537,6370,71412,650315,721727,11/01/2016 12:00:00 AM,108,254,224
Piedmont,Halifax County,51083,667,2405,3072,837,5190,6027,74665,617775,692440,07/01/2017 12:00:00 AM,112,257,225
Piedmont,Halifax County,51083,669,2551,3220,846,5508,6354,73202,646049,719251,10/01/2016 12:00:00 AM,109,253,223
Piedmont,Halifax County,51083,677,2609,3286,846,5664,6510,74145,657459,731604,08/01/2016 12:00:00 AM,110,252,223
Piedmont,Halifax County,51083,677,2657,3334,842,5803,6645,73399,681760,755159,05/01/2016 12:00:00 AM,108,257,227
Piedmont,Halifax County,51083,678,2591,3269,851,5607,6458,74129,656231,730360,09/01/2016 12:00:00 AM,109,253,223
Piedmont,Halifax County,51083,679,2593,3272,853,5636,6489,74510,653107,727617,07/01/2016 12:00:00 AM,110,252,222
Piedmont,Halifax County,51083,680,2704,3384,883,5898,6781,76672,678153,754825,12/01/2015 12:00:00 AM,113,251,223
Piedmont,Halifax County,51083,681,2618,3299,856,5698,6554,74948,678849,753797,06/01/2016 12:00:00 AM,110,259,228
Piedmont,Halifax County,51083,681,2679,3360,861,5823,6684,73899,673422,747321,04/01/2016 12:00:00 AM,109,251,222
Piedmont,Halifax County,51083,682,2696,3378,896,5843,6739,77398,675444,752842,09/01/2015 12:00:00 AM,113,251,223
Piedmont,Halifax County,51083,685,2694,3379,862,5890,6752,72877,680605,753482,03/01/2016 12:00:00 AM,106,253,223
Piedmont,Halifax County,51083,685,2698,3383,895,5866,6761,80193,674596,754789,11/01/2015 12:00:00 AM,117,250,223
Piedmont,Halifax County,51083,685,2707,3392,884,5896,6780,76551,677863,754414,01/01/2016 12:00:00 AM,112,250,222
Piedmont,Halifax County,51083,687,2715,3402,904,5900,6804,81341,677253,758594,10/01/2015 12:00:00 AM,118,249,223
Piedmont,Halifax County,51083,690,2708,3398,889,5918,6807,77260,684927,762187,02/01/2016 12:00:00 AM,112,253,224
Piedmont,Halifax County,51083,693,2691,3384,916,5846,6762,80300,673613,753913,06/01/2015 12:00:00 AM,116,250,223
Piedmont,Halifax County,51083,695,2707,3402,928,5862,6790,80353,681661,762014,08/01/2015 12:00:00 AM,116,252,224
Piedmont,Halifax County,51083,700,2685,3385,938,5855,6793,84082,675260,759342,03/01/2015 12:00:00 AM,120,251,224
Piedmont,Halifax County,51083,700,2689,3389,940,5887,6827,83404,678817,762221,04/01/2015 12:00:00 AM,119,252,225
Piedmont,Halifax County,51083,702,2663,3365,945,5812,6757,85263,668128,753391,05/01/2015 12:00:00 AM,121,251,224
Piedmont,Halifax County,51083,704,2716,3420,955,5907,6862,83120,662290,745410,07/01/2014 12:00:00 AM,118,244,218
Piedmont,Halifax County,51083,706,2684,3390,957,5880,6837,81542,660998,742540,08/01/2014 12:00:00 AM,115,246,219
Piedmont,Halifax County,51083,706,2761,3467,984,5963,6947,85975,668826,754801,06/01/2014 12:00:00 AM,122,242,218
Piedmont,Halifax County,51083,706,2777,3483,975,5953,6928,85888,670805,756693,05/01/2014 12:00:00 AM,122,242,217
Piedmont,Halifax County,51083,707,2676,3383,950,5835,6785,84347,678735,763082,02/01/2015 12:00:00 AM,119,254,226
Piedmont,Halifax County,51083,707,2705,3412,951,5846,6797,84289,672845,757134,07/01/2015 12:00:00 AM,119,249,222
Piedmont,Halifax County,51083,709,2707,3416,967,5910,6877,88265,681992,770257,10/01/2014 12:00:00 AM,124,252,225
Piedmont,Halifax County,51083,712,2694,3406,983,5876,6859,83822,650581,734403,09/01/2014 12:00:00 AM,118,241,216
Piedmont,Halifax County,51083,716,2697,3413,972,5838,6810,88979,676216,765195,12/01/2014 12:00:00 AM,124,251,224
Piedmont,Halifax County,51083,717,2691,3408,973,5848,6821,85456,669233,754689,01/01/2015 12:00:00 AM,119,249,221
Piedmont,Halifax County,51083,718,2795,3513,988,6003,6991,88291,674789,763080,04/01/2014 12:00:00 AM,123,241,217
Piedmont,Halifax County,51083,718,2807,3525,1010,6001,7011,99239,723419,822658,10/01/2013 12:00:00 AM,138,258,233
Piedmont,Halifax County,51083,720,2699,3419,986,5848,6834,91647,677589,769236,11/01/2014 12:00:00 AM,127,251,225
Piedmont,Halifax County,51083,720,2746,3466,1002,6071,7073,95139,728547,823686,03/01/2012 12:00:00 AM,132,265,238
Piedmont,Halifax County,51083,720,2751,3471,1002,6098,7100,95827,730310,826137,02/01/2012 12:00:00 AM,133,265,238
Piedmont,Halifax County,51083,722,2794,3516,1005,6012,7017,90505,670966,761471,11/01/2013 12:00:00 AM,125,240,217
Piedmont,Halifax County,51083,722,2813,3535,995,6021,7016,89150,671200,760350,03/01/2014 12:00:00 AM,123,239,215
Piedmont,Halifax County,51083,722,2819,3541,997,6029,7026,89172,672560,761732,02/01/2014 12:00:00 AM,124,239,215
Piedmont,Halifax County,51083,722,2820,3542,997,6037,7034,88565,659003,747568,01/01/2014 12:00:00 AM,123,234,211
Piedmont,Halifax County,51083,723,2724,3447,1019,5992,7011,98752,718078,816830,04/01/2012 12:00:00 AM,137,264,237
Piedmont,Halifax County,51083,725,2798,3523,1010,6052,7062,99858,729310,829168,09/01/2013 12:00:00 AM,138,261,235
Piedmont,Halifax County,51083,726,2776,3502,1004,6053,7057,97640,725588,823228,06/01/2013 12:00:00 AM,134,261,235
Piedmont,Halifax County,51083,726,2796,3522,1007,6086,7093,98382,728823,827205,07/01/2013 12:00:00 AM,136,261,235
Piedmont,Halifax County,51083,728,2779,3507,1027,5956,6983,95484,661672,757156,12/01/2013 12:00:00 AM,131,238,216
Piedmont,Halifax County,51083,728,2787,3515,1013,6023,7036,98951,723654,822605,08/01/2013 12:00:00 AM,136,260,234
Piedmont,Halifax County,51083,730,2744,3474,1025,6074,7099,96390,720879,817269,01/01/2012 12:00:00 AM,132,263,235
Piedmont,Halifax County,51083,733,2746,3479,1031,6053,7084,100181,720891,821072,05/01/2012 12:00:00 AM,137,263,236
Piedmont,Halifax County,51083,733,2754,3487,1017,6001,7018,97350,715136,812486,05/01/2013 12:00:00 AM,133,260,233
Piedmont,Halifax County,51083,734,2761,3495,989,6048,7037,93312,724080,817392,04/01/2013 12:00:00 AM,127,262,234
Piedmont,Halifax County,51083,739,2735,3474,1027,6013,7040,98517,713005,811522,08/01/2012 12:00:00 AM,133,261,234
Piedmont,Halifax County,51083,739,2748,3487,1007,5995,7002,97367,714959,812326,09/01/2012 12:00:00 AM,132,260,233
Piedmont,Halifax County,51083,741,2792,3533,1027,6110,7137,102212,733577,835789,12/01/2012 12:00:00 AM,138,263,237
Piedmont,Halifax County,51083,742,2763,3505,1018,6056,7074,97333,720384,817717,02/01/2013 12:00:00 AM,131,261,233
Piedmont,Halifax County,51083,742,2769,3511,1018,6072,7090,96270,726314,822584,03/01/2013 12:00:00 AM,130,262,234
Piedmont,Halifax County,51083,743,2707,3450,1050,5970,7020,102516,703729,806245,06/01/2012 12:00:00 AM,138,260,234
Piedmont,Halifax County,51083,743,2782,3525,1035,6082,7117,98445,718978,817423,01/01/2013 12:00:00 AM,132,258,232
Piedmont,Halifax County,51083,746,2788,3534,1025,6082,7107,102090,729964,832054,11/01/2012 12:00:00 AM,137,262,235
Piedmont,Halifax County,51083,747,2713,3460,1050,5972,7022,102106,702846,804952,07/01/2012 12:00:00 AM,137,259,233
Piedmont,Halifax County,51083,751,2768,3519,1057,6037,7094,105290,721366,826656,10/01/2012 12:00:00 AM,140,261,235
Piedmont,Henry County,51089,635,3802,4437,799,7816,8615,67578,894278,961856,02/01/2020 12:00:00 AM,106,235,217
Piedmont,Henry County,51089,637,4037,4674,755,8145,8900,175739,1741684,1917423,02/01/2021 12:00:00 AM,276,431,410
Piedmont,Henry County,51089,641,4271,4912,854,8964,9818,85863,1086670,1172533,02/01/2017 12:00:00 AM,134,254,239
Piedmont,Henry County,51089,642,4008,4650,773,8005,8778,184443,1847201,2031644,04/01/2021 12:00:00 AM,287,461,437
Piedmont,Henry County,51089,643,3848,4491,807,7932,8739,150332,1369675,1520007,03/01/2020 12:00:00 AM,234,356,338
Piedmont,Henry County,51089,643,4034,4677,770,8126,8896,173568,1719882,1893450,03/01/2021 12:00:00 AM,270,426,405
Piedmont,Henry County,51089,645,3862,4507,831,7913,8744,75890,913709,989599,11/01/2019 12:00:00 AM,118,237,220
Piedmont,Henry County,51089,645,3963,4608,786,7871,8657,185830,1833006,2018836,05/01/2021 12:00:00 AM,288,463,438
Piedmont,Henry County,51089,645,3984,4629,794,7902,8696,186102,1824222,2010324,06/01/2021 12:00:00 AM,289,458,434
Piedmont,Henry County,51089,648,3986,4634,782,8017,8799,177403,1678501,1855904,01/01/2021 12:00:00 AM,274,421,400
Piedmont,Henry County,51089,648,4043,4691,795,8173,8968,155701,1515921,1671622,12/01/2020 12:00:00 AM,240,375,356
Piedmont,Henry County,51089,649,3859,4508,815,7938,8753,72334,924930,997264,12/01/2019 12:00:00 AM,111,240,221
Piedmont,Henry County,51089,651,3804,4455,819,7817,8636,70965.44,887705,958670.44,01/01/2020 12:00:00 AM,109,233,215
Piedmont,Henry County,51089,652,3840,4492,841,7847,8688,77968,920012,997980,10/01/2019 12:00:00 AM,120,240,222
Piedmont,Henry County,51089,652,4132,4784,829,8453,9282,154769,1485185,1639954,04/01/2020 12:00:00 AM,237,359,343
Piedmont,Henry County,51089,653,4084,4737,805,8287,9092,158494,1537705,1696199,11/01/2020 12:00:00 AM,243,377,358
Piedmont,Henry County,51089,654,3821,4475,835,7900,8735,76494,932671,1009165,07/01/2019 12:00:00 AM,117,244,226
Piedmont,Henry County,51089,655,4197,4852,887,8797,9684,88621,1056993,1145614,04/01/2017 12:00:00 AM,135,252,236
Piedmont,Henry County,51089,656,3841,4497,845,7940,8785,77791,934320,1012111,08/01/2019 12:00:00 AM,119,243,225
Piedmont,Henry County,51089,656,3857,4513,846,7942,8788,78395,929609,1008004,09/01/2019 12:00:00 AM,120,241,223
Piedmont,Henry County,51089,658,4217,4875,832,8625,9457,154066,1492666,1646732,05/01/2020 12:00:00 AM,234,354,338
Piedmont,Henry County,51089,660,4296,4956,837,8808,9645,156508,1533172,1689680,06/01/2020 12:00:00 AM,237,357,341
Piedmont,Henry County,51089,661,4181,4842,815,8512,9327,160038,1572810,1732848,10/01/2020 12:00:00 AM,242,376,358
Piedmont,Henry County,51089,664,4209,4873,823,8629,9452,154758,1498208,1652966,09/01/2020 12:00:00 AM,233,356,339
Piedmont,Henry County,51089,664,4252,4916,903,8891,9794,92211,1074007,1166218,03/01/2017 12:00:00 AM,139,253,237
Piedmont,Henry County,51089,664,4467,5131,911,9283,10194,89877,1092492,1182369,12/01/2016 12:00:00 AM,135,245,230
Piedmont,Henry County,51089,665,4083,4748,887,8637,9524,89209,1045222.4,1134431.4,07/01/2017 12:00:00 AM,134,256,239
Piedmont,Henry County,51089,667,3800,4467,846,7950,8796,77709,932293,1010002,05/01/2019 12:00:00 AM,117,245,226
Piedmont,Henry County,51089,667,4187,4854,900,8792,9692,91487,1059768,1151255,05/01/2017 12:00:00 AM,137,253,237
Piedmont,Henry County,51089,668,3831,4499,854,7963,8817,79461,935468,1014929,06/01/2019 12:00:00 AM,119,244,226
Piedmont,Henry County,51089,670,4339,5009,844,8905,9749,157687,1545399,1703086,07/01/2020 12:00:00 AM,235,356,340
Piedmont,Henry County,51089,671,4165,4836,898,8820,9718,91787,1069107,1160894,06/01/2017 12:00:00 AM,137,257,240
Piedmont,Henry County,51089,671,4444,5115,908,9230,10138,89541,1084932,1174473,01/01/2017 12:00:00 AM,133,244,230
Piedmont,Henry County,51089,672,3629,4301,862,7629,8491,78396,884586,962982,02/01/2019 12:00:00 AM,117,244,224
Piedmont,Henry County,51089,674,3828,4502,864,8064,8928,78072,945661,1023733,04/01/2019 12:00:00 AM,116,247,227
Piedmont,Henry County,51089,674,4060,4734,910,8606,9516,90477,1038261,1128738,08/01/2017 12:00:00 AM,134,256,238
Piedmont,Henry County,51089,675,4289,4964,856,8794,9650,159844,1529037,1688881,08/01/2020 12:00:00 AM,237,357,340
Piedmont,Henry County,51089,679,3813,4492,884,8074,8958,81378,946445,1027823,03/01/2019 12:00:00 AM,120,248,229
Piedmont,Henry County,51089,682,4479,5161,942,9332,10274,92940,1104035,1196975,11/01/2016 12:00:00 AM,136,246,232
Piedmont,Henry County,51089,684,3824,4508,866,8047,8913,79924,978769,1058693,01/01/2019 12:00:00 AM,117,256,235
Piedmont,Henry County,51089,684,4488,5172,946,9380,10326,92063,1107585,1199648,10/01/2016 12:00:00 AM,135,247,232
Piedmont,Henry County,51089,685,3838,4523,875,8185,9060,83388,972940,1056328,11/01/2018 12:00:00 AM,122,254,234
Piedmont,Henry County,51089,687,4015,4702,921,8506,9427,92224,1026511,1118735,09/01/2017 12:00:00 AM,134,256,238
Piedmont,Henry County,51089,688,3827,4515,877,8108,8985,85028,958745,1043773,12/01/2018 12:00:00 AM,124,251,231
Piedmont,Henry County,51089,690,4539,5229,966,9490,10456,94789,1129995,1224784,09/01/2016 12:00:00 AM,137,249,234
Piedmont,Henry County,51089,690,4574,5264,965,9610,10575,94949,1148884,1243833,08/01/2016 12:00:00 AM,138,251,236
Piedmont,Henry County,51089,693,3993,4686,932,8482,9414,96676,1006704,1103380,10/01/2017 12:00:00 AM,140,252,235
Piedmont,Henry County,51089,694,3852,4546,891,8174,9065,84026,982646.7,1066672.7,10/01/2018 12:00:00 AM,121,255,235
Piedmont,Henry County,51089,696,3933,4629,888,8372,9260,81198,986937,1068135,06/01/2018 12:00:00 AM,117,251,231
Piedmont,Henry County,51089,696,3953,4649,901,8382,9283,85666,992395,1078061,05/01/2018 12:00:00 AM,123,251,232
Piedmont,Henry County,51089,698,3891,4589,897,8288,9185,83387,986791,1070178,09/01/2018 12:00:00 AM,119,254,233
Piedmont,Henry County,51089,698,3928,4626,909,8330,9239,84797,992739,1077536,08/01/2018 12:00:00 AM,121,253,233
Piedmont,Henry County,51089,698,4597,5295,983,9576,10559,97162,1147220,1244382,07/01/2016 12:00:00 AM,139,250,235
Piedmont,Henry County,51089,701,3931,4632,917,8352,9269,87775,987948,1075723,04/01/2018 12:00:00 AM,125,251,232
Piedmont,Henry County,51089,702,3920,4622,907,8331,9238,85303,995981,1081284,07/01/2018 12:00:00 AM,122,254,234
Piedmont,Henry County,51089,702,4686,5388,993,9752,10745,98555,1192435,1290990,06/01/2016 12:00:00 AM,140,254,240
Piedmont,Henry County,51089,704,4955,5659,1001,10485,11486,95146,1219279,1314425,06/01/2014 12:00:00 AM,135,246,232
Piedmont,Henry County,51089,705,4914,5619,1002,10521,11523,95505,1215685,1311190,07/01/2014 12:00:00 AM,135,247,233
Piedmont,Henry County,51089,709,5088,5797,998,10685,11683,97763,1259551,1357314,04/01/2014 12:00:00 AM,138,248,234
Piedmont,Henry County,51089,710,3928,4638,933,8363,9296,89441,986046,1075487,03/01/2018 12:00:00 AM,126,251,232
Piedmont,Henry County,51089,710,3971,4681,952,8477,9429,95889,1006099,1101988,12/01/2017 12:00:00 AM,135,253,235
Piedmont,Henry County,51089,711,3945,4656,941,8412,9353,91216,986268,1077484,02/01/2018 12:00:00 AM,128,250,231
Piedmont,Henry County,51089,711,3983,4694,949,8527,9476,97740,1002694,1100434,11/01/2017 12:00:00 AM,137,252,234
Piedmont,Henry County,51089,711,5029,5740,998,10607,11605,96600,1237864,1334464,05/01/2014 12:00:00 AM,136,246,232
Piedmont,Henry County,51089,712,4844,5556,1007,10358,11365,97260,1183803,1281063,08/01/2014 12:00:00 AM,137,244,231
Piedmont,Henry County,51089,712,5257,5969,1155,11097,12252,132218,1386904,1519122,01/01/2012 12:00:00 AM,186,264,255
Piedmont,Henry County,51089,714,5107,5821,1010,10713,11723,96727,1251848,1348575,03/01/2014 12:00:00 AM,135,245,232
Piedmont,Henry County,51089,715,5146,5861,1031,10789,11820,100585,1252852,1353437,02/01/2014 12:00:00 AM,141,243,231
Piedmont,Henry County,51089,717,3927,4644,959,8371,9330,93355,983986,1077341,01/01/2018 12:00:00 AM,130,251,232
Piedmont,Henry County,51089,717,4820,5537,1025,10216,11241,98827,1177209,1276036,09/01/2014 12:00:00 AM,138,244,230
Piedmont,Henry County,51089,718,5370,6088,1035,11330,12365,114531,1434182,1548713,09/01/2013 12:00:00 AM,160,267,254
Piedmont,Henry County,51089,719,5171,5890,1035,10870,11905,101340,1257080,1358420,01/01/2014 12:00:00 AM,141,243,231
Piedmont,Henry County,51089,719,5341,6060,1057,11304,12361,116706,1419841,1536547,05/01/2013 12:00:00 AM,162,266,254
Piedmont,Henry County,51089,720,4733,5453,1031,9816,10847,104491,1193138,1297629,05/01/2016 12:00:00 AM,145,252,238
Piedmont,Henry County,51089,720,4896,5616,1008,10222,11230,103885,1235348,1339233,05/01/2015 12:00:00 AM,144,252,238
Piedmont,Henry County,51089,720,5269,5989,1028,11092,12120,104501,1308683,1413184,11/01/2013 12:00:00 AM,145,248,236
Piedmont,Henry County,51089,720,5294,6014,1179,11092,12271,135511,1388393,1523904,05/01/2012 12:00:00 AM,188,262,253
Piedmont,Henry County,51089,720,5345,6065,1035,11244,12279,114408,1426494,1540902,10/01/2013 12:00:00 AM,159,267,254
Piedmont,Henry County,51089,720,5380,6100,1031,11388,12419,112037,1436027,1548064,07/01/2013 12:00:00 AM,156,267,254
Piedmont,Henry County,51089,721,4812,5533,1030,10081,11111,106414,1213466,1319880,02/01/2015 12:00:00 AM,148,252,239
Piedmont,Henry County,51089,721,4873,5594,1001,10206,11207,103060,1228907,1331967,04/01/2015 12:00:00 AM,143,252,238
Piedmont,Henry County,51089,721,5288,6009,1177,11135,12312,138284,1394206,1532490,03/01/2012 12:00:00 AM,192,264,255
Piedmont,Henry County,51089,722,4835,5557,1015,10162,11177,103715,1222074,1325789,03/01/2015 12:00:00 AM,144,253,239
Piedmont,Henry County,51089,722,4842,5564,1013,10220,11233,105173,1226625,1331798,11/01/2014 12:00:00 AM,146,253,239
Piedmont,Henry County,51089,722,5359,6081,1069,11352,12421,118957,1430909,1549866,06/01/2013 12:00:00 AM,165,267,255
Piedmont,Henry County,51089,723,4892,5615,1017,10212,11229,104767,1226463,1331230,07/01/2015 12:00:00 AM,145,251,237
Piedmont,Henry County,51089,723,5273,5996,1177,11107,12284,138767,1391462,1530229,04/01/2012 12:00:00 AM,192,264,255
Piedmont,Henry County,51089,724,5376,6100,1036,11348,12384,114107,1436175,1550282,08/01/2013 12:00:00 AM,158,267,254
Piedmont,Henry County,51089,725,4827,5552,1024,10204,11228,106123,1220711,1326834,10/01/2014 12:00:00 AM,146,253,239
Piedmont,Henry County,51089,725,5270,5995,1188,11105,12293,138718,1392889,1531607,02/01/2012 12:00:00 AM,191,264,255
Piedmont,Henry County,51089,726,4888,5614,1014,10204,11218,102616,1243095,1345711,06/01/2015 12:00:00 AM,141,254,240
Piedmont,Henry County,51089,727,4728,5455,1046,9839,10885,105039,1172200,1277239,04/01/2016 12:00:00 AM,144,248,234
Piedmont,Henry County,51089,727,5234,5961,1037,10980,12017,104159,1284333,1388492,12/01/2013 12:00:00 AM,143,245,233
Piedmont,Henry County,51089,727,5343,6070,1072,11317,12389,119896,1415034,1534930,04/01/2013 12:00:00 AM,165,265,253
Piedmont,Henry County,51089,730,4789,5519,1042,9928,10970,103625,1186153,1289778,03/01/2016 12:00:00 AM,142,248,234
Piedmont,Henry County,51089,730,4839,5569,1025,10116,11141,104282,1212681,1316963,10/01/2015 12:00:00 AM,143,251,236
Piedmont,Henry County,51089,731,5377,6108,1087,11362,12449,121924,1421120,1543044,03/01/2013 12:00:00 AM,167,264,253
Piedmont,Henry County,51089,732,4859,5591,1021,10207,11228,107278,1215263,1322541,12/01/2014 12:00:00 AM,147,250,237
Piedmont,Henry County,51089,732,5354,6086,1100,11275,12375,123501,1411519,1535020,02/01/2013 12:00:00 AM,169,264,252
Piedmont,Henry County,51089,733,4803,5536,1045,9950,10995,105955,1188780,1294735,02/01/2016 12:00:00 AM,145,248,234
Piedmont,Henry County,51089,733,5299,6032,1196,11115,12311,136705,1398918,1535623,06/01/2012 12:00:00 AM,187,264,255
Piedmont,Henry County,51089,736,4782,5518,1052,9941,10993,106853,1182983,1289836,01/01/2016 12:00:00 AM,145,247,234
Piedmont,Henry County,51089,736,4846,5582,1044,10166,11210,107226,1206295,1313521,01/01/2015 12:00:00 AM,146,249,235
Piedmont,Henry County,51089,739,4830,5569,1056,10094,11150,105356,1199211,1304567,12/01/2015 12:00:00 AM,143,248,234
Piedmont,Henry County,51089,739,4848,5587,1048,10116,11164,108788,1215105,1323893,09/01/2015 12:00:00 AM,147,251,237
Piedmont,Henry County,51089,739,5285,6024,1158,11134,12292,133181,1404066,1537247,12/01/2012 12:00:00 AM,180,266,255
Piedmont,Henry County,51089,739,5327,6066,1140,11227,12367,128094,1396165,1524259,01/01/2013 12:00:00 AM,173,262,251
Piedmont,Henry County,51089,740,4823,5563,1051,10059,11110,107188,1201757,1308945,11/01/2015 12:00:00 AM,145,249,235
Piedmont,Henry County,51089,743,4873,5616,1059,10117,11176,109453,1220405,1329858,08/01/2015 12:00:00 AM,147,250,237
Piedmont,Henry County,51089,747,5316,6063,1196,11200,12396,136160,1415642,1551802,09/01/2012 12:00:00 AM,182,266,256
Piedmont,Henry County,51089,750,5313,6063,1212,11172,12384,137827,1410993,1548820,08/01/2012 12:00:00 AM,184,266,255
Piedmont,Henry County,51089,753,5283,6036,1219,11085,12304,139716,1397606,1537322,07/01/2012 12:00:00 AM,186,265,255
Piedmont,Henry County,51089,754,5323,6077,1191,11189,12380,135361,1411677,1547038,11/01/2012 12:00:00 AM,180,265,255
Piedmont,Henry County,51089,756,5352,6108,1217,11252,12469,141161,1426374,1567535,10/01/2012 12:00:00 AM,187,267,257
Piedmont,Highland County,51091,3,44,47,4,94,98,513,9250,9763,06/01/2017 12:00:00 AM,171,210,208
Piedmont,Highland County,51091,3,53,56,3,92,95,725,21882,22607,06/01/2021 12:00:00 AM,242,413,404
Piedmont,Highland County,51091,4,43,47,4,84,88,236,8280,8516,11/01/2018 12:00:00 AM,59,193,181
Piedmont,Highland County,51091,4,44,48,4,84,88,236,7389,7625,12/01/2018 12:00:00 AM,59,168,159
Piedmont,Highland County,51091,4,46,50,4,79,83,226,7750,7976,01/01/2019 12:00:00 AM,57,168,160
Piedmont,Highland County,51091,4,49,53,4,85,89,226,8502,8728,02/01/2019 12:00:00 AM,57,174,165
Piedmont,Highland County,51091,4,51,55,4,87,91,207,9555,9762,04/01/2019 12:00:00 AM,52,187,177
Piedmont,Highland County,51091,4,52,56,4,85,89,207,9384,9591,05/01/2019 12:00:00 AM,52,180,171
Piedmont,Highland County,51091,4,52,56,4,93,97,226,8997,9223,03/01/2019 12:00:00 AM,57,173,165
Piedmont,Highland County,51091,4,53,57,4,91,95,959,20702,21661,05/01/2021 12:00:00 AM,240,391,380
Piedmont,Highland County,51091,4,68,72,4,137,141,214,16024,16238,07/01/2013 12:00:00 AM,54,236,226
Piedmont,Highland County,51091,4,70,74,4,137,141,214,16266,16480,05/01/2013 12:00:00 AM,54,232,223
Piedmont,Highland County,51091,4,72,76,4,141,145,214,16473,16687,06/01/2013 12:00:00 AM,54,229,220
Piedmont,Highland County,51091,5,42,47,6,91,97,644,9442,10086,07/01/2017 12:00:00 AM,129,225,215
Piedmont,Highland County,51091,5,43,48,6,82,88,604,7734,8338,03/01/2017 12:00:00 AM,121,180,174
Piedmont,Highland County,51091,5,43,48,6,89,95,665,8779,9444,08/01/2017 12:00:00 AM,133,204,197
Piedmont,Highland County,51091,5,44,49,6,80,86,589,8140,8729,10/01/2018 12:00:00 AM,118,185,178
Piedmont,Highland County,51091,5,44,49,6,94,100,687,8663,9350,05/01/2017 12:00:00 AM,137,197,191
Piedmont,Highland County,51091,5,45,50,6,87,93,604,8567,9171,04/01/2017 12:00:00 AM,121,190,183
Piedmont,Highland County,51091,5,50,55,6,99,105,604,8908,9512,01/01/2017 12:00:00 AM,121,178,173
Piedmont,Highland County,51091,5,51,56,6,102,108,604,8972,9576,12/01/2016 12:00:00 AM,121,176,171
Piedmont,Highland County,51091,5,52,57,5,82,87,305,9421,9726,08/01/2019 12:00:00 AM,61,181,171
Piedmont,Highland County,51091,5,53,58,5,94,99,1193,21573,22766,04/01/2021 12:00:00 AM,239,407,393
Piedmont,Highland County,51091,5,53,58,6,106,112,604,10383,10987,02/01/2017 12:00:00 AM,121,196,189
Piedmont,Highland County,51091,5,53,58,6,114,120,610,9565,10175,06/01/2016 12:00:00 AM,122,180,175
Piedmont,Highland County,51091,5,55,60,6,113,119,610,9139,9749,05/01/2016 12:00:00 AM,122,166,162
Piedmont,Highland County,51091,5,58,63,6,115,121,610,9605,10215,04/01/2016 12:00:00 AM,122,166,162
Piedmont,Highland County,51091,5,62,67,6,130,136,610,11086,11696,01/01/2016 12:00:00 AM,122,179,175
Piedmont,Highland County,51091,5,62,67,6,132,138,612,11760,12372,12/01/2015 12:00:00 AM,122,190,185
Piedmont,Highland County,51091,5,63,68,6,130,136,610,10774,11384,02/01/2016 12:00:00 AM,122,171,167
Piedmont,Highland County,51091,5,65,70,6,135,141,610,11192,11802,03/01/2016 12:00:00 AM,122,172,169
Piedmont,Highland County,51091,5,70,75,5,138,143,322,16034,16356,04/01/2013 12:00:00 AM,64,229,218
Piedmont,Highland County,51091,5,71,76,6,157,163,209,17211,17420,02/01/2014 12:00:00 AM,42,242,229
Piedmont,Highland County,51091,5,71,76,6,159,165,392,15404,15796,08/01/2014 12:00:00 AM,78,217,208
Piedmont,Highland County,51091,5,74,79,5,172,177,139,18244,18383,04/01/2014 12:00:00 AM,28,247,233
Piedmont,Highland County,51091,5,74,79,6,160,166,209,16683,16892,03/01/2014 12:00:00 AM,42,225,214
Piedmont,Highland County,51091,5,75,80,5,161,166,192,16655,16847,01/01/2014 12:00:00 AM,38,222,211
Piedmont,Highland County,51091,6,42,48,9,86,95,1119,9297,10416,09/01/2017 12:00:00 AM,187,221,217
Piedmont,Highland County,51091,6,43,49,7,81,88,642,7999,8641,09/01/2018 12:00:00 AM,107,186,176
Piedmont,Highland County,51091,6,44,50,7,82,89,642,8983,9625,08/01/2018 12:00:00 AM,107,204,193
Piedmont,Highland County,51091,6,46,52,7,86,93,641,9505,10146,07/01/2018 12:00:00 AM,107,207,195
Piedmont,Highland County,51091,6,47,53,9,93,102,1122,9626,10748,10/01/2017 12:00:00 AM,187,205,203
Piedmont,Highland County,51091,6,50,56,8,111,119,796,9180,9976,09/01/2016 12:00:00 AM,133,184,178
Piedmont,Highland County,51091,6,51,57,6,93,99,1404,20112,21516,02/01/2021 12:00:00 AM,234,394,377
Piedmont,Highland County,51091,6,51,57,8,117,125,797,10497,11294,08/01/2016 12:00:00 AM,133,206,198
Piedmont,Highland County,51091,6,52,58,6,88,94,350,9069,9419,07/01/2019 12:00:00 AM,58,174,162
Piedmont,Highland County,51091,6,52,58,6,93,99,1404,21076,22480,03/01/2021 12:00:00 AM,234,405,388
Piedmont,Highland County,51091,6,52,58,7,110,117,657,9526,10183,11/01/2016 12:00:00 AM,110,183,176
Piedmont,Highland County,51091,6,52,58,8,113,121,856,10642,11498,10/01/2016 12:00:00 AM,143,205,198
Piedmont,Highland County,51091,6,54,60,6,92,98,347,9662,10009,06/01/2019 12:00:00 AM,58,179,167
Piedmont,Highland County,51091,6,54,60,8,122,130,939,10078,11017,07/01/2016 12:00:00 AM,157,187,184
Piedmont,Highland County,51091,6,56,62,6,100,106,1404,22074,23478,01/01/2021 12:00:00 AM,234,394,379
Piedmont,Highland County,51091,6,63,69,8,123,131,504,13228,13732,09/01/2013 12:00:00 AM,84,210,199
Piedmont,Highland County,51091,6,65,71,9,136,145,1123,13392,14515,10/01/2015 12:00:00 AM,187,206,204
Piedmont,Highland County,51091,6,65,71,9,138,147,1123,13249,14372,11/01/2015 12:00:00 AM,187,204,202
Piedmont,Highland County,51091,6,66,72,8,130,138,479,14826,15305,08/01/2013 12:00:00 AM,80,225,213
Piedmont,Highland County,51091,6,67,73,8,134,142,689,15421,16110,01/01/2013 12:00:00 AM,115,230,221
Piedmont,Highland County,51091,6,67,73,8,138,146,786,16101,16887,02/01/2013 12:00:00 AM,131,240,231
Piedmont,Highland County,51091,6,68,74,9,142,151,1107,14553,15660,05/01/2015 12:00:00 AM,185,214,212
Piedmont,Highland County,51091,6,68,74,9,145,154,1107,14145,15252,09/01/2015 12:00:00 AM,185,208,206
Piedmont,Highland County,51091,6,69,75,7,141,148,412,15039,15451,10/01/2013 12:00:00 AM,69,218,206
Piedmont,Highland County,51091,6,69,75,8,139,147,602,16112,16714,12/01/2012 12:00:00 AM,100,234,223
Piedmont,Highland County,51091,6,69,75,8,150,158,953,15299,16252,03/01/2015 12:00:00 AM,159,222,217
Piedmont,Highland County,51091,6,69,75,9,143,152,1107,14892,15999,06/01/2015 12:00:00 AM,185,216,213
Piedmont,Highland County,51091,6,69,75,9,144,153,1107,14727,15834,07/01/2015 12:00:00 AM,185,213,211
Piedmont,Highland County,51091,6,69,75,9,149,158,1107,14913,16020,04/01/2015 12:00:00 AM,185,216,214
Piedmont,Highland County,51091,6,70,76,10,142,152,620,16066,16686,03/01/2013 12:00:00 AM,103,230,220
Piedmont,Highland County,51091,6,70,76,7,138,145,357,14327,14684,12/01/2013 12:00:00 AM,60,205,193
Piedmont,Highland County,51091,6,70,76,7,164,171,724,16286,17010,11/01/2014 12:00:00 AM,121,233,224
Piedmont,Highland County,51091,6,70,76,8,158,166,953,16427,17380,01/01/2015 12:00:00 AM,159,235,229
Piedmont,Highland County,51091,6,70,76,9,149,158,1107,15086,16193,08/01/2015 12:00:00 AM,185,216,213
Piedmont,Highland County,51091,6,71,77,7,143,150,357,14122,14479,11/01/2013 12:00:00 AM,60,199,188
Piedmont,Highland County,51091,6,71,77,8,157,165,953,16768,17721,02/01/2015 12:00:00 AM,159,236,230
Piedmont,Highland County,51091,6,72,78,7,157,164,518,14905,15423,09/01/2014 12:00:00 AM,86,207,198
Piedmont,Highland County,51091,6,72,78,7,166,173,570,15960,16530,10/01/2014 12:00:00 AM,95,222,212
Piedmont,Highland County,51091,6,72,78,8,145,153,602,18033,18635,11/01/2012 12:00:00 AM,100,250,239
Piedmont,Highland County,51091,6,73,79,6,171,177,163,18234,18397,05/01/2014 12:00:00 AM,27,250,233
Piedmont,Highland County,51091,6,73,79,6,171,177,260,18123,18383,06/01/2014 12:00:00 AM,43,248,233
Piedmont,Highland County,51091,7,45,52,10,82,92,1090,8477,9567,06/01/2018 12:00:00 AM,156,188,184
Piedmont,Highland County,51091,7,45,52,10,87,97,1026,8884,9910,03/01/2018 12:00:00 AM,147,197,191
Piedmont,Highland County,51091,7,46,53,10,91,101,1129,9438,10567,01/01/2018 12:00:00 AM,161,205,199
Piedmont,Highland County,51091,7,46,53,10,91,101,1136,10258,11394,11/01/2017 12:00:00 AM,162,223,215
Piedmont,Highland County,51091,7,47,54,10,90,100,1129,9139,10268,02/01/2018 12:00:00 AM,161,194,190
Piedmont,Highland County,51091,7,47,54,10,95,105,1136,10443,11579,12/01/2017 12:00:00 AM,162,222,214
Piedmont,Highland County,51091,7,51,58,7,82,89,1408,16194,17602,11/01/2020 12:00:00 AM,201,318,303
Piedmont,Highland County,51091,7,51,58,7,84,91,589,8681,9270,12/01/2019 12:00:00 AM,84,170,160
Piedmont,Highland County,51091,7,51,58,7,90,97,1388,17664,19052,12/01/2020 12:00:00 AM,198,346,328
Piedmont,Highland County,51091,7,53,60,7,85,92,589,8853,9442,11/01/2019 12:00:00 AM,84,167,157
Piedmont,Highland County,51091,7,53,60,7,85,92,677,9535,10212,10/01/2019 12:00:00 AM,97,180,170
Piedmont,Highland County,51091,7,55,62,7,94,101,1571,18692,20263,10/01/2020 12:00:00 AM,224,340,327
Piedmont,Highland County,51091,7,67,74,10,138,148,906,15452,16358,09/01/2012 12:00:00 AM,129,231,221
Piedmont,Highland County,51091,7,69,76,9,158,167,995,16072,17067,12/01/2014 12:00:00 AM,142,233,225
Piedmont,Highland County,51091,7,71,78,8,158,166,587,15855,16442,07/01/2014 12:00:00 AM,84,223,211
Piedmont,Highland County,51091,7,72,79,9,146,155,639,18019,18658,10/01/2012 12:00:00 AM,91,250,236
Piedmont,Highland County,51091,7,75,82,9,156,165,758,22523,23281,07/01/2012 12:00:00 AM,108,300,284
Piedmont,Highland County,51091,7,79,86,9,165,174,642,19022,19664,06/01/2012 12:00:00 AM,92,241,229
Piedmont,Highland County,51091,8,43,51,11,82,93,1090,8907,9997,05/01/2018 12:00:00 AM,136,207,196
Piedmont,Highland County,51091,8,43,51,11,83,94,1090,9026,10116,04/01/2018 12:00:00 AM,136,210,198
Piedmont,Highland County,51091,8,52,60,8,86,94,694,9468,10162,09/01/2019 12:00:00 AM,87,182,169
Piedmont,Highland County,51091,8,54,62,8,89,97,706,9414,10120,02/01/2020 12:00:00 AM,88,174,163
Piedmont,Highland County,51091,8,54,62,8,91,99,663,8833,9496,01/01/2020 12:00:00 AM,83,164,153
Piedmont,Highland County,51091,8,55,63,8,89,97,1552,16038,17590,03/01/2020 12:00:00 AM,194,292,279
Piedmont,Highland County,51091,8,63,71,8,107,115,1552,18838,20390,06/01/2020 12:00:00 AM,194,299,287
Piedmont,Highland County,51091,8,63,71,8,109,117,1552,18744,20296,04/01/2020 12:00:00 AM,194,298,286
Piedmont,Highland County,51091,8,64,72,8,109,117,1552,18734,20286,08/01/2020 12:00:00 AM,194,293,282
Piedmont,Highland County,51091,8,64,72,8,112,120,1552,20757,22309,07/01/2020 12:00:00 AM,194,324,310
Piedmont,Highland County,51091,8,65,73,8,112,120,1552,20020,21572,05/01/2020 12:00:00 AM,194,308,296
Piedmont,Highland County,51091,8,71,79,11,149,160,1035,17504,18539,08/01/2012 12:00:00 AM,129,247,235
Piedmont,Highland County,51091,8,80,88,12,166,178,1148,18072,19220,03/01/2012 12:00:00 AM,144,226,218
Piedmont,Highland County,51091,8,81,89,12,164,176,1148,17800,18948,02/01/2012 12:00:00 AM,144,220,213
Piedmont,Highland County,51091,8,82,90,11,166,177,1008,16768,17776,01/01/2012 12:00:00 AM,126,204,198
Piedmont,Highland County,51091,8,82,90,12,168,180,1148,18603,19751,04/01/2012 12:00:00 AM,144,227,219
Piedmont,Highland County,51091,8,82,90,12,174,186,1129,19214,20343,05/01/2012 12:00:00 AM,141,234,226
Piedmont,Highland County,51091,9,57,66,9,100,109,1405,17052,18457,09/01/2020 12:00:00 AM,156,299,280
Piedmont,Lexington City,51678,31,128,159,37,241,278,7007,41775,48782,08/01/2020 12:00:00 AM,226,326,307
Piedmont,Lexington City,51678,32,122,154,38,219,257,4091,22988,27079,12/01/2019 12:00:00 AM,128,188,176
Piedmont,Lexington City,51678,32,122,154,38,231,269,7142,39538,46680,03/01/2020 12:00:00 AM,223,324,303
Piedmont,Lexington City,51678,32,124,156,36,234,270,3150,23958,27108,01/01/2020 12:00:00 AM,98,193,174
Piedmont,Lexington City,51678,32,127,159,40,234,274,7457,40973,48430,06/01/2020 12:00:00 AM,233,323,305
Piedmont,Lexington City,51678,32,128,160,39,235,274,3826,24832,28658,11/01/2019 12:00:00 AM,120,194,179
Piedmont,Lexington City,51678,32,130,162,39,241,280,7296,42924,50220,07/01/2020 12:00:00 AM,228,330,310
Piedmont,Lexington City,51678,32,142,174,37,265,302,6908,48023,54931,09/01/2020 12:00:00 AM,216,338,316
Piedmont,Lexington City,51678,33,125,158,40,225,265,3870,23579,27449,10/01/2019 12:00:00 AM,117,189,174
Piedmont,Lexington City,51678,33,127,160,39,245,284,3612,26790,30402,02/01/2020 12:00:00 AM,109,211,190
Piedmont,Lexington City,51678,33,131,164,40,229,269,4323,24130,28453,09/01/2019 12:00:00 AM,131,184,173
Piedmont,Lexington City,51678,34,132,166,45,243,288,8648,42550,51198,04/01/2020 12:00:00 AM,254,322,308
Piedmont,Lexington City,51678,34,133,167,45,249,294,8592,45494,54086,05/01/2020 12:00:00 AM,253,342,324
Piedmont,Lexington City,51678,36,142,178,41,264,305,8151,48664,56815,10/01/2020 12:00:00 AM,226,343,319
Piedmont,Lexington City,51678,36,142,178,42,282,324,4201,28612,32813,11/01/2018 12:00:00 AM,117,201,184
Piedmont,Lexington City,51678,37,133,170,47,236,283,5083,24390,29473,08/01/2019 12:00:00 AM,137,183,173
Piedmont,Lexington City,51678,37,135,172,44,258,302,4374,26537,30911,01/01/2019 12:00:00 AM,118,197,180
Piedmont,Lexington City,51678,37,142,179,45,283,328,4849,29880,34729,12/01/2018 12:00:00 AM,131,210,194
Piedmont,Lexington City,51678,37,149,186,43,288,331,4343,28656,32999,10/01/2018 12:00:00 AM,117,192,177
Piedmont,Lexington City,51678,39,131,170,50,230,280,5443,24022,29465,06/01/2019 12:00:00 AM,140,183,173
Piedmont,Lexington City,51678,39,132,171,50,239,289,5585,26380,31965,07/01/2019 12:00:00 AM,143,200,187
Piedmont,Lexington City,51678,39,137,176,46,259,305,4849,27468,32317,02/01/2019 12:00:00 AM,124,200,184
Piedmont,Lexington City,51678,39,148,187,46,286,332,4411,29446,33857,09/01/2018 12:00:00 AM,113,199,181
Piedmont,Lexington City,51678,39,153,192,47,299,346,4682,32318,37000,08/01/2018 12:00:00 AM,120,211,193
Piedmont,Lexington City,51678,40,139,179,50,247,297,5381,27097,32478,05/01/2019 12:00:00 AM,135,195,181
Piedmont,Lexington City,51678,40,141,181,50,260,310,5488,27475,32963,04/01/2019 12:00:00 AM,137,195,182
Piedmont,Lexington City,51678,40,149,189,53,280,333,5311,29932,35243,05/01/2018 12:00:00 AM,133,201,186
Piedmont,Lexington City,51678,40,150,190,53,301,354,5199,32230,37429,11/01/2017 12:00:00 AM,130,215,197
Piedmont,Lexington City,51678,40,153,193,54,296,350,5105,31955,37060,06/01/2018 12:00:00 AM,128,209,192
Piedmont,Lexington City,51678,40,153,193,55,308,363,5064,32572,37636,10/01/2017 12:00:00 AM,127,213,195
Piedmont,Lexington City,51678,40,155,195,45,297,342,3697,32017,35714,08/01/2015 12:00:00 AM,92,207,183
Piedmont,Lexington City,51678,40,155,195,48,300,348,4376,32895,37271,07/01/2018 12:00:00 AM,109,212,191
Piedmont,Lexington City,51678,41,136,177,51,253,304,5173,26076,31249,03/01/2019 12:00:00 AM,126,192,177
Piedmont,Lexington City,51678,41,150,191,47,292,339,3805,30434,34239,07/01/2015 12:00:00 AM,93,203,179
Piedmont,Lexington City,51678,41,150,191,54,295,349,4674,30080,34754,01/01/2018 12:00:00 AM,114,201,182
Piedmont,Lexington City,51678,41,150,191,54,301,355,4829,30560,35389,12/01/2017 12:00:00 AM,118,204,185
Piedmont,Lexington City,51678,41,154,195,57,307,364,5155,34324,39479,08/01/2017 12:00:00 AM,126,223,202
Piedmont,Lexington City,51678,41,158,199,48,306,354,3865,31942,35807,04/01/2015 12:00:00 AM,94,202,180
Piedmont,Lexington City,51678,42,148,190,56,285,341,5176,29996,35172,02/01/2018 12:00:00 AM,123,203,185
Piedmont,Lexington City,51678,42,155,197,48,299,347,3708,31293,35001,06/01/2015 12:00:00 AM,88,202,178
Piedmont,Lexington City,51678,43,145,188,52,265,317,10160,51105,61265,11/01/2020 12:00:00 AM,236,352,326
Piedmont,Lexington City,51678,43,150,193,60,308,368,5582,32570,38152,09/01/2017 12:00:00 AM,130,217,198
Piedmont,Lexington City,51678,43,156,199,47,292,339,3933,31223,35156,09/01/2015 12:00:00 AM,91,200,177
Piedmont,Lexington City,51678,43,159,202,49,297,346,4515,30535,35050,12/01/2015 12:00:00 AM,105,192,174
Piedmont,Lexington City,51678,43,160,203,51,314,365,4248,32133,36381,05/01/2015 12:00:00 AM,99,201,179
Piedmont,Lexington City,51678,43,164,207,51,310,361,4452,31014,35466,02/01/2015 12:00:00 AM,104,189,171
Piedmont,Lexington City,51678,43,167,210,50,321,371,4225,32608,36833,03/01/2015 12:00:00 AM,98,195,175
Piedmont,Lexington City,51678,43,179,222,49,357,406,4405,38415,42820,10/01/2014 12:00:00 AM,102,215,193
Piedmont,Lexington City,51678,44,149,193,56,282,338,5502,29118,34620,03/01/2018 12:00:00 AM,125,195,179
Piedmont,Lexington City,51678,44,150,194,57,286,343,5466,29194,34660,04/01/2018 12:00:00 AM,124,195,179
Piedmont,Lexington City,51678,44,154,198,51,293,344,4630,29805,34435,01/01/2016 12:00:00 AM,105,194,174
Piedmont,Lexington City,51678,44,156,200,50,286,336,4440,29748,34188,11/01/2015 12:00:00 AM,101,191,171
Piedmont,Lexington City,51678,45,141,186,64,275,339,5927,27291,33218,06/01/2017 12:00:00 AM,132,194,179
Piedmont,Lexington City,51678,45,142,187,62,288,350,5612,29154,34766,07/01/2017 12:00:00 AM,125,205,186
Piedmont,Lexington City,51678,45,169,214,54,323,377,4750,33615,38365,01/01/2015 12:00:00 AM,106,199,179
Piedmont,Lexington City,51678,45,172,217,53,336,389,5022,36378,41400,12/01/2014 12:00:00 AM,112,212,191
Piedmont,Lexington City,51678,45,181,226,53,351,404,4540,39981,44521,05/01/2014 12:00:00 AM,101,221,197
Piedmont,Lexington City,51678,45,181,226,53,354,407,4519,35282,39801,09/01/2014 12:00:00 AM,100,195,176
Piedmont,Lexington City,51678,45,181,226,54,352,406,4607,36642,41249,07/01/2014 12:00:00 AM,102,202,183
Piedmont,Lexington City,51678,45,184,229,53,359,412,4526,37301,41827,08/01/2014 12:00:00 AM,101,203,183
Piedmont,Lexington City,51678,45,193,238,55,360,415,5094,40255,45349,03/01/2014 12:00:00 AM,113,209,191
Piedmont,Lexington City,51678,46,146,192,54,272,326,12445,64120,76565,06/01/2021 12:00:00 AM,271,439,399
Piedmont,Lexington City,51678,46,150,196,55,284,339,5370,30300,35670,02/01/2016 12:00:00 AM,117,202,182
Piedmont,Lexington City,51678,46,152,198,52,297,349,4769,30302,35071,03/01/2016 12:00:00 AM,104,199,177
Piedmont,Lexington City,51678,46,154,200,54,285,339,5107,30476,35583,10/01/2015 12:00:00 AM,111,198,178
Piedmont,Lexington City,51678,46,167,213,54,330,384,4998,35168,40166,11/01/2014 12:00:00 AM,109,211,189
Piedmont,Lexington City,51678,46,188,234,54,360,414,4494,40938,45432,04/01/2014 12:00:00 AM,98,218,194
Piedmont,Lexington City,51678,46,191,237,56,366,422,4910,38814,43724,01/01/2014 12:00:00 AM,107,203,184
Piedmont,Lexington City,51678,47,141,188,66,275,341,6315,28138,34453,05/01/2017 12:00:00 AM,134,200,183
Piedmont,Lexington City,51678,47,143,190,57,279,336,13186,62867,76053,04/01/2021 12:00:00 AM,281,440,400
Piedmont,Lexington City,51678,47,143,190,57,282,339,13256,62132,75388,03/01/2021 12:00:00 AM,282,434,397
Piedmont,Lexington City,51678,47,143,190,65,268,333,5717,25807,31524,03/01/2017 12:00:00 AM,122,180,166
Piedmont,Lexington City,51678,47,144,191,55,276,331,4851,28453,33304,04/01/2016 12:00:00 AM,103,198,174
Piedmont,Lexington City,51678,47,147,194,58,289,347,12876,61582,74458,01/01/2021 12:00:00 AM,274,419,384
Piedmont,Lexington City,51678,47,149,196,58,289,347,11433,52840,64273,12/01/2020 12:00:00 AM,243,355,328
Piedmont,Lexington City,51678,47,183,230,56,365,421,4798,39555,44353,06/01/2014 12:00:00 AM,102,216,193
Piedmont,Lexington City,51678,47,186,233,60,346,406,5661,37347,43008,12/01/2013 12:00:00 AM,120,201,185
Piedmont,Lexington City,51678,48,137,185,70,265,335,6475,26232,32707,04/01/2017 12:00:00 AM,135,191,177
Piedmont,Lexington City,51678,48,140,188,55,277,332,12297,59961,72258,02/01/2021 12:00:00 AM,256,428,384
Piedmont,Lexington City,51678,48,141,189,61,263,324,6004,26646,32650,05/01/2016 12:00:00 AM,125,189,173
Piedmont,Lexington City,51678,48,145,193,59,279,338,13491,62795,76286,05/01/2021 12:00:00 AM,281,433,395
Piedmont,Lexington City,51678,48,188,236,59,354,413,5582,40131,45713,02/01/2014 12:00:00 AM,116,213,194
Piedmont,Lexington City,51678,49,145,194,62,284,346,6116,30185,36301,06/01/2016 12:00:00 AM,125,208,187
Piedmont,Lexington City,51678,49,148,197,64,287,351,5998,28450,34448,12/01/2016 12:00:00 AM,122,192,175
Piedmont,Lexington City,51678,49,185,234,64,361,425,6894,41934,48828,12/01/2012 12:00:00 AM,141,227,209
Piedmont,Lexington City,51678,50,140,190,68,262,330,7012,27508,34520,07/01/2016 12:00:00 AM,140,196,182
Piedmont,Lexington City,51678,50,147,197,68,283,351,5864,27309,33173,01/01/2017 12:00:00 AM,117,186,168
Piedmont,Lexington City,51678,50,177,227,66,346,412,7168,39830,46998,10/01/2012 12:00:00 AM,143,225,207
Piedmont,Lexington City,51678,50,184,234,68,339,407,6800,36710,43510,11/01/2013 12:00:00 AM,136,200,186
Piedmont,Lexington City,51678,50,185,235,65,365,430,6593,41973,48566,02/01/2013 12:00:00 AM,132,227,207
Piedmont,Lexington City,51678,51,146,197,69,276,345,7079,28930,36009,10/01/2016 12:00:00 AM,139,198,183
Piedmont,Lexington City,51678,51,179,230,69,346,415,7861,40936,48797,11/01/2012 12:00:00 AM,154,229,212
Piedmont,Lexington City,51678,51,182,233,64,346,410,6254,40567,46821,08/01/2012 12:00:00 AM,123,223,201
Piedmont,Lexington City,51678,51,188,239,67,369,436,7033,41961,48994,01/01/2013 12:00:00 AM,138,223,205
Piedmont,Lexington City,51678,52,142,194,70,267,337,7236,27902,35138,08/01/2016 12:00:00 AM,139,196,181
Piedmont,Lexington City,51678,52,179,231,65,346,411,6322,40420,46742,07/01/2012 12:00:00 AM,122,226,202
Piedmont,Lexington City,51678,52,179,231,71,336,407,7748,38834,46582,10/01/2013 12:00:00 AM,149,217,202
Piedmont,Lexington City,51678,52,180,232,69,346,415,7227,39913,47140,09/01/2013 12:00:00 AM,139,222,203
Piedmont,Lexington City,51678,52,181,233,69,358,427,7304,41456,48760,03/01/2013 12:00:00 AM,140,229,209
Piedmont,Lexington City,51678,53,146,199,71,281,352,7226,27861,35087,11/01/2016 12:00:00 AM,136,191,176
Piedmont,Lexington City,51678,53,165,218,67,326,393,6521,37410,43931,02/01/2012 12:00:00 AM,123,227,202
Piedmont,Lexington City,51678,53,187,240,72,365,437,7263,42349,49612,09/01/2012 12:00:00 AM,137,226,207
Piedmont,Lexington City,51678,54,145,199,74,273,347,8014,29012,37026,09/01/2016 12:00:00 AM,148,200,186
Piedmont,Lexington City,51678,54,150,204,80,285,365,7209,28136,35345,02/01/2017 12:00:00 AM,134,188,173
Piedmont,Lexington City,51678,54,169,223,67,329,396,6520,38553,45073,05/01/2012 12:00:00 AM,121,228,202
Piedmont,Lexington City,51678,54,182,236,73,358,431,7837,40252,48089,08/01/2013 12:00:00 AM,145,221,204
Piedmont,Lexington City,51678,55,165,220,71,324,395,6795,36673,43468,01/01/2012 12:00:00 AM,124,222,198
Piedmont,Lexington City,51678,55,170,225,70,330,400,6833,38991,45824,06/01/2012 12:00:00 AM,124,229,204
Piedmont,Lexington City,51678,55,181,236,75,350,425,7865,40745,48610,04/01/2013 12:00:00 AM,143,225,206
Piedmont,Lexington City,51678,55,182,237,75,359,434,8035,41707,49742,07/01/2013 12:00:00 AM,146,229,210
Piedmont,Lexington City,51678,56,167,223,73,330,403,7252,37787,45039,03/01/2012 12:00:00 AM,130,226,202
Piedmont,Lexington City,51678,56,182,238,79,354,433,8806,40480,49286,05/01/2013 12:00:00 AM,157,222,207
Piedmont,Lexington City,51678,56,187,243,77,375,452,8175,42926,51101,06/01/2013 12:00:00 AM,146,230,210
Piedmont,Lexington City,51678,58,168,226,77,322,399,7317,38152,45469,04/01/2012 12:00:00 AM,126,227,201
Piedmont,Lynchburg City,51680,1114,4553,5667,1421,9733,11154,319438,2061164,2380602,02/01/2021 12:00:00 AM,287,453,420
Piedmont,Lynchburg City,51680,1129,4508,5637,1480,9639,11119,329699,2025328,2355027,03/01/2021 12:00:00 AM,292,449,418
Piedmont,Lynchburg City,51680,1132,3945,5077,1516,8836,10352,147007,1040689,1187696,02/01/2020 12:00:00 AM,130,264,234
Piedmont,Lynchburg City,51680,1134,3987,5121,1518,8907,10425,145868,1046471,1192339,01/01/2020 12:00:00 AM,129,262,233
Piedmont,Lynchburg City,51680,1143,4056,5199,1543,9002,10545,281923,1541128,1823051,03/01/2020 12:00:00 AM,247,380,351
Piedmont,Lynchburg City,51680,1143,4476,5619,1505,9599,11104,356775,2174349,2531124,04/01/2021 12:00:00 AM,312,486,450
Piedmont,Lynchburg City,51680,1151,3916,5067,1528,8819,10347,149958,1043415,1193373,11/01/2019 12:00:00 AM,130,266,236
Piedmont,Lynchburg City,51680,1158,3984,5142,1541,8928,10469,154771,1056121,1210892,12/01/2019 12:00:00 AM,134,265,235
Piedmont,Lynchburg City,51680,1160,4465,5625,1536,9541,11077,362040,2170093,2532133,05/01/2021 12:00:00 AM,312,486,450
Piedmont,Lynchburg City,51680,1166,3958,5124,1523,8875,10398,151424,1063396,1214820,10/01/2019 12:00:00 AM,130,269,237
Piedmont,Lynchburg City,51680,1168,4444,5612,1572,9661,11233,292742,1681550,1974292,04/01/2020 12:00:00 AM,251,378,352
Piedmont,Lynchburg City,51680,1171,4508,5679,1547,9617,11164,367092,2188779,2555871,06/01/2021 12:00:00 AM,313,486,450
Piedmont,Lynchburg City,51680,1172,4655,5827,1577,9948,11525,291342,1718642,2009984,06/01/2020 12:00:00 AM,249,369,345
Piedmont,Lynchburg City,51680,1173,4534,5707,1555,9667,11222,304225,1775552,2079777,11/01/2020 12:00:00 AM,259,392,364
Piedmont,Lynchburg City,51680,1175,3978,5153,1554,8961,10515,152934,1060639,1213573,09/01/2019 12:00:00 AM,130,267,236
Piedmont,Lynchburg City,51680,1177,4448,5625,1588,9513,11101,350284,1972992,2323276,01/01/2021 12:00:00 AM,298,444,413
Piedmont,Lynchburg City,51680,1177,4524,5701,1581,9676,11257,306691,1774591,2081282,12/01/2020 12:00:00 AM,261,392,365
Piedmont,Lynchburg City,51680,1178,4612,5790,1558,9834,11392,301619,1799067,2100686,10/01/2020 12:00:00 AM,256,390,363
Piedmont,Lynchburg City,51680,1181,4572,5753,1595,9881,11476,292580,1698190,1990770,05/01/2020 12:00:00 AM,248,371,346
Piedmont,Lynchburg City,51680,1190,3986,5176,1573,8983,10556,153643,1070232,1223875,08/01/2019 12:00:00 AM,129,268,236
Piedmont,Lynchburg City,51680,1193,3966,5159,1587,8973,10560,157666,1064143,1221809,07/01/2019 12:00:00 AM,132,268,237
Piedmont,Lynchburg City,51680,1195,4662,5857,1616,9902,11518,295485,1708180,2003665,09/01/2020 12:00:00 AM,247,366,342
Piedmont,Lynchburg City,51680,1196,4713,5909,1598,9971,11569,291654,1716208,2007862,08/01/2020 12:00:00 AM,244,364,340
Piedmont,Lynchburg City,51680,1203,4730,5933,1628,10098,11726,301888,1738469,2040357,07/01/2020 12:00:00 AM,251,368,344
Piedmont,Lynchburg City,51680,1218,3880,5098,1630,8810,10440,155956,1037722,1193678,05/01/2019 12:00:00 AM,128,267,234
Piedmont,Lynchburg City,51680,1221,3931,5152,1638,8912,10550,158854,1050382,1209236,06/01/2019 12:00:00 AM,130,267,235
Piedmont,Lynchburg City,51680,1237,3731,4968,1675,8536,10211,157296,998076,1155372,02/01/2019 12:00:00 AM,127,268,233
Piedmont,Lynchburg City,51680,1238,3839,5077,1653,8749,10402,157039,1033398,1190437,04/01/2019 12:00:00 AM,127,269,234
Piedmont,Lynchburg City,51680,1245,3926,5171,1674,8964,10638,161606,1069784,1231390,11/01/2018 12:00:00 AM,130,272,238
Piedmont,Lynchburg City,51680,1246,3864,5110,1665,8821,10486,154385.2,1068256,1222641.2,01/01/2019 12:00:00 AM,124,276,239
Piedmont,Lynchburg City,51680,1247,3847,5094,1668,8777,10445,157417,1026660,1184077,03/01/2019 12:00:00 AM,126,267,232
Piedmont,Lynchburg City,51680,1254,3973,5227,1682,9050,10732,168804,1079109,1247913,10/01/2018 12:00:00 AM,135,272,239
Piedmont,Lynchburg City,51680,1256,3926,5182,1697,8950,10647,167239,1062678,1229917,12/01/2018 12:00:00 AM,133,271,237
Piedmont,Lynchburg City,51680,1263,4255,5518,1821,9696,11517,177298,1163249,1340547,02/01/2017 12:00:00 AM,140,273,243
Piedmont,Lynchburg City,51680,1270,3965,5235,1727,9051,10778,169671,1080125,1249796,09/01/2018 12:00:00 AM,134,272,239
Piedmont,Lynchburg City,51680,1272,4123,5395,1790,9467,11257,184611,1164630,1349241,07/01/2017 12:00:00 AM,145,282,250
Piedmont,Lynchburg City,51680,1274,4012,5286,1747,9139,10886,170108,1101046,1271154,08/01/2018 12:00:00 AM,134,274,240
Piedmont,Lynchburg City,51680,1276,4025,5301,1812,9193,11005,174179,1095105,1269284,02/01/2018 12:00:00 AM,137,272,239
Piedmont,Lynchburg City,51680,1278,4019,5297,1790,9158,10948,176444,1099696,1276140,07/01/2018 12:00:00 AM,138,274,241
Piedmont,Lynchburg City,51680,1278,4036,5314,1801,9203,11004,174292,1103696,1277988,03/01/2018 12:00:00 AM,136,273,240
Piedmont,Lynchburg City,51680,1280,4163,5443,1809,9603,11412,186742,1174537,1361279,08/01/2017 12:00:00 AM,146,282,250
Piedmont,Lynchburg City,51680,1281,4052,5333,1804,9196,11000,176067,1113548,1289615,06/01/2018 12:00:00 AM,137,275,242
Piedmont,Lynchburg City,51680,1285,4019,5304,1810,9083,10893,176836,1085501,1262337,05/01/2018 12:00:00 AM,138,270,238
Piedmont,Lynchburg City,51680,1286,4049,5335,1820,9274,11094,176008,1095883,1271891,01/01/2018 12:00:00 AM,137,271,238
Piedmont,Lynchburg City,51680,1287,4065,5352,1824,9424,11248,183116,1124365,1307481,12/01/2017 12:00:00 AM,142,277,244
Piedmont,Lynchburg City,51680,1287,4137,5424,1821,9501,11322,188284,1171143,1359427,06/01/2017 12:00:00 AM,146,283,251
Piedmont,Lynchburg City,51680,1289,4090,5379,1826,9457,11283,186009,1137376,1323385,10/01/2017 12:00:00 AM,144,278,246
Piedmont,Lynchburg City,51680,1291,4081,5372,1825,9479,11304,181540,1128359,1309899,11/01/2017 12:00:00 AM,141,276,244
Piedmont,Lynchburg City,51680,1291,4148,5439,1834,9504,11338,182293,1146199,1328492,04/01/2017 12:00:00 AM,141,276,244
Piedmont,Lynchburg City,51680,1293,4023,5316,1819,9129,10948,181566,1106857,1288423,04/01/2018 12:00:00 AM,140,275,242
Piedmont,Lynchburg City,51680,1293,4138,5431,1850,9462,11312,186885,1148070,1334955,05/01/2017 12:00:00 AM,145,277,246
Piedmont,Lynchburg City,51680,1293,4149,5442,1831,9580,11411,189675,1168674,1358349,09/01/2017 12:00:00 AM,147,282,250
Piedmont,Lynchburg City,51680,1298,4231,5529,1839,9658,11497,181487,1168348,1349835,03/01/2017 12:00:00 AM,140,276,244
Piedmont,Lynchburg City,51680,1348,4295,5643,1993,9839,11832,197771,1168954,1366725,12/01/2016 12:00:00 AM,147,272,242
Piedmont,Lynchburg City,51680,1348,4337,5685,1969,9942,11911,190082,1175962,1366044,01/01/2017 12:00:00 AM,141,271,240
Piedmont,Lynchburg City,51680,1352,4333,5685,2010,9923,11933,205048,1186594,1391642,11/01/2016 12:00:00 AM,152,274,245
Piedmont,Lynchburg City,51680,1354,4420,5774,2020,10165,12185,210353,1216957,1427310,09/01/2016 12:00:00 AM,155,275,247
Piedmont,Lynchburg City,51680,1359,4344,5703,2039,9996,12035,209400,1190464,1399864,10/01/2016 12:00:00 AM,154,274,245
Piedmont,Lynchburg City,51680,1361,4434,5795,2019,10197,12216,210991,1240697,1451688,05/01/2016 12:00:00 AM,155,280,251
Piedmont,Lynchburg City,51680,1366,4396,5762,2044,10113,12157,213566,1220115.3,1433681.3,07/01/2016 12:00:00 AM,156,278,249
Piedmont,Lynchburg City,51680,1369,4406,5775,2059,10115,12174,216592,1216266.7,1432858.7,08/01/2016 12:00:00 AM,158,276,248
Piedmont,Lynchburg City,51680,1379,4418,5797,2075,10121,12196,216241,1242176,1458417,06/01/2016 12:00:00 AM,157,281,252
Piedmont,Lynchburg City,51680,1383,4463,5846,2092,10295,12387,215734,1228424,1444158,03/01/2016 12:00:00 AM,156,275,247
Piedmont,Lynchburg City,51680,1384,4445,5829,2073,10251,12324,213341,1226583,1439924,04/01/2016 12:00:00 AM,154,276,247
Piedmont,Lynchburg City,51680,1384,4467,5851,2087,10327,12414,213749,1223548,1437297,01/01/2016 12:00:00 AM,154,274,246
Piedmont,Lynchburg City,51680,1397,4478,5875,2133,10312,12445,220313,1229011,1449324,02/01/2016 12:00:00 AM,158,274,247
Piedmont,Lynchburg City,51680,1399,4610,6009,2128,10581,12709,222179,1269001,1491180,11/01/2015 12:00:00 AM,159,275,248
Piedmont,Lynchburg City,51680,1406,4541,5947,2142,10434,12576,219730,1246435,1466165,12/01/2015 12:00:00 AM,156,274,247
Piedmont,Lynchburg City,51680,1416,4620,6036,2157,10591,12748,223200,1280948,1504148,10/01/2015 12:00:00 AM,158,277,249
Piedmont,Lynchburg City,51680,1434,4665,6099,2204,10680,12884,230840,1293867,1524707,09/01/2015 12:00:00 AM,161,277,250
Piedmont,Lynchburg City,51680,1448,4679,6127,2228,10687,12915,236965,1292141,1529106,08/01/2015 12:00:00 AM,164,276,250
Piedmont,Lynchburg City,51680,1452,4682,6134,2264,10669,12933,241800,1281910,1523710,05/01/2015 12:00:00 AM,167,274,248
Piedmont,Lynchburg City,51680,1453,4700,6153,2289,10697,12986,244762,1284466,1529228,02/01/2015 12:00:00 AM,168,273,249
Piedmont,Lynchburg City,51680,1454,4713,6167,2304,10736,13040,247123,1276217,1523340,03/01/2015 12:00:00 AM,170,271,247
Piedmont,Lynchburg City,51680,1457,4727,6184,2286,10749,13035,244855,1282477,1527332,04/01/2015 12:00:00 AM,168,271,247
Piedmont,Lynchburg City,51680,1462,4695,6157,2249,10702,12951,240337,1291197,1531534,07/01/2015 12:00:00 AM,164,275,249
Piedmont,Lynchburg City,51680,1467,5643,7110,2363,11918,14281,249500,1435498,1684998,02/01/2014 12:00:00 AM,170,254,237
Piedmont,Lynchburg City,51680,1468,5773,7241,2320,12147,14467,249092,1482530,1731622,11/01/2013 12:00:00 AM,170,257,239
Piedmont,Lynchburg City,51680,1470,4851,6321,2292,10922,13214,242948,1304002,1546950,01/01/2015 12:00:00 AM,165,269,245
Piedmont,Lynchburg City,51680,1470,5676,7146,2362,11935,14297,249883,1429570,1679453,01/01/2014 12:00:00 AM,170,252,235
Piedmont,Lynchburg City,51680,1471,5586,7057,2349,11835,14184,246957,1430072,1677029,03/01/2014 12:00:00 AM,168,256,238
Piedmont,Lynchburg City,51680,1475,5711,7186,2362,12012,14374,249376,1445253,1694629,12/01/2013 12:00:00 AM,169,253,236
Piedmont,Lynchburg City,51680,1476,4707,6183,2297,10700,12997,245575,1293377,1538952,06/01/2015 12:00:00 AM,166,275,249
Piedmont,Lynchburg City,51680,1478,5534,7012,2349,11755,14104,246169,1420443,1666612,04/01/2014 12:00:00 AM,167,257,238
Piedmont,Lynchburg City,51680,1482,5874,7356,2369,12393,14762,277321,1648897,1926218,07/01/2013 12:00:00 AM,187,281,262
Piedmont,Lynchburg City,51680,1484,5447,6931,2338,11638,13976,243715,1398733,1642448,05/01/2014 12:00:00 AM,164,257,237
Piedmont,Lynchburg City,51680,1485,5884,7369,2351,12466,14817,277200,1672342,1949542,08/01/2013 12:00:00 AM,187,284,265
Piedmont,Lynchburg City,51680,1487,5024,6511,2313,11139,13452,253492,1361858,1615350,11/01/2014 12:00:00 AM,170,271,248
Piedmont,Lynchburg City,51680,1488,4929,6417,2340,10986,13326,256148,1333331,1589479,12/01/2014 12:00:00 AM,172,271,248
Piedmont,Lynchburg City,51680,1491,5795,7286,2394,12132,14526,281874,1591255,1873129,10/01/2013 12:00:00 AM,189,275,257
Piedmont,Lynchburg City,51680,1494,5858,7352,2386,12291,14677,273972,1613841,1887813,09/01/2013 12:00:00 AM,183,275,257
Piedmont,Lynchburg City,51680,1498,5869,7367,2434,12341,14775,286499,1639692,1926191,06/01/2013 12:00:00 AM,191,279,261
Piedmont,Lynchburg City,51680,1499,5405,6904,2343,11613,13956,245171,1395129,1640300,06/01/2014 12:00:00 AM,164,258,238
Piedmont,Lynchburg City,51680,1501,5127,6628,2366,11304,13670,257694,1394700,1652394,10/01/2014 12:00:00 AM,172,272,249
Piedmont,Lynchburg City,51680,1508,5772,7280,2459,12102,14561,285483,1592769,1878252,05/01/2013 12:00:00 AM,189,276,258
Piedmont,Lynchburg City,51680,1519,5367,6886,2375,11577,13952,251140,1379700,1630840,07/01/2014 12:00:00 AM,165,257,237
Piedmont,Lynchburg City,51680,1529,5216,6745,2398,11413,13811,249246,1350761,1600007,09/01/2014 12:00:00 AM,163,259,237
Piedmont,Lynchburg City,51680,1535,5668,7203,2520,11903,14423,292393,1563212,1855605,04/01/2013 12:00:00 AM,190,276,258
Piedmont,Lynchburg City,51680,1537,5305,6842,2417,11507,13924,253486,1370379,1623865,08/01/2014 12:00:00 AM,165,258,237
Piedmont,Lynchburg City,51680,1564,5602,7166,2597,11755,14352,301735,1543405,1845140,02/01/2013 12:00:00 AM,193,276,257
Piedmont,Lynchburg City,51680,1564,5638,7202,2635,11884,14519,317031,1581741,1898772,10/01/2012 12:00:00 AM,203,281,264
Piedmont,Lynchburg City,51680,1566,5648,7214,2609,11817,14426,306289,1554589,1860878,03/01/2013 12:00:00 AM,196,275,258
Piedmont,Lynchburg City,51680,1571,5572,7143,2668,11727,14395,318538,1558682,1877220,09/01/2012 12:00:00 AM,203,280,263
Piedmont,Lynchburg City,51680,1572,5596,7168,2654,11766,14420,316568,1556503,1873071,11/01/2012 12:00:00 AM,201,278,261
Piedmont,Lynchburg City,51680,1579,5556,7135,2676,11655,14331,317966,1541742,1859708,12/01/2012 12:00:00 AM,201,277,261
Piedmont,Lynchburg City,51680,1582,5558,7140,2699,11740,14439,319641,1554350,1873991,08/01/2012 12:00:00 AM,202,280,262
Piedmont,Lynchburg City,51680,1582,5577,7159,2633,11674,14307,306101,1526038,1832139,01/01/2013 12:00:00 AM,193,274,256
Piedmont,Lynchburg City,51680,1585,5446,7031,2724,11462,14186,327235,1498654,1825889,06/01/2012 12:00:00 AM,206,275,260
Piedmont,Lynchburg City,51680,1588,5515,7103,2746,11625,14371,413940,1868628,2282568,07/01/2012 12:00:00 AM,261,339,321
Piedmont,Lynchburg City,51680,1602,5398,7000,2779,11359,14138,334921,1478793,1813714,05/01/2012 12:00:00 AM,209,274,259
Piedmont,Lynchburg City,51680,1607,5340,6947,2832,11306,14138,343796,1458422,1802218,04/01/2012 12:00:00 AM,214,273,259
Piedmont,Lynchburg City,51680,1640,5283,6923,2926,11181,14107,358791,1443494,1802285,03/01/2012 12:00:00 AM,219,273,260
Piedmont,Lynchburg City,51680,1650,5260,6910,2980,11124,14104,364008,1439517,1803525,02/01/2012 12:00:00 AM,221,274,261
Piedmont,Lynchburg City,51680,1663,5221,6884,3031,11008,14039,368228,1404725,1772953,01/01/2012 12:00:00 AM,221,269,258
Piedmont,Martinsville City,51690,328,1498,1826,437,2948,3385,80908,512025,592933,03/01/2020 12:00:00 AM,247,342,325
Piedmont,Martinsville City,51690,330,1626,1956,404,3185,3589,91744,687807,779551,02/01/2021 12:00:00 AM,278,423,399
Piedmont,Martinsville City,51690,334,1472,1806,443,2887,3330,37330,340650,377980,01/01/2020 12:00:00 AM,112,231,209
Piedmont,Martinsville City,51690,334,1486,1820,438,2935,3373,39395,353594,392989,12/01/2019 12:00:00 AM,118,238,216
Piedmont,Martinsville City,51690,335,1612,1947,439,3115,3554,96859,655722,752581,01/01/2021 12:00:00 AM,289,407,387
Piedmont,Martinsville City,51690,336,1496,1832,446,2938,3384,38712,351141,389853,02/01/2020 12:00:00 AM,115,235,213
Piedmont,Martinsville City,51690,337,1602,1939,443,3143,3586,81426,555906,637332,04/01/2020 12:00:00 AM,242,347,329
Piedmont,Martinsville City,51690,337,1661,1998,425,3240,3665,99042,748151,847193,04/01/2021 12:00:00 AM,294,450,424
Piedmont,Martinsville City,51690,338,1659,1997,421,3242,3663,94476,687545,782021,03/01/2021 12:00:00 AM,280,414,392
Piedmont,Martinsville City,51690,340,1660,2000,444,3247,3691,103358,757134,860492,06/01/2021 12:00:00 AM,304,456,430
Piedmont,Martinsville City,51690,342,1638,1980,452,3166,3618,87825,588101,675926,12/01/2020 12:00:00 AM,257,359,341
Piedmont,Martinsville City,51690,342,1657,1999,440,3225,3665,101672,747508,849180,05/01/2021 12:00:00 AM,297,451,425
Piedmont,Martinsville City,51690,344,1629,1973,459,3173,3632,84402,555991,640393,05/01/2020 12:00:00 AM,245,341,325
Piedmont,Martinsville City,51690,344,1646,1990,459,3200,3659,84357,560255,644612,06/01/2020 12:00:00 AM,245,340,324
Piedmont,Martinsville City,51690,346,1472,1818,458,2912,3370,40213,347765,387978,11/01/2019 12:00:00 AM,116,236,213
Piedmont,Martinsville City,51690,350,1677,2027,455,3249,3704,82980,567926,650906,08/01/2020 12:00:00 AM,237,339,321
Piedmont,Martinsville City,51690,351,1677,2028,468,3260,3728,87399,570593,657992,07/01/2020 12:00:00 AM,249,340,324
Piedmont,Martinsville City,51690,353,1518,1871,476,3004,3480,42701,355237,397938,07/01/2019 12:00:00 AM,121,234,213
Piedmont,Martinsville City,51690,353,1646,1999,465,3199,3664,92136,594263,686399,11/01/2020 12:00:00 AM,261,361,343
Piedmont,Martinsville City,51690,354,1491,1845,468,2944,3412,42561,354848,397409,10/01/2019 12:00:00 AM,120,238,215
Piedmont,Martinsville City,51690,356,1507,1863,479,2995,3474,43064,359264,402328,08/01/2019 12:00:00 AM,121,238,216
Piedmont,Martinsville City,51690,356,1521,1877,475,3013,3488,41646,361635,403281,09/01/2019 12:00:00 AM,117,238,215
Piedmont,Martinsville City,51690,360,1690,2050,477,3282,3759,88864,578783,667647,09/01/2020 12:00:00 AM,247,342,326
Piedmont,Martinsville City,51690,362,1653,2015,487,3188,3675,93589,591763,685352,10/01/2020 12:00:00 AM,259,358,340
Piedmont,Martinsville City,51690,367,1493,1860,509,2961,3470,45943,349951,395894,06/01/2019 12:00:00 AM,125,234,213
Piedmont,Martinsville City,51690,371,1543,1914,497,3091,3588,46607,368173,414780,03/01/2018 12:00:00 AM,126,239,217
Piedmont,Martinsville City,51690,372,1498,1870,523,2932,3455,47770,351018,398788,05/01/2019 12:00:00 AM,128,234,213
Piedmont,Martinsville City,51690,372,1638,2010,495,3300,3795,47787,399638,447425,02/01/2017 12:00:00 AM,128,244,223
Piedmont,Martinsville City,51690,373,1656,2029,504,3414,3918,49435,407382,456817,12/01/2016 12:00:00 AM,133,246,225
Piedmont,Martinsville City,51690,374,1653,2027,502,3397,3899,47929,406292,454221,01/01/2017 12:00:00 AM,128,246,224
Piedmont,Martinsville City,51690,374,1658,2032,517,3428,3945,50970,408383,459353,11/01/2016 12:00:00 AM,136,246,226
Piedmont,Martinsville City,51690,377,1389,1766,506,2751,3257,46400,320409,366809,02/01/2019 12:00:00 AM,123,231,208
Piedmont,Martinsville City,51690,378,1534,1912,498,3056,3554,46384,361640,408024,02/01/2018 12:00:00 AM,123,236,213
Piedmont,Martinsville City,51690,379,1476,1855,514,2931,3445,47102,356925,404027,01/01/2019 12:00:00 AM,124,242,218
Piedmont,Martinsville City,51690,379,1478,1857,534,2901,3435,48963,340314,389277,04/01/2019 12:00:00 AM,129,230,210
Piedmont,Martinsville City,51690,379,1529,1908,514,3054,3568,48448,362648,411096,04/01/2018 12:00:00 AM,128,237,215
Piedmont,Martinsville City,51690,380,1426,1806,507,2841,3348,47698,335675,383373,12/01/2018 12:00:00 AM,126,235,212
Piedmont,Martinsville City,51690,380,1565,1945,512,3119,3631,51625,368677,420302,11/01/2017 12:00:00 AM,136,236,216
Piedmont,Martinsville City,51690,382,1546,1928,501,3093,3594,48426,365137,413563,01/01/2018 12:00:00 AM,127,236,215
Piedmont,Martinsville City,51690,382,1548,1930,514,3096,3610,46810,372261,419071,05/01/2018 12:00:00 AM,123,240,217
Piedmont,Martinsville City,51690,384,1458,1842,510,2937,3447,46812,348325,395137,11/01/2018 12:00:00 AM,122,239,215
Piedmont,Martinsville City,51690,384,1529,1913,514,3072,3586,48337,365976,414313,06/01/2018 12:00:00 AM,126,239,217
Piedmont,Martinsville City,51690,385,1532,1917,503,3050,3553,48984,358376,407360,12/01/2017 12:00:00 AM,127,234,212
Piedmont,Martinsville City,51690,387,1685,2072,555,3483,4038,56615,420109,476724,09/01/2016 12:00:00 AM,146,249,230
Piedmont,Martinsville City,51690,389,1568,1957,522,3141,3663,52230,369457,421687,10/01/2017 12:00:00 AM,134,236,215
Piedmont,Martinsville City,51690,391,1479,1870,519,2952,3471,49371,363934,413305,10/01/2018 12:00:00 AM,126,246,221
Piedmont,Martinsville City,51690,391,1507,1898,514,3022,3536,48045,358801,406846,08/01/2018 12:00:00 AM,123,238,214
Piedmont,Martinsville City,51690,391,1513,1904,524,3026,3550,48730,359434,408164,07/01/2018 12:00:00 AM,125,238,214
Piedmont,Martinsville City,51690,391,1565,1956,536,3131,3667,51980,375545,427525,09/01/2017 12:00:00 AM,133,240,219
Piedmont,Martinsville City,51690,391,1593,1984,531,3206,3737,52991,375617,428608,04/01/2017 12:00:00 AM,136,236,216
Piedmont,Martinsville City,51690,392,1484,1876,532,2909,3441,48063,343295,391358,03/01/2019 12:00:00 AM,123,231,209
Piedmont,Martinsville City,51690,392,1665,2057,566,3437,4003,56183,410042,466225,10/01/2016 12:00:00 AM,143,246,227
Piedmont,Martinsville City,51690,393,1697,2090,565,3480,4045,57248,419669,476917,08/01/2016 12:00:00 AM,146,247,228
Piedmont,Martinsville City,51690,395,1473,1868,529,2939,3468,47801,353143,400944,09/01/2018 12:00:00 AM,121,240,215
Piedmont,Martinsville City,51690,395,1563,1958,543,3138,3681,53707,380276,433983,08/01/2017 12:00:00 AM,136,243,222
Piedmont,Martinsville City,51690,395,1906,2301,575,3802,4377,55831,458170,514001,12/01/2013 12:00:00 AM,141,240,223
Piedmont,Martinsville City,51690,396,1611,2007,537,3253,3790,52493,392549,445042,03/01/2017 12:00:00 AM,133,244,222
Piedmont,Martinsville City,51690,399,1711,2110,579,3505,4084,58773,427830.6,486603.6,07/01/2016 12:00:00 AM,147,250,231
Piedmont,Martinsville City,51690,399,1922,2321,568,3852,4420,57064,464222,521286,11/01/2013 12:00:00 AM,143,242,225
Piedmont,Martinsville City,51690,401,1580,1981,550,3179,3729,53452,387998,441450,07/01/2017 12:00:00 AM,133,246,223
Piedmont,Martinsville City,51690,402,1880,2282,594,3758,4352,58362,447134,505496,01/01/2014 12:00:00 AM,145,238,222
Piedmont,Martinsville City,51690,403,1914,2317,609,3834,4443,68601,498828,567429,04/01/2012 12:00:00 AM,170,261,245
Piedmont,Martinsville City,51690,404,1568,1972,553,3152,3705,55271,383060,438331,06/01/2017 12:00:00 AM,137,244,222
Piedmont,Martinsville City,51690,405,1593,1998,548,3224,3772,55382,391663,447045,05/01/2017 12:00:00 AM,137,246,224
Piedmont,Martinsville City,51690,405,1839,2244,591,3738,4329,59267,442379,501646,07/01/2014 12:00:00 AM,146,241,224
Piedmont,Martinsville City,51690,407,1919,2326,603,3846,4449,65572,502964,568536,10/01/2013 12:00:00 AM,161,262,244
Piedmont,Martinsville City,51690,407,1955,2362,618,3918,4536,65730,506711,572441,07/01/2013 12:00:00 AM,161,259,242
Piedmont,Martinsville City,51690,409,1737,2146,589,3543,4132,59628,437842,497470,06/01/2016 12:00:00 AM,146,252,232
Piedmont,Martinsville City,51690,410,1864,2274,608,3726,4334,60199,451174,511373,04/01/2014 12:00:00 AM,147,242,225
Piedmont,Martinsville City,51690,411,1854,2265,574,3802,4376,57016,473571,530587,06/01/2015 12:00:00 AM,139,255,234
Piedmont,Martinsville City,51690,411,1879,2290,608,3728,4336,59433,448271,507704,02/01/2014 12:00:00 AM,145,239,222
Piedmont,Martinsville City,51690,411,1946,2357,635,3871,4506,66960,506776,573736,06/01/2013 12:00:00 AM,163,260,243
Piedmont,Martinsville City,51690,411,1965,2376,615,3959,4574,66844,510301,577145,08/01/2013 12:00:00 AM,163,260,243
Piedmont,Martinsville City,51690,412,1915,2327,634,3828,4462,72647,495531,568178,05/01/2012 12:00:00 AM,176,259,244
Piedmont,Martinsville City,51690,413,1831,2244,612,3746,4358,63396,439081,502477,08/01/2014 12:00:00 AM,154,240,224
Piedmont,Martinsville City,51690,413,1863,2276,588,3812,4400,60988,474604,535592,07/01/2015 12:00:00 AM,148,255,235
Piedmont,Martinsville City,51690,413,1865,2278,608,3776,4384,60262,448996,509258,06/01/2014 12:00:00 AM,146,241,224
Piedmont,Martinsville City,51690,413,1919,2332,640,3857,4497,74192,502394,576586,02/01/2012 12:00:00 AM,180,262,247
Piedmont,Martinsville City,51690,413,1920,2333,630,3845,4475,72572,496882,569454,03/01/2012 12:00:00 AM,176,259,244
Piedmont,Martinsville City,51690,414,1755,2169,607,3570,4177,62732,442202,504934,05/01/2016 12:00:00 AM,152,252,233
Piedmont,Martinsville City,51690,414,1923,2337,623,3844,4467,67853,499338,567191,09/01/2013 12:00:00 AM,164,260,243
Piedmont,Martinsville City,51690,414,1935,2349,637,3877,4514,72316,500788,573104,01/01/2012 12:00:00 AM,175,259,244
Piedmont,Martinsville City,51690,415,1831,2246,592,3737,4329,58571,459522,518093,05/01/2015 12:00:00 AM,141,251,231
Piedmont,Martinsville City,51690,415,1880,2295,617,3729,4346,61311,451220,512531,03/01/2014 12:00:00 AM,148,240,223
Piedmont,Martinsville City,51690,415,1888,2303,593,3892,4485,59244,478284,537528,08/01/2015 12:00:00 AM,143,253,233
Piedmont,Martinsville City,51690,416,1748,2164,619,3568,4187,62741,433071,495812,04/01/2016 12:00:00 AM,151,248,229
Piedmont,Martinsville City,51690,416,1779,2195,607,3633,4240,60468,441061,501529,03/01/2016 12:00:00 AM,145,248,228
Piedmont,Martinsville City,51690,416,1833,2249,623,3747,4370,64218,442591,506809,09/01/2014 12:00:00 AM,154,241,225
Piedmont,Martinsville City,51690,416,1932,2348,645,3876,4521,73848,502081,575929,06/01/2012 12:00:00 AM,178,260,245
Piedmont,Martinsville City,51690,418,1788,2206,616,3645,4261,62488,444080,506568,02/01/2016 12:00:00 AM,149,248,230
Piedmont,Martinsville City,51690,418,1838,2256,615,3752,4367,62437,460298,522735,04/01/2015 12:00:00 AM,149,250,232
Piedmont,Martinsville City,51690,419,1827,2246,604,3693,4297,60104,451924,512028,11/01/2015 12:00:00 AM,143,247,228
Piedmont,Martinsville City,51690,419,1835,2254,603,3739,4342,59428,459023,518451,10/01/2015 12:00:00 AM,142,250,230
Piedmont,Martinsville City,51690,419,1859,2278,614,3759,4373,61578,450252,511830,05/01/2014 12:00:00 AM,147,242,225
Piedmont,Martinsville City,51690,419,1862,2281,605,3808,4413,59939,466380,526319,09/01/2015 12:00:00 AM,143,250,231
Piedmont,Martinsville City,51690,422,1952,2374,644,3890,4534,70806,507223,578029,05/01/2013 12:00:00 AM,168,260,243
Piedmont,Martinsville City,51690,423,1794,2217,611,3658,4269,62018,442848,504866,01/01/2016 12:00:00 AM,147,247,228
Piedmont,Martinsville City,51690,423,1810,2233,604,3685,4289,60527,447896,508423,12/01/2015 12:00:00 AM,143,247,228
Piedmont,Martinsville City,51690,427,1820,2247,635,3702,4337,66368,459196,525564,03/01/2015 12:00:00 AM,155,252,234
Piedmont,Martinsville City,51690,429,1924,2353,677,3846,4523,77640,502295,579935,12/01/2012 12:00:00 AM,181,261,246
Piedmont,Martinsville City,51690,431,1917,2348,685,3825,4510,79641,501377,581018,10/01/2012 12:00:00 AM,185,262,247
Piedmont,Martinsville City,51690,431,1928,2359,668,3876,4544,74188,503271,577459,03/01/2013 12:00:00 AM,172,261,245
Piedmont,Martinsville City,51690,432,1852,2284,639,3777,4416,66059,465204,531263,02/01/2015 12:00:00 AM,153,251,233
Piedmont,Martinsville City,51690,432,1903,2335,674,3821,4495,78165,504011,582176,07/01/2012 12:00:00 AM,181,265,249
Piedmont,Martinsville City,51690,432,1945,2377,689,3885,4574,79775,510950,590725,11/01/2012 12:00:00 AM,185,263,249
Piedmont,Martinsville City,51690,433,1842,2275,660,3737,4397,74044,455699,529743,10/01/2014 12:00:00 AM,171,247,233
Piedmont,Martinsville City,51690,434,1812,2246,660,3702,4362,71950,454118,526068,11/01/2014 12:00:00 AM,166,251,234
Piedmont,Martinsville City,51690,435,1921,2356,677,3886,4563,74708,505931,580639,02/01/2013 12:00:00 AM,172,263,246
Piedmont,Martinsville City,51690,436,1946,2382,679,3880,4559,77698,500946,578644,01/01/2013 12:00:00 AM,178,257,243
Piedmont,Martinsville City,51690,437,1894,2331,696,3791,4487,82220,497267,579487,09/01/2012 12:00:00 AM,188,263,249
Piedmont,Martinsville City,51690,439,1919,2358,692,3826,4518,80401,501033,581434,08/01/2012 12:00:00 AM,183,261,247
Piedmont,Martinsville City,51690,439,1954,2393,687,3894,4581,75514,507651,583165,04/01/2013 12:00:00 AM,172,260,244
Piedmont,Martinsville City,51690,442,1847,2289,665,3759,4424,70252,455840,526092,01/01/2015 12:00:00 AM,159,247,230
Piedmont,Martinsville City,51690,444,1830,2274,680,3745,4425,74442,452172,526614,12/01/2014 12:00:00 AM,168,247,232
Piedmont,Mecklenburg County,51117,403,1643,2046,481,3578,4059,37330,386162,423492,09/01/2019 12:00:00 AM,93,235,207
Piedmont,Mecklenburg County,51117,404,1621,2025,482,3529,4011,37851,379926,417777,10/01/2019 12:00:00 AM,94,234,206
Piedmont,Mecklenburg County,51117,404,1621,2025,497,3549,4046,40612,378645,419257,07/01/2019 12:00:00 AM,101,234,207
Piedmont,Mecklenburg County,51117,404,1652,2056,488,3603,4091,38403,389683,428086,08/01/2019 12:00:00 AM,95,236,208
Piedmont,Mecklenburg County,51117,405,1572,1977,478,3404,3882,37354,360699,398053,02/01/2019 12:00:00 AM,92,229,201
Piedmont,Mecklenburg County,51117,405,1611,2016,486,3495,3981,37819,361551,399370,01/01/2020 12:00:00 AM,93,224,198
Piedmont,Mecklenburg County,51117,406,1589,1995,487,3470,3957,38580,369629,408209,02/01/2020 12:00:00 AM,95,233,205
Piedmont,Mecklenburg County,51117,407,1641,2048,484,3574,4058,39161,377881,417042,12/01/2019 12:00:00 AM,96,230,204
Piedmont,Mecklenburg County,51117,414,1600,2014,498,3474,3972,93084,594771,687855,03/01/2020 12:00:00 AM,225,372,342
Piedmont,Mecklenburg County,51117,414,1628,2042,494,3542,4036,39729,373057,412786,11/01/2019 12:00:00 AM,96,229,202
Piedmont,Mecklenburg County,51117,415,1669,2084,500,3707,4207,40293,425529,465822,01/01/2019 12:00:00 AM,97,255,224
Piedmont,Mecklenburg County,51117,415,1678,2093,497,3728,4225,44212,417857,462069,10/01/2018 12:00:00 AM,107,249,221
Piedmont,Mecklenburg County,51117,417,1684,2101,498,3737,4235,42435,404234,446669,12/01/2018 12:00:00 AM,102,240,213
Piedmont,Mecklenburg County,51117,418,1650,2068,503,3615,4118,40678,387354,428032,03/01/2019 12:00:00 AM,97,235,207
Piedmont,Mecklenburg County,51117,419,1684,2103,499,3635,4134,93185,626235,719420,04/01/2020 12:00:00 AM,222,372,342
Piedmont,Mecklenburg County,51117,420,1629,2049,521,3574,4095,43471,383110,426581,06/01/2019 12:00:00 AM,104,235,208
Piedmont,Mecklenburg County,51117,421,1681,2102,503,3761,4264,43968,405673,449641,11/01/2018 12:00:00 AM,104,241,214
Piedmont,Mecklenburg County,51117,421,1702,2123,497,3747,4244,39602,403679,443281,07/01/2018 12:00:00 AM,94,237,209
Piedmont,Mecklenburg County,51117,421,1722,2143,503,3720,4223,94400,645850,740250,05/01/2020 12:00:00 AM,224,375,345
Piedmont,Mecklenburg County,51117,422,1632,2054,525,3576,4101,44228,385637,429865,05/01/2019 12:00:00 AM,105,236,209
Piedmont,Mecklenburg County,51117,424,1683,2107,507,3710,4217,42137,401265,443402,09/01/2018 12:00:00 AM,99,238,210
Piedmont,Mecklenburg County,51117,428,1700,2128,505,3727,4232,41706,409200,450906,08/01/2018 12:00:00 AM,97,241,212
Piedmont,Mecklenburg County,51117,428,1725,2153,516,3677,4193,97424,644566,741990,06/01/2020 12:00:00 AM,228,374,345
Piedmont,Mecklenburg County,51117,429,1633,2062,524,3540,4064,43900,379850,423750,04/01/2019 12:00:00 AM,102,233,206
Piedmont,Mecklenburg County,51117,429,1725,2154,506,3789,4295,41233,410568,451801,06/01/2018 12:00:00 AM,96,238,210
Piedmont,Mecklenburg County,51117,431,1745,2176,517,3719,4236,95976,634061,730037,08/01/2020 12:00:00 AM,223,363,335
Piedmont,Mecklenburg County,51117,431,1746,2177,517,3754,4271,96807,654062,750869,07/01/2020 12:00:00 AM,225,375,345
Piedmont,Mecklenburg County,51117,432,1743,2175,498,3674,4172,114280,774836.41,889116.41,02/01/2021 12:00:00 AM,265,445,409
Piedmont,Mecklenburg County,51117,434,1814,2248,522,4069,4591,43446,451849,495295,05/01/2017 12:00:00 AM,100,249,220
Piedmont,Mecklenburg County,51117,435,1734,2169,515,3688,4203,101631,684930,786561,11/01/2020 12:00:00 AM,234,395,363
Piedmont,Mecklenburg County,51117,435,1745,2180,520,3840,4360,42237,419221,461458,04/01/2018 12:00:00 AM,97,240,212
Piedmont,Mecklenburg County,51117,437,1742,2179,518,3704,4222,102481,674869,777350,12/01/2020 12:00:00 AM,235,387,357
Piedmont,Mecklenburg County,51117,437,1876,2313,518,4155,4673,43812,447761,491573,08/01/2016 12:00:00 AM,100,239,213
Piedmont,Mecklenburg County,51117,438,1718,2156,512,3631,4143,117120,768802,885922,01/01/2021 12:00:00 AM,267,447,411
Piedmont,Mecklenburg County,51117,438,1734,2172,539,3798,4337,44007,416408,460415,01/01/2018 12:00:00 AM,100,240,212
Piedmont,Mecklenburg County,51117,438,1806,2244,520,4029,4549,42731,443870,486601,07/01/2017 12:00:00 AM,98,246,217
Piedmont,Mecklenburg County,51117,439,1708,2147,525,3633,4158,104602,667144,771746,10/01/2020 12:00:00 AM,238,391,359
Piedmont,Mecklenburg County,51117,439,1761,2200,542,3914,4456,46339,436095,482434,11/01/2017 12:00:00 AM,106,248,219
Piedmont,Mecklenburg County,51117,440,1818,2258,525,4102,4627,42802,457039,499841,06/01/2017 12:00:00 AM,97,251,221
Piedmont,Mecklenburg County,51117,440,1846,2286,541,4102,4643,45348,446378,491726,10/01/2016 12:00:00 AM,103,242,215
Piedmont,Mecklenburg County,51117,441,1754,2195,549,3866,4415,46166,425949,472115,12/01/2017 12:00:00 AM,105,243,215
Piedmont,Mecklenburg County,51117,442,1728,2170,528,3760,4288,45173,412415,457588,05/01/2018 12:00:00 AM,102,239,211
Piedmont,Mecklenburg County,51117,442,1756,2198,537,3852,4389,42927,421939,464866,03/01/2018 12:00:00 AM,97,240,211
Piedmont,Mecklenburg County,51117,442,1767,2209,536,3891,4427,42981,422413,465394,02/01/2018 12:00:00 AM,97,239,211
Piedmont,Mecklenburg County,51117,442,1843,2285,537,4081,4618,45439,438826,484265,09/01/2016 12:00:00 AM,103,238,212
Piedmont,Mecklenburg County,51117,442,1875,2317,532,4175,4707,46068,448339,494407,07/01/2016 12:00:00 AM,104,239,213
Piedmont,Mecklenburg County,51117,443,1716,2159,533,3657,4190,99737,637432,737169,09/01/2020 12:00:00 AM,225,371,341
Piedmont,Mecklenburg County,51117,443,1830,2273,534,4088,4622,43588,454446,498034,04/01/2017 12:00:00 AM,98,248,219
Piedmont,Mecklenburg County,51117,446,1702,2148,512,3540,4052,122197,801016,923213,05/01/2021 12:00:00 AM,274,471,430
Piedmont,Mecklenburg County,51117,446,1751,2197,514,3679,4193,121361.1,785928.77,907289.87,03/01/2021 12:00:00 AM,272,449,413
Piedmont,Mecklenburg County,51117,446,1773,2219,545,3946,4491,44973,442886,487859,09/01/2017 12:00:00 AM,101,250,220
Piedmont,Mecklenburg County,51117,447,1798,2245,545,4008,4553,45382,446745,492127,08/01/2017 12:00:00 AM,102,248,219
Piedmont,Mecklenburg County,51117,447,1842,2289,543,4126,4669,44554,458289,502843,03/01/2017 12:00:00 AM,100,249,220
Piedmont,Mecklenburg County,51117,449,1760,2209,556,3929,4485,47509,431902,479411,10/01/2017 12:00:00 AM,106,245,217
Piedmont,Mecklenburg County,51117,449,1830,2279,554,4079,4633,45616,439859,485475,11/01/2016 12:00:00 AM,102,240,213
Piedmont,Mecklenburg County,51117,449,1836,2285,543,4074,4617,43320,442269,485589,01/01/2017 12:00:00 AM,96,241,213
Piedmont,Mecklenburg County,51117,449,1871,2320,558,4162,4720,47148,446675,493823,06/01/2016 12:00:00 AM,105,239,213
Piedmont,Mecklenburg County,51117,450,1727,2177,520,3621,4141,124209,823223,947432,04/01/2021 12:00:00 AM,276,477,435
Piedmont,Mecklenburg County,51117,451,1835,2286,551,4088,4639,45411,439610,485021,12/01/2016 12:00:00 AM,101,240,212
Piedmont,Mecklenburg County,51117,451,1853,2304,545,4151,4696,44618,457850,502468,02/01/2017 12:00:00 AM,99,247,218
Piedmont,Mecklenburg County,51117,452,1735,2187,520,3587,4107,124176,808982,933158,06/01/2021 12:00:00 AM,275,466,427
Piedmont,Mecklenburg County,51117,452,1871,2323,554,4139,4693,46149,449099,495248,05/01/2016 12:00:00 AM,102,240,213
Piedmont,Mecklenburg County,51117,454,1903,2357,558,4249,4807,47781,457988,505769,03/01/2016 12:00:00 AM,105,241,215
Piedmont,Mecklenburg County,51117,455,1890,2345,556,4201,4757,47330,452219,499549,04/01/2016 12:00:00 AM,104,239,213
Piedmont,Mecklenburg County,51117,466,1932,2398,585,4313,4898,52490,459611,512101,02/01/2016 12:00:00 AM,113,238,214
Piedmont,Mecklenburg County,51117,469,1920,2389,601,4246,4847,55386,453384,508770,01/01/2016 12:00:00 AM,118,236,213
Piedmont,Mecklenburg County,51117,469,1937,2406,603,4286,4889,54964,459356,514320,12/01/2015 12:00:00 AM,117,237,214
Piedmont,Mecklenburg County,51117,470,2076,2546,595,4724,5319,53801,515078,568879,11/01/2014 12:00:00 AM,114,248,223
Piedmont,Mecklenburg County,51117,473,1944,2417,617,4355,4972,54708,467193,521901,07/01/2015 12:00:00 AM,116,240,216
Piedmont,Mecklenburg County,51117,473,2069,2542,607,4718,5325,56496,515494,571990,12/01/2014 12:00:00 AM,119,249,225
Piedmont,Mecklenburg County,51117,477,1955,2432,623,4330,4953,56113,470838,526951,11/01/2015 12:00:00 AM,118,241,217
Piedmont,Mecklenburg County,51117,478,1967,2445,721,4569,5290,71402,506683,578085,01/01/2012 12:00:00 AM,149,258,236
Piedmont,Mecklenburg County,51117,479,2065,2544,631,4680,5311,56213,507118,563331,01/01/2015 12:00:00 AM,117,246,221
Piedmont,Mecklenburg County,51117,480,1950,2430,637,4297,4934,57235,463955,521190,09/01/2015 12:00:00 AM,119,238,214
Piedmont,Mecklenburg County,51117,480,1967,2447,639,4421,5060,58743,481646,540389,05/01/2015 12:00:00 AM,122,245,221
Piedmont,Mecklenburg County,51117,481,2037,2518,632,4655,5287,56950,511661,568611,10/01/2014 12:00:00 AM,118,251,226
Piedmont,Mecklenburg County,51117,482,1960,2442,632,4315,4947,58180,467603,525783,10/01/2015 12:00:00 AM,121,239,215
Piedmont,Mecklenburg County,51117,482,1989,2471,707,4609,5316,68482,525836,594318,04/01/2012 12:00:00 AM,142,264,241
Piedmont,Mecklenburg County,51117,482,2006,2488,687,4666,5353,67184,534151,601335,05/01/2012 12:00:00 AM,139,266,242
Piedmont,Mecklenburg County,51117,483,1939,2422,630,4357,4987,57289,469078,526367,06/01/2015 12:00:00 AM,119,242,217
Piedmont,Mecklenburg County,51117,483,1954,2437,633,4350,4983,56815,472453,529268,08/01/2015 12:00:00 AM,118,242,217
Piedmont,Mecklenburg County,51117,483,2045,2528,632,4609,5241,56873,509729,566602,02/01/2015 12:00:00 AM,118,249,224
Piedmont,Mecklenburg County,51117,484,1977,2461,728,4599,5327,72261,520665,592926,02/01/2012 12:00:00 AM,149,263,241
Piedmont,Mecklenburg County,51117,484,2093,2577,633,4729,5362,53863,506179,560042,06/01/2014 12:00:00 AM,111,242,217
Piedmont,Mecklenburg County,51117,484,2150,2634,672,4840,5512,61699,523483,585182,12/01/2013 12:00:00 AM,127,243,222
Piedmont,Mecklenburg County,51117,485,2142,2627,652,4810,5462,54720,520258,574978,04/01/2014 12:00:00 AM,113,243,219
Piedmont,Mecklenburg County,51117,486,2005,2491,692,4690,5382,67096,538790,605886,06/01/2012 12:00:00 AM,138,269,243
Piedmont,Mecklenburg County,51117,486,2038,2524,646,4669,5315,54128,485795,539923,09/01/2014 12:00:00 AM,111,238,214
Piedmont,Mecklenburg County,51117,486,2043,2529,641,4673,5314,52687,493856,546543,08/01/2014 12:00:00 AM,108,242,216
Piedmont,Mecklenburg County,51117,486,2146,2632,659,4829,5488,55206,524236,579442,03/01/2014 12:00:00 AM,114,244,220
Piedmont,Mecklenburg County,51117,487,2119,2606,656,4773,5429,54822,516698,571520,05/01/2014 12:00:00 AM,113,244,219
Piedmont,Mecklenburg County,51117,487,2164,2651,667,4904,5571,57646,531179,588825,02/01/2014 12:00:00 AM,118,245,222
Piedmont,Mecklenburg County,51117,488,1971,2459,730,4577,5307,71504,519002,590506,03/01/2012 12:00:00 AM,147,263,240
Piedmont,Mecklenburg County,51117,488,2133,2621,699,4864,5563,68534,564614,633148,06/01/2013 12:00:00 AM,140,265,242
Piedmont,Mecklenburg County,51117,488,2140,2628,668,4838,5506,58594,516073,574667,01/01/2014 12:00:00 AM,120,241,219
Piedmont,Mecklenburg County,51117,489,2019,2508,644,4549,5193,58015,502428,560443,03/01/2015 12:00:00 AM,119,249,223
Piedmont,Mecklenburg County,51117,489,2155,2644,685,4840,5525,62380,524291,586671,11/01/2013 12:00:00 AM,128,243,222
Piedmont,Mecklenburg County,51117,489,2170,2659,685,4883,5568,68595,572573,641168,10/01/2013 12:00:00 AM,140,264,241
Piedmont,Mecklenburg County,51117,490,1997,2487,707,4680,5387,69224,538835,608059,07/01/2012 12:00:00 AM,141,270,244
Piedmont,Mecklenburg County,51117,490,2131,2621,698,4952,5650,67586,578026,645612,03/01/2013 12:00:00 AM,138,271,246
Piedmont,Mecklenburg County,51117,491,1984,2475,650,4448,5098,59563,491581,551144,04/01/2015 12:00:00 AM,121,248,223
Piedmont,Mecklenburg County,51117,492,2067,2559,655,4700,5355,54004,496740,550744,07/01/2014 12:00:00 AM,110,240,215
Piedmont,Mecklenburg County,51117,493,2026,2519,700,4763,5463,66138,554832,620970,09/01/2012 12:00:00 AM,134,274,247
Piedmont,Mecklenburg County,51117,493,2127,2620,714,4912,5626,71114,575307,646421,04/01/2013 12:00:00 AM,144,270,247
Piedmont,Mecklenburg County,51117,495,2130,2625,716,4882,5598,71511,570628,642139,05/01/2013 12:00:00 AM,144,268,245
Piedmont,Mecklenburg County,51117,497,2132,2629,710,4969,5679,68279,580266,648545,02/01/2013 12:00:00 AM,137,272,247
Piedmont,Mecklenburg County,51117,497,2157,2654,708,4897,5605,67870,563916,631786,07/01/2013 12:00:00 AM,137,261,238
Piedmont,Mecklenburg County,51117,498,2045,2543,708,4801,5509,67850,555595,623445,10/01/2012 12:00:00 AM,136,272,245
Piedmont,Mecklenburg County,51117,499,2028,2527,718,4760,5478,69606,553122,622728,08/01/2012 12:00:00 AM,139,273,246
Piedmont,Mecklenburg County,51117,499,2172,2671,715,4913,5628,71868,572867,644735,09/01/2013 12:00:00 AM,144,264,241
Piedmont,Mecklenburg County,51117,499,2174,2673,719,4909,5628,70545,568955,639500,08/01/2013 12:00:00 AM,141,262,239
Piedmont,Mecklenburg County,51117,501,2099,2600,707,4921,5628,66158,564424,630582,01/01/2013 12:00:00 AM,132,269,243
Piedmont,Mecklenburg County,51117,504,2065,2569,711,4844,5555,67794,561254,629048,11/01/2012 12:00:00 AM,135,272,245
Piedmont,Mecklenburg County,51117,508,2062,2570,729,4875,5604,69956,566462,636418,12/01/2012 12:00:00 AM,138,275,248
Piedmont,Nelson County,51125,138,662,800,164,1411,1575,37255,295595,332850,02/01/2021 12:00:00 AM,270,447,416
Piedmont,Nelson County,51125,142,661,803,179,1396,1575,40050,290696,330746,03/01/2021 12:00:00 AM,282,440,412
Piedmont,Nelson County,51125,142,673,815,176,1429,1605,42278,315386,357664,06/01/2021 12:00:00 AM,298,469,439
Piedmont,Nelson County,51125,143,592,735,178,1281,1459,15213,140809,156022,01/01/2020 12:00:00 AM,106,238,212
Piedmont,Nelson County,51125,144,656,800,184,1382,1566,43115,309858,352973,04/01/2021 12:00:00 AM,299,472,441
Piedmont,Nelson County,51125,144,658,802,183,1390,1573,42793,315676,358469,05/01/2021 12:00:00 AM,297,480,447
Piedmont,Nelson County,51125,145,656,801,189,1390,1579,41978,291557,333535,01/01/2021 12:00:00 AM,290,444,416
Piedmont,Nelson County,51125,145,673,818,190,1435,1625,37189,263151,300340,12/01/2020 12:00:00 AM,256,391,367
Piedmont,Nelson County,51125,145,680,825,194,1549,1743,17789,175720,193509,03/01/2017 12:00:00 AM,123,258,235
Piedmont,Nelson County,51125,147,613,760,183,1320,1503,33967,224823,258790,03/01/2020 12:00:00 AM,231,367,341
Piedmont,Nelson County,51125,147,614,761,184,1324,1508,17651,147997,165648,07/01/2019 12:00:00 AM,120,241,218
Piedmont,Nelson County,51125,148,604,752,189,1311,1500,16420,143323,159743,02/01/2020 12:00:00 AM,111,237,212
Piedmont,Nelson County,51125,148,612,760,185,1314,1499,16503,144352,160855,06/01/2019 12:00:00 AM,112,236,212
Piedmont,Nelson County,51125,148,620,768,183,1363,1546,17799,155550,173349,10/01/2018 12:00:00 AM,120,251,226
Piedmont,Nelson County,51125,148,667,815,204,1499,1703,19385,167431,186816,05/01/2017 12:00:00 AM,131,251,229
Piedmont,Nelson County,51125,148,668,816,192,1434,1626,36726,262701,299427,11/01/2020 12:00:00 AM,248,393,367
Piedmont,Nelson County,51125,148,674,822,202,1504,1706,18341,170032,188373,04/01/2017 12:00:00 AM,124,252,229
Piedmont,Nelson County,51125,149,579,728,188,1247,1435,17717,140363,158080,02/01/2019 12:00:00 AM,119,242,217
Piedmont,Nelson County,51125,149,618,767,185,1318,1503,17309,147384,164693,05/01/2019 12:00:00 AM,116,238,215
Piedmont,Nelson County,51125,149,638,787,191,1426,1617,17675,160934,178609,08/01/2018 12:00:00 AM,119,252,227
Piedmont,Nelson County,51125,149,655,804,199,1485,1684,17323,164307,181630,08/01/2017 12:00:00 AM,116,251,226
Piedmont,Nelson County,51125,149,662,811,201,1499,1700,19059,167069,186128,06/01/2017 12:00:00 AM,128,252,230
Piedmont,Nelson County,51125,150,610,760,188,1308,1496,16471,144310,160781,03/01/2019 12:00:00 AM,110,237,212
Piedmont,Nelson County,51125,150,620,770,189,1378,1567,17169,162578,179747,12/01/2018 12:00:00 AM,114,262,233
Piedmont,Nelson County,51125,150,631,781,191,1404,1595,18327,159286,177613,09/01/2018 12:00:00 AM,122,252,227
Piedmont,Nelson County,51125,151,592,743,193,1302,1495,17823,145312,163135,12/01/2019 12:00:00 AM,118,245,220
Piedmont,Nelson County,51125,151,606,757,196,1319,1515,19978,146756,166734,08/01/2019 12:00:00 AM,132,242,220
Piedmont,Nelson County,51125,151,610,761,194,1285,1479,17317,141399,158716,04/01/2019 12:00:00 AM,115,232,209
Piedmont,Nelson County,51125,151,641,792,204,1471,1675,18204,163449,181653,07/01/2017 12:00:00 AM,121,255,229
Piedmont,Nelson County,51125,151,656,807,197,1486,1683,17814,164855,182669,10/01/2017 12:00:00 AM,118,251,226
Piedmont,Nelson County,51125,151,659,810,201,1499,1700,17976,167615,185591,09/01/2017 12:00:00 AM,119,254,229
Piedmont,Nelson County,51125,152,612,764,198,1356,1554,18791,160620,179411,01/01/2019 12:00:00 AM,124,262,235
Piedmont,Nelson County,51125,152,626,778,195,1385,1580,18534,156420,174954,11/01/2018 12:00:00 AM,122,250,225
Piedmont,Nelson County,51125,153,637,790,206,1415,1621,19810,158030,177840,02/01/2018 12:00:00 AM,129,248,225
Piedmont,Nelson County,51125,153,673,826,194,1471,1665,36369,254553,290922,09/01/2020 12:00:00 AM,238,378,352
Piedmont,Nelson County,51125,154,634,788,196,1428,1624,18622,160536,179158,07/01/2018 12:00:00 AM,121,253,227
Piedmont,Nelson County,51125,154,634,788,198,1422,1620,17683,159610,177293,03/01/2018 12:00:00 AM,115,252,225
Piedmont,Nelson County,51125,154,636,790,194,1444,1638,17662,165868,183530,06/01/2018 12:00:00 AM,115,261,232
Piedmont,Nelson County,51125,154,655,809,202,1490,1692,18930,170255,189185,11/01/2017 12:00:00 AM,123,260,234
Piedmont,Nelson County,51125,154,673,827,201,1457,1658,39472,264544,304016,10/01/2020 12:00:00 AM,256,393,368
Piedmont,Nelson County,51125,155,612,767,202,1319,1521,19790,146194,165984,09/01/2019 12:00:00 AM,128,239,216
Piedmont,Nelson County,51125,155,634,789,197,1448,1645,17119,159948,177067,04/01/2018 12:00:00 AM,110,252,224
Piedmont,Nelson County,51125,155,637,792,197,1449,1646,17615,162383,179998,05/01/2018 12:00:00 AM,114,255,227
Piedmont,Nelson County,51125,155,667,822,195,1408,1603,36458,241646,278104,06/01/2020 12:00:00 AM,235,362,338
Piedmont,Nelson County,51125,155,668,823,193,1434,1627,35597,244442,280039,04/01/2020 12:00:00 AM,230,366,340
Piedmont,Nelson County,51125,155,960,1115,210,2132,2342,17991,240127,258118,02/01/2014 12:00:00 AM,116,250,231
Piedmont,Nelson County,51125,155,967,1122,210,2169,2379,17808,241934,259742,05/01/2014 12:00:00 AM,115,250,231
Piedmont,Nelson County,51125,156,640,796,206,1425,1631,19726,163984,183710,12/01/2017 12:00:00 AM,126,256,231
Piedmont,Nelson County,51125,156,673,829,198,1432,1630,36964,246362,283326,05/01/2020 12:00:00 AM,237,366,342
Piedmont,Nelson County,51125,156,682,838,194,1492,1686,35992,252271,288263,08/01/2020 12:00:00 AM,231,370,344
Piedmont,Nelson County,51125,156,713,869,207,1603,1810,19250,179871,199121,02/01/2017 12:00:00 AM,123,252,229
Piedmont,Nelson County,51125,157,623,780,210,1385,1595,18966,154115,173081,01/01/2018 12:00:00 AM,121,247,222
Piedmont,Nelson County,51125,157,914,1071,201,2092,2293,15826,233321,249147,07/01/2014 12:00:00 AM,101,255,233
Piedmont,Nelson County,51125,157,964,1121,219,2144,2363,18897,242401,261298,04/01/2014 12:00:00 AM,120,251,233
Piedmont,Nelson County,51125,158,594,752,206,1292,1498,20053,141784,161837,10/01/2019 12:00:00 AM,127,239,215
Piedmont,Nelson County,51125,158,686,844,213,1582,1795,20084,176504,196588,12/01/2016 12:00:00 AM,127,257,233
Piedmont,Nelson County,51125,158,882,1040,208,2015,2223,17544,221862,239406,08/01/2014 12:00:00 AM,111,252,230
Piedmont,Nelson County,51125,158,944,1102,205,2122,2327,17070,237987,255057,06/01/2014 12:00:00 AM,108,252,231
Piedmont,Nelson County,51125,158,961,1119,221,2147,2368,19043,238403,257446,01/01/2014 12:00:00 AM,121,248,230
Piedmont,Nelson County,51125,159,590,749,209,1286,1495,20043,142346,162389,11/01/2019 12:00:00 AM,126,241,217
Piedmont,Nelson County,51125,159,697,856,217,1595,1812,19497,176856,196353,01/01/2017 12:00:00 AM,123,254,229
Piedmont,Nelson County,51125,161,677,838,203,1451,1654,36788,249158,285946,07/01/2020 12:00:00 AM,228,368,341
Piedmont,Nelson County,51125,161,686,847,219,1581,1800,20740,177305,198045,11/01/2016 12:00:00 AM,129,258,234
Piedmont,Nelson County,51125,161,939,1100,225,2135,2360,22040,261642,283682,09/01/2013 12:00:00 AM,137,279,258
Piedmont,Nelson County,51125,161,953,1114,230,2126,2356,23589,257684,281273,10/01/2013 12:00:00 AM,147,270,252
Piedmont,Nelson County,51125,161,964,1125,224,2151,2375,18680,244216,262896,03/01/2014 12:00:00 AM,116,253,234
Piedmont,Nelson County,51125,162,945,1107,231,2122,2353,20475,239288,259763,11/01/2013 12:00:00 AM,126,253,235
Piedmont,Nelson County,51125,163,942,1105,234,2115,2349,21206,238002,259208,12/01/2013 12:00:00 AM,130,253,235
Piedmont,Nelson County,51125,164,813,977,228,1846,2074,21814,212259,234073,11/01/2014 12:00:00 AM,133,261,240
Piedmont,Nelson County,51125,164,816,980,227,1845,2072,21684,209603,231287,12/01/2014 12:00:00 AM,132,257,236
Piedmont,Nelson County,51125,164,830,994,229,1876,2105,21826,218265,240091,10/01/2014 12:00:00 AM,133,263,242
Piedmont,Nelson County,51125,164,858,1022,231,1946,2177,20239,219236,239475,09/01/2014 12:00:00 AM,123,256,234
Piedmont,Nelson County,51125,165,777,942,226,1808,2034,21889,204380,226269,08/01/2015 12:00:00 AM,133,263,240
Piedmont,Nelson County,51125,165,795,960,238,1812,2050,23154,207171,230325,06/01/2015 12:00:00 AM,140,261,240
Piedmont,Nelson County,51125,166,748,914,234,1735,1969,22258,194609,216867,09/01/2015 12:00:00 AM,134,260,237
Piedmont,Nelson County,51125,166,806,972,232,1828,2060,22313,211074,233387,02/01/2015 12:00:00 AM,134,262,240
Piedmont,Nelson County,51125,167,698,865,241,1587,1828,23469,180940,204409,10/01/2016 12:00:00 AM,141,259,236
Piedmont,Nelson County,51125,167,825,992,232,1867,2099,22206,208266,230472,01/01/2015 12:00:00 AM,133,252,232
Piedmont,Nelson County,51125,168,740,908,236,1682,1918,21998,190302,212300,12/01/2015 12:00:00 AM,131,257,234
Piedmont,Nelson County,51125,168,751,919,235,1723,1958,22085,190634,212719,10/01/2015 12:00:00 AM,131,254,231
Piedmont,Nelson County,51125,168,787,955,240,1811,2051,23477,203613,227090,07/01/2015 12:00:00 AM,140,259,238
Piedmont,Nelson County,51125,168,798,966,242,1802,2044,24012,206766,230778,05/01/2015 12:00:00 AM,143,259,239
Piedmont,Nelson County,51125,168,811,979,239,1844,2083,23643,211352,234995,04/01/2015 12:00:00 AM,141,261,240
Piedmont,Nelson County,51125,168,940,1108,237,2135,2372,22863,260100,282963,07/01/2013 12:00:00 AM,136,277,255
Piedmont,Nelson County,51125,169,732,901,235,1677,1912,22025,187038,209063,01/01/2016 12:00:00 AM,130,256,232
Piedmont,Nelson County,51125,169,758,927,234,1741,1975,21950,192224,214174,11/01/2015 12:00:00 AM,130,254,231
Piedmont,Nelson County,51125,169,939,1108,245,2149,2394,24775,263759,288534,08/01/2013 12:00:00 AM,147,281,260
Piedmont,Nelson County,51125,171,702,873,249,1590,1839,24292,179650,203942,09/01/2016 12:00:00 AM,142,256,234
Piedmont,Nelson County,51125,171,730,901,241,1680,1921,22519,192074,214593,02/01/2016 12:00:00 AM,132,263,238
Piedmont,Nelson County,51125,171,804,975,245,1817,2062,23772,208525,232297,03/01/2015 12:00:00 AM,139,259,238
Piedmont,Nelson County,51125,171,947,1118,243,2157,2400,23744,262944,286688,06/01/2013 12:00:00 AM,139,278,256
Piedmont,Nelson County,51125,174,693,867,263,1578,1841,26991,178741,205732,07/01/2016 12:00:00 AM,155,258,237
Piedmont,Nelson County,51125,174,698,872,257,1588,1845,25579,179791,205370,08/01/2016 12:00:00 AM,147,258,236
Piedmont,Nelson County,51125,175,919,1094,272,2063,2335,30083,245947,276030,11/01/2012 12:00:00 AM,172,268,252
Piedmont,Nelson County,51125,176,722,898,253,1666,1919,23697,190226,213923,03/01/2016 12:00:00 AM,135,263,238
Piedmont,Nelson County,51125,176,921,1097,273,2077,2350,29457,250506,279963,12/01/2012 12:00:00 AM,167,272,255
Piedmont,Nelson County,51125,176,966,1142,265,2165,2430,27032,266536,293568,03/01/2013 12:00:00 AM,154,276,257
Piedmont,Nelson County,51125,177,945,1122,260,2127,2387,25859,257740,283599,05/01/2013 12:00:00 AM,146,273,253
Piedmont,Nelson County,51125,178,698,876,262,1597,1859,25670,186226,211896,05/01/2016 12:00:00 AM,144,267,242
Piedmont,Nelson County,51125,179,686,865,266,1587,1853,26114,184164,210278,06/01/2016 12:00:00 AM,146,268,243
Piedmont,Nelson County,51125,179,723,902,261,1664,1925,26200,188207,214407,04/01/2016 12:00:00 AM,146,260,238
Piedmont,Nelson County,51125,180,934,1114,284,2101,2385,30898,251000,281898,10/01/2012 12:00:00 AM,172,269,253
Piedmont,Nelson County,51125,181,925,1106,284,2080,2364,29542,251885,281427,06/01/2012 12:00:00 AM,163,272,254
Piedmont,Nelson County,51125,182,951,1133,276,2122,2398,27947,259607,287554,04/01/2013 12:00:00 AM,154,273,254
Piedmont,Nelson County,51125,183,928,1111,289,2085,2374,30303,250661,280964,05/01/2012 12:00:00 AM,166,270,253
Piedmont,Nelson County,51125,183,942,1125,279,2147,2426,28072,257836,285908,01/01/2012 12:00:00 AM,153,274,254
Piedmont,Nelson County,51125,183,965,1148,284,2163,2447,30009,261842,291851,02/01/2013 12:00:00 AM,164,271,254
Piedmont,Nelson County,51125,185,906,1091,295,2043,2338,31750,245952,277702,09/01/2012 12:00:00 AM,172,271,255
Piedmont,Nelson County,51125,185,936,1121,288,2118,2406,31180,255238,286418,04/01/2012 12:00:00 AM,169,273,256
Piedmont,Nelson County,51125,185,939,1124,283,2140,2423,29374,260046,289420,02/01/2012 12:00:00 AM,159,277,257
Piedmont,Nelson County,51125,185,942,1127,295,2100,2395,31904,249878,281782,01/01/2013 12:00:00 AM,172,265,250
Piedmont,Nelson County,51125,186,908,1094,303,2055,2358,31538,244711,276249,08/01/2012 12:00:00 AM,170,270,253
Piedmont,Nelson County,51125,187,951,1138,289,2149,2438,30947,261659,292606,03/01/2012 12:00:00 AM,165,275,257
Piedmont,Nelson County,51125,189,915,1104,310,2051,2361,36098,269387,305485,07/01/2012 12:00:00 AM,191,294,277
Piedmont,Pittsylvania County,51143,680,3568,4248,856,7747,8603,73465,887243,960708,02/01/2017 12:00:00 AM,108,249,226
Piedmont,Pittsylvania County,51143,683,3486,4169,815,7190,8005,186241,1534998,1721239,02/01/2021 12:00:00 AM,273,440,413
Piedmont,Pittsylvania County,51143,686,3427,4113,828,6914,7742,197305,1567695,1765000,05/01/2021 12:00:00 AM,288,457,429
Piedmont,Pittsylvania County,51143,688,3447,4135,822,7087,7909,187038,1491577,1678615,03/01/2021 12:00:00 AM,272,433,406
Piedmont,Pittsylvania County,51143,692,3404,4096,835,6846,7681,197723,1569081,1766804,06/01/2021 12:00:00 AM,286,461,431
Piedmont,Pittsylvania County,51143,694,3286,3980,870,6844,7714,77901,787328,865229,10/01/2019 12:00:00 AM,112,240,217
Piedmont,Pittsylvania County,51143,694,3443,4137,832,7007,7839,198079,1605119,1803198,04/01/2021 12:00:00 AM,285,466,436
Piedmont,Pittsylvania County,51143,694,3527,4221,878,7618,8496,78685,876627,955312,05/01/2017 12:00:00 AM,113,249,226
Piedmont,Pittsylvania County,51143,695,3230,3925,881,6670,7551,77239,758651,835890,09/01/2019 12:00:00 AM,111,235,213
Piedmont,Pittsylvania County,51143,695,3250,3945,868,6752,7620,77167,774400,851567,05/01/2019 12:00:00 AM,111,238,216
Piedmont,Pittsylvania County,51143,695,3276,3971,876,6787,7663,80466,779858,860324,11/01/2019 12:00:00 AM,116,238,217
Piedmont,Pittsylvania County,51143,698,3257,3955,890,6714,7604,79125,773358,852483,01/01/2020 12:00:00 AM,113,237,216
Piedmont,Pittsylvania County,51143,700,3097,3797,886,6445,7331,77959,729966,807925,02/01/2019 12:00:00 AM,111,236,213
Piedmont,Pittsylvania County,51143,700,3265,3965,886,6815,7701,77421,783599,861020,06/01/2019 12:00:00 AM,111,240,217
Piedmont,Pittsylvania County,51143,700,3454,4154,858,7133,7991,192943,1501372,1694315,01/01/2021 12:00:00 AM,276,435,408
Piedmont,Pittsylvania County,51143,702,3268,3970,898,6741,7639,80297,787274,867571,02/01/2020 12:00:00 AM,114,241,219
Piedmont,Pittsylvania County,51143,702,3295,3997,884,6855,7739,81820,799195,881015,12/01/2019 12:00:00 AM,117,243,220
Piedmont,Pittsylvania County,51143,702,3516,4218,893,7572,8465,80700,872356,953056,06/01/2017 12:00:00 AM,115,248,226
Piedmont,Pittsylvania County,51143,703,3244,3947,893,6694,7587,78930,770459.04,849389.04,08/01/2019 12:00:00 AM,112,238,215
Piedmont,Pittsylvania County,51143,703,3250,3953,891,6750,7641,79172,774052,853224,04/01/2019 12:00:00 AM,113,238,216
Piedmont,Pittsylvania County,51143,704,3266,3970,889,6844,7733,76909,777680,854589,03/01/2019 12:00:00 AM,109,238,215
Piedmont,Pittsylvania County,51143,704,3269,3973,899,6756,7655,167234,1157445,1324679,03/01/2020 12:00:00 AM,238,354,333
Piedmont,Pittsylvania County,51143,705,3548,4253,888,7692,8580,79502,878384,957886,03/01/2017 12:00:00 AM,113,248,225
Piedmont,Pittsylvania County,51143,708,3539,4247,899,7658,8557,82070,875938,958008,04/01/2017 12:00:00 AM,116,248,226
Piedmont,Pittsylvania County,51143,708,3568,4276,943,7961,8904,83244,901514,984758,07/01/2016 12:00:00 AM,118,253,230
Piedmont,Pittsylvania County,51143,709,3508,4217,875,7217,8092,171173,1311049,1482222,12/01/2020 12:00:00 AM,241,374,351
Piedmont,Pittsylvania County,51143,710,3635,4345,936,8095,9031,84284,936529,1020813,06/01/2016 12:00:00 AM,119,258,235
Piedmont,Pittsylvania County,51143,711,3246,3957,897,6721,7618,78055,772477,850532,07/01/2019 12:00:00 AM,110,238,215
Piedmont,Pittsylvania County,51143,713,3213,3926,899,6763,7662,81147,803945,885092,01/01/2019 12:00:00 AM,114,250,225
Piedmont,Pittsylvania County,51143,713,3490,4203,918,7551,8469,85504,872028,957532,08/01/2017 12:00:00 AM,120,250,228
Piedmont,Pittsylvania County,51143,713,3569,4282,937,7928,8865,82977,899947,982924,08/01/2016 12:00:00 AM,116,252,230
Piedmont,Pittsylvania County,51143,714,3538,4252,934,7784,8718,79817,872835,952652,11/01/2016 12:00:00 AM,112,247,224
Piedmont,Pittsylvania County,51143,716,3482,4198,924,7510,8434,85433,864166,949599,07/01/2017 12:00:00 AM,119,248,226
Piedmont,Pittsylvania County,51143,716,3494,4210,886,7219,8105,174207,1336708,1510915,11/01/2020 12:00:00 AM,243,383,359
Piedmont,Pittsylvania County,51143,716,3551,4267,887,7293,8180,173027,1336129,1509156,10/01/2020 12:00:00 AM,242,376,354
Piedmont,Pittsylvania County,51143,716,3727,4443,960,8285,9245,85977,940148,1026125,02/01/2016 12:00:00 AM,120,252,231
Piedmont,Pittsylvania County,51143,716,3727,4443,963,8233,9196,87231,935702,1022933,03/01/2016 12:00:00 AM,122,251,230
Piedmont,Pittsylvania County,51143,717,3323,4040,900,7068,7968,83308,807218,890526,11/01/2018 12:00:00 AM,116,243,220
Piedmont,Pittsylvania County,51143,717,3522,4239,944,7743,8687,81619,868527,950146,10/01/2016 12:00:00 AM,114,247,224
Piedmont,Pittsylvania County,51143,717,3529,4246,938,7830,8768,81356,886508,967864,09/01/2016 12:00:00 AM,113,251,228
Piedmont,Pittsylvania County,51143,718,3283,4001,907,6929,7836,85030,794142,879172,12/01/2018 12:00:00 AM,118,242,220
Piedmont,Pittsylvania County,51143,719,3468,4187,911,7163,8074,169620,1251230,1420850,04/01/2020 12:00:00 AM,236,361,339
Piedmont,Pittsylvania County,51143,720,3677,4397,961,8156,9117,88375,941923,1030298,05/01/2016 12:00:00 AM,123,256,234
Piedmont,Pittsylvania County,51143,723,3307,4030,916,7011,7927,93763,863941,957704,10/01/2018 12:00:00 AM,130,261,238
Piedmont,Pittsylvania County,51143,723,3541,4264,935,7784,8719,80055,875289,955344,12/01/2016 12:00:00 AM,111,247,224
Piedmont,Pittsylvania County,51143,723,3572,4295,929,7817,8746,79088,893811,972899,01/01/2017 12:00:00 AM,109,250,227
Piedmont,Pittsylvania County,51143,724,3435,4159,926,7411,8337,86042,855709,941751,09/01/2017 12:00:00 AM,119,249,226
Piedmont,Pittsylvania County,51143,724,3580,4304,899,7346,8245,167753,1264388,1432141,09/01/2020 12:00:00 AM,232,353,333
Piedmont,Pittsylvania County,51143,724,3694,4418,979,8168,9147,89483,925857,1015340,04/01/2016 12:00:00 AM,124,251,230
Piedmont,Pittsylvania County,51143,726,3448,4174,934,7442,8376,86667,858994,945661,11/01/2017 12:00:00 AM,119,249,227
Piedmont,Pittsylvania County,51143,728,3462,4190,932,7443,8375,86731,852528,939259,10/01/2017 12:00:00 AM,119,246,224
Piedmont,Pittsylvania County,51143,729,3554,4283,921,7321,8242,172425,1273040,1445465,05/01/2020 12:00:00 AM,237,358,337
Piedmont,Pittsylvania County,51143,730,3430,4160,918,7319,8237,79957,840250,920207,03/01/2018 12:00:00 AM,110,245,221
Piedmont,Pittsylvania County,51143,731,3734,4465,994,8285,9279,89650,937380,1027030,01/01/2016 12:00:00 AM,123,251,230
Piedmont,Pittsylvania County,51143,732,3337,4069,927,7092,8019,83985,802296,886281,09/01/2018 12:00:00 AM,115,240,218
Piedmont,Pittsylvania County,51143,732,3564,4296,916,7335,8251,171956,1275354,1447310,06/01/2020 12:00:00 AM,235,358,337
Piedmont,Pittsylvania County,51143,733,3419,4152,930,7273,8203,81518,833811,915329,01/01/2018 12:00:00 AM,111,244,220
Piedmont,Pittsylvania County,51143,734,3339,4073,924,7032,7956,83046,802013,885059,07/01/2018 12:00:00 AM,113,240,217
Piedmont,Pittsylvania County,51143,734,3389,4123,905,7182,8087,79319,823020,902339,05/01/2018 12:00:00 AM,108,243,219
Piedmont,Pittsylvania County,51143,734,3415,4149,932,7310,8242,83547,838237.98,921784.98,02/01/2018 12:00:00 AM,114,245,222
Piedmont,Pittsylvania County,51143,735,3790,4525,965,8426,9391,88879,953654,1042533,09/01/2015 12:00:00 AM,121,252,230
Piedmont,Pittsylvania County,51143,735,3827,4562,945,8532,9477,84391,964464,1048855,08/01/2015 12:00:00 AM,115,252,230
Piedmont,Pittsylvania County,51143,736,3362,4098,934,7153,8087,84300,817410,901710,08/01/2018 12:00:00 AM,115,243,220
Piedmont,Pittsylvania County,51143,736,3457,4193,943,7392,8335,86637,846024,932661,12/01/2017 12:00:00 AM,118,245,222
Piedmont,Pittsylvania County,51143,737,3852,4589,946,8583,9529,84212,968018,1052230,07/01/2015 12:00:00 AM,114,251,229
Piedmont,Pittsylvania County,51143,738,3419,4157,926,7252,8178,84144,828541,912685,04/01/2018 12:00:00 AM,114,242,220
Piedmont,Pittsylvania County,51143,738,3601,4339,929,7407,8336,173460,1285818,1459278,07/01/2020 12:00:00 AM,235,357,336
Piedmont,Pittsylvania County,51143,738,3623,4361,921,7435,8356,171494,1288059,1459553,08/01/2020 12:00:00 AM,232,356,335
Piedmont,Pittsylvania County,51143,743,3765,4508,995,8339,9334,88275,947881,1036156,12/01/2015 12:00:00 AM,119,252,230
Piedmont,Pittsylvania County,51143,743,3769,4512,992,8322,9314,90248,942940,1033188,10/01/2015 12:00:00 AM,121,250,229
Piedmont,Pittsylvania County,51143,744,3367,4111,930,7094,8024,81663,813322,894985,06/01/2018 12:00:00 AM,110,242,218
Piedmont,Pittsylvania County,51143,744,3863,4607,961,8614,9575,86859,971738,1058597,06/01/2015 12:00:00 AM,117,252,230
Piedmont,Pittsylvania County,51143,745,3769,4514,1005,8284,9289,90042,939386,1029428,11/01/2015 12:00:00 AM,121,249,228
Piedmont,Pittsylvania County,51143,756,3854,4610,996,8601,9597,91022,975893,1066915,05/01/2015 12:00:00 AM,120,253,231
Piedmont,Pittsylvania County,51143,765,3887,4652,1013,8651,9664,91924,981011,1072935,04/01/2015 12:00:00 AM,120,252,231
Piedmont,Pittsylvania County,51143,782,3931,4713,1057,8765,9822,97267,987524,1084791,03/01/2015 12:00:00 AM,124,251,230
Piedmont,Pittsylvania County,51143,787,3921,4708,1066,8758,9824,98828,989191,1088019,02/01/2015 12:00:00 AM,126,252,231
Piedmont,Pittsylvania County,51143,800,4100,4900,1094,8931,10025,103728,1026452,1130180,10/01/2014 12:00:00 AM,130,250,231
Piedmont,Pittsylvania County,51143,803,3976,4779,1093,8886,9979,101006,988040,1089046,01/01/2015 12:00:00 AM,126,249,228
Piedmont,Pittsylvania County,51143,804,4161,4965,1100,9033,10133,96028,996458,1092486,09/01/2014 12:00:00 AM,119,239,220
Piedmont,Pittsylvania County,51143,806,4020,4826,1097,8857,9954,104654,1014628,1119282,11/01/2014 12:00:00 AM,130,252,232
Piedmont,Pittsylvania County,51143,808,3984,4792,1115,8832,9947,106217,999584,1105801,12/01/2014 12:00:00 AM,131,251,231
Piedmont,Pittsylvania County,51143,812,4258,5070,1115,9145,10260,95740,1014276,1110016,07/01/2014 12:00:00 AM,118,238,219
Piedmont,Pittsylvania County,51143,815,4225,5040,1109,9154,10263,96210,1014491,1110701,08/01/2014 12:00:00 AM,118,240,220
Piedmont,Pittsylvania County,51143,817,4327,5144,1112,9272,10384,94898,1031377,1126275,06/01/2014 12:00:00 AM,116,238,219
Piedmont,Pittsylvania County,51143,824,4383,5207,1116,9378,10494,94620,1041253,1135873,05/01/2014 12:00:00 AM,115,238,218
Piedmont,Pittsylvania County,51143,831,4395,5226,1128,9409,10537,96223,1048353,1144576,04/01/2014 12:00:00 AM,116,239,219
Piedmont,Pittsylvania County,51143,832,4370,5202,1151,9341,10492,98744,1037042,1135786,02/01/2014 12:00:00 AM,119,237,218
Piedmont,Pittsylvania County,51143,834,4371,5205,1155,9346,10501,99049,1023281,1122330,01/01/2014 12:00:00 AM,119,234,216
Piedmont,Pittsylvania County,51143,837,4364,5201,1150,9354,10504,100156,1034485,1134641,03/01/2014 12:00:00 AM,120,237,218
Piedmont,Pittsylvania County,51143,847,4199,5046,1248,9001,10249,126570,1085157,1211727,02/01/2012 12:00:00 AM,149,258,240
Piedmont,Pittsylvania County,51143,848,4227,5075,1201,9044,10245,120364,1103834,1224198,07/01/2012 12:00:00 AM,142,261,241
Piedmont,Pittsylvania County,51143,850,4224,5074,1241,9043,10284,124512,1087502,1212014,03/01/2012 12:00:00 AM,146,257,239
Piedmont,Pittsylvania County,51143,850,4403,5253,1188,9410,10598,116975,1130999,1247974,08/01/2013 12:00:00 AM,138,257,238
Piedmont,Pittsylvania County,51143,851,4366,5217,1203,9367,10570,107780,1030243,1138023,12/01/2013 12:00:00 AM,127,236,218
Piedmont,Pittsylvania County,51143,851,4431,5282,1199,9512,10711,119710,1140511,1260221,09/01/2013 12:00:00 AM,141,257,239
Piedmont,Pittsylvania County,51143,854,4242,5096,1224,9071,10295,123792,1107624,1231416,08/01/2012 12:00:00 AM,145,261,242
Piedmont,Pittsylvania County,51143,854,4403,5257,1183,9433,10616,115612,1134767,1250379,07/01/2013 12:00:00 AM,135,258,238
Piedmont,Pittsylvania County,51143,857,4217,5074,1249,9022,10271,128051,1086881,1214932,04/01/2012 12:00:00 AM,149,258,239
Piedmont,Pittsylvania County,51143,858,4162,5020,1267,8944,10211,128071,1065505,1193576,01/01/2012 12:00:00 AM,149,256,238
Piedmont,Pittsylvania County,51143,858,4197,5055,1233,8970,10203,123684,1092244,1215928,06/01/2012 12:00:00 AM,144,260,241
Piedmont,Pittsylvania County,51143,862,4334,5196,1199,9222,10421,116597,1116796,1233393,05/01/2013 12:00:00 AM,135,258,237
Piedmont,Pittsylvania County,51143,863,4197,5060,1242,8999,10241,126037,1091863,1217900,05/01/2012 12:00:00 AM,146,260,241
Piedmont,Pittsylvania County,51143,866,4363,5229,1199,9327,10526,117377,1126220,1243597,06/01/2013 12:00:00 AM,136,258,238
Piedmont,Pittsylvania County,51143,868,4374,5242,1226,9394,10620,110980,1041799,1152779,11/01/2013 12:00:00 AM,128,238,220
Piedmont,Pittsylvania County,51143,869,4404,5273,1218,9435,10653,122465,1130946,1253411,10/01/2013 12:00:00 AM,141,257,238
Piedmont,Pittsylvania County,51143,870,4299,5169,1256,9135,10391,128966,1113946,1242912,11/01/2012 12:00:00 AM,148,259,240
Piedmont,Pittsylvania County,51143,871,4219,5090,1254,9031,10285,127824,1099842,1227666,09/01/2012 12:00:00 AM,147,261,241
Piedmont,Pittsylvania County,51143,872,4246,5118,1269,9046,10315,130907,1099855,1230762,10/01/2012 12:00:00 AM,150,259,240
Piedmont,Pittsylvania County,51143,872,4357,5229,1218,9219,10437,122364,1118395,1240759,03/01/2013 12:00:00 AM,140,257,237
Piedmont,Pittsylvania County,51143,873,4325,5198,1222,9191,10413,122815,1111410,1234225,04/01/2013 12:00:00 AM,141,257,237
Piedmont,Pittsylvania County,51143,874,4311,5185,1247,9157,10404,128169,1117247,1245416,12/01/2012 12:00:00 AM,147,259,240
Piedmont,Pittsylvania County,51143,880,4336,5216,1256,9192,10448,125735,1110395,1236130,01/01/2013 12:00:00 AM,143,256,237
Piedmont,Pittsylvania County,51143,885,4343,5228,1240,9240,10480,123360,1128137,1251497,02/01/2013 12:00:00 AM,139,260,239
Piedmont,Roanoke City,51770,2118,8242,10360,2962,17756,20718,657952,3760107,4418059,02/01/2021 12:00:00 AM,311,456,426
Piedmont,Roanoke City,51770,2150,8172,10322,3038,17575,20613,662468,3652560,4315028,03/01/2021 12:00:00 AM,308,447,418
Piedmont,Roanoke City,51770,2164,8039,10203,3119,17167,20286,722848,3897891,4620739,04/01/2021 12:00:00 AM,334,485,453
Piedmont,Roanoke City,51770,2165,7263,9428,3198,15960,19158,575591,2733497,3309088,03/01/2020 12:00:00 AM,266,376,351
Piedmont,Roanoke City,51770,2174,7191,9365,3206,15891,19097,315711,1916964,2232675,02/01/2020 12:00:00 AM,145,267,238
Piedmont,Roanoke City,51770,2179,8089,10268,3219,17335,20554,698977,3588698,4287675,01/01/2021 12:00:00 AM,321,444,418
Piedmont,Roanoke City,51770,2186,7187,9373,3242,15801,19043,317552,1889776,2207328,01/01/2020 12:00:00 AM,145,263,235
Piedmont,Roanoke City,51770,2189,7981,10170,3189,17050,20239,745887,3898734,4644621,05/01/2021 12:00:00 AM,341,489,457
Piedmont,Roanoke City,51770,2195,8117,10312,3233,17443,20676,617578,3181520,3799098,12/01/2020 12:00:00 AM,281,392,368
Piedmont,Roanoke City,51770,2196,6915,9111,3148,15091,18239,314676,1823772,2138448,02/01/2019 12:00:00 AM,143,264,235
Piedmont,Roanoke City,51770,2197,7786,9983,3179,17445,20624,329872,2137250,2467122,02/01/2017 12:00:00 AM,150,274,247
Piedmont,Roanoke City,51770,2199,7375,9574,3238,16206,19444,326048,1957789,2283837,11/01/2019 12:00:00 AM,148,265,239
Piedmont,Roanoke City,51770,2205,7494,9699,3237,16329,19566,331158,1996158,2327316,10/01/2019 12:00:00 AM,150,266,240
Piedmont,Roanoke City,51770,2208,8143,10351,3275,17517,20792,627323,3228924,3856247,11/01/2020 12:00:00 AM,284,397,373
Piedmont,Roanoke City,51770,2209,7868,10077,3263,17144,20407,591640,2955848,3547488,04/01/2020 12:00:00 AM,268,376,352
Piedmont,Roanoke City,51770,2210,7502,9712,3231,16439,19670,323501,2012233,2335734,09/01/2019 12:00:00 AM,146,268,240
Piedmont,Roanoke City,51770,2210,7975,10185,3230,16974,20204,748775,3874561.47,4623336.47,06/01/2021 12:00:00 AM,339,486,454
Piedmont,Roanoke City,51770,2211,7347,9558,3282,16118,19400,334361,1965753,2300114,12/01/2019 12:00:00 AM,151,268,241
Piedmont,Roanoke City,51770,2215,7521,9736,3228,16436,19664,324644,1997613,2322257,08/01/2019 12:00:00 AM,147,266,239
Piedmont,Roanoke City,51770,2221,7492,9713,3224,16456,19680,321022,1995482,2316504,07/01/2019 12:00:00 AM,145,266,238
Piedmont,Roanoke City,51770,2224,8192,10416,3338,17593,20931,634274,3203538,3837812,10/01/2020 12:00:00 AM,285,391,368
Piedmont,Roanoke City,51770,2235,8295,10530,3334,17851,21185,596657,3083510,3680167,09/01/2020 12:00:00 AM,267,372,349
Piedmont,Roanoke City,51770,2240,8111,10351,3352,17577,20929,604824,3033996,3638820,05/01/2020 12:00:00 AM,270,374,352
Piedmont,Roanoke City,51770,2247,8252,10499,3359,17769,21128,606397,3065123,3671520,06/01/2020 12:00:00 AM,270,371,350
Piedmont,Roanoke City,51770,2250,7375,9625,3275,16134,19409,325724,1955642,2281366,05/01/2019 12:00:00 AM,145,265,237
Piedmont,Roanoke City,51770,2252,7432,9684,3279,16351,19630,326268,1985650,2311918,06/01/2019 12:00:00 AM,145,267,239
Piedmont,Roanoke City,51770,2252,8286,10538,3358,17860,21218,602203,3052010,3654213,08/01/2020 12:00:00 AM,267,368,347
Piedmont,Roanoke City,51770,2266,7710,9976,3353,17458,20811,343537,2157742.63,2501279.63,06/01/2017 12:00:00 AM,152,280,251
Piedmont,Roanoke City,51770,2269,8369,10638,3396,18030,21426,614207,3107056,3721263,07/01/2020 12:00:00 AM,271,371,350
Piedmont,Roanoke City,51770,2270,7688,9958,3342,17298,20640,340968,2130212,2471180,04/01/2017 12:00:00 AM,150,277,248
Piedmont,Roanoke City,51770,2278,7728,10006,3381,17475,20856,345386,2164833,2510219,07/01/2017 12:00:00 AM,152,280,251
Piedmont,Roanoke City,51770,2280,7391,9671,3325,16347,19672,345498,1987883,2333381,12/01/2018 12:00:00 AM,152,269,241
Piedmont,Roanoke City,51770,2280,7739,10019,3364,17352,20716,351210,2149176,2500386,05/01/2017 12:00:00 AM,154,278,250
Piedmont,Roanoke City,51770,2281,7473,9754,3340,16675,20015,339832,2054136,2393968,06/01/2018 12:00:00 AM,149,275,245
Piedmont,Roanoke City,51770,2281,7811,10092,3328,17468,20796,341926,2154776,2496702,03/01/2017 12:00:00 AM,150,276,247
Piedmont,Roanoke City,51770,2283,7415,9698,3334,16420,19754,345186,2009354,2354540,11/01/2018 12:00:00 AM,151,271,243
Piedmont,Roanoke City,51770,2284,7419,9703,3343,16391,19734,344556,2040145,2384701,10/01/2018 12:00:00 AM,151,275,246
Piedmont,Roanoke City,51770,2284,7507,9791,3332,16727,20059,339931,2056638,2396569,05/01/2018 12:00:00 AM,149,274,245
Piedmont,Roanoke City,51770,2285,7570,9855,3383,16892,20275,344796,2077799,2422595,02/01/2018 12:00:00 AM,151,274,246
Piedmont,Roanoke City,51770,2286,7456,9742,3296,16373,19669,351240,2131290,2482530,01/01/2019 12:00:00 AM,154,286,255
Piedmont,Roanoke City,51770,2287,7560,9847,3377,16778,20155,344985,2046802.74,2391787.74,04/01/2018 12:00:00 AM,151,271,243
Piedmont,Roanoke City,51770,2288,7593,9881,3364,17083,20447,354839,2087784,2442623,12/01/2017 12:00:00 AM,155,275,247
Piedmont,Roanoke City,51770,2289,7368,9657,3331,16203,19534,337415,1987706,2325121,04/01/2019 12:00:00 AM,147,270,241
Piedmont,Roanoke City,51770,2290,7599,9889,3377,17097,20474,356954,2087299,2444253,11/01/2017 12:00:00 AM,156,275,247
Piedmont,Roanoke City,51770,2291,7340,9631,3346,16075,19421,336819,1955460,2292279,03/01/2019 12:00:00 AM,147,266,238
Piedmont,Roanoke City,51770,2295,7636,9931,3384,17129,20513,356968.4,2103053,2460021.4,10/01/2017 12:00:00 AM,156,275,248
Piedmont,Roanoke City,51770,2295,7777,10072,3394,17507,20901,357842,2167772,2525614,08/01/2017 12:00:00 AM,156,279,251
Piedmont,Roanoke City,51770,2297,7428,9725,3387,16539,19926,346729,2035866,2382595,09/01/2018 12:00:00 AM,151,274,245
Piedmont,Roanoke City,51770,2299,7577,9876,3407,16786,20193,348386.03,2052126,2400512.03,03/01/2018 12:00:00 AM,152,271,243
Piedmont,Roanoke City,51770,2302,7416,9718,3359,16630,19989,344336,2043207,2387543,07/01/2018 12:00:00 AM,150,276,246
Piedmont,Roanoke City,51770,2310,7479,9789,3398,16716,20114,349295,2064620,2413915,08/01/2018 12:00:00 AM,151,276,247
Piedmont,Roanoke City,51770,2310,7561,9871,3428,16922,20350,347663,2055571,2403234,01/01/2018 12:00:00 AM,151,272,243
Piedmont,Roanoke City,51770,2311,7691,10002,3438,17304,20742,362676,2136463,2499139,09/01/2017 12:00:00 AM,157,278,250
Piedmont,Roanoke City,51770,2374,7895,10269,3507,17786,21293,348025,2140647,2488672,12/01/2016 12:00:00 AM,147,271,242
Piedmont,Roanoke City,51770,2374,7960,10334,3463,17962,21425,339458,2145882,2485340,01/01/2017 12:00:00 AM,143,270,241
Piedmont,Roanoke City,51770,2382,7892,10274,3545,17831,21376,356579,2137428,2494007,11/01/2016 12:00:00 AM,150,271,243
Piedmont,Roanoke City,51770,2403,7881,10284,3622,17886,21508,366525,2137500,2504025,10/01/2016 12:00:00 AM,153,271,243
Piedmont,Roanoke City,51770,2407,8063,10470,3665,18326,21991,379062,2202275,2581337,04/01/2016 12:00:00 AM,157,273,247
Piedmont,Roanoke City,51770,2410,7966,10376,3668,18021,21689,378286,2157411,2535697,09/01/2016 12:00:00 AM,157,271,244
Piedmont,Roanoke City,51770,2410,8104,10514,3668,18348,22016,381621,2269023,2650644,06/01/2016 12:00:00 AM,158,280,252
Piedmont,Roanoke City,51770,2410,8162,10572,3664,18498,22162,377417,2220658,2598075,03/01/2016 12:00:00 AM,157,272,246
Piedmont,Roanoke City,51770,2411,8034,10445,3689,18304,21993,384383,2237470,2621853,05/01/2016 12:00:00 AM,159,279,251
Piedmont,Roanoke City,51770,2423,8202,10625,3721,18532,22253,387077,2218053,2605130,12/01/2015 12:00:00 AM,160,270,245
Piedmont,Roanoke City,51770,2424,7959,10383,3713,18101,21814,382936,2186372,2569308,07/01/2016 12:00:00 AM,158,275,247
Piedmont,Roanoke City,51770,2424,8152,10576,3708,18435,22143,380807,2220718,2601525,02/01/2016 12:00:00 AM,157,272,246
Piedmont,Roanoke City,51770,2424,8195,10619,3723,18502,22225,386581,2198780,2585361,01/01/2016 12:00:00 AM,159,268,243
Piedmont,Roanoke City,51770,2433,7965,10398,3745,18025,21770,387469,2165751,2553220,08/01/2016 12:00:00 AM,159,272,246
Piedmont,Roanoke City,51770,2438,8389,10827,3711,18807,22518,388842,2263059,2651901,09/01/2015 12:00:00 AM,159,270,245
Piedmont,Roanoke City,51770,2446,8252,10698,3792,18651,22443,400542,2235929,2636471,11/01/2015 12:00:00 AM,164,271,246
Piedmont,Roanoke City,51770,2450,8279,10729,3722,18688,22410,389537,2235983,2625520,10/01/2015 12:00:00 AM,159,270,245
Piedmont,Roanoke City,51770,2454,8512,10966,3739,18956,22695,392461,2282189,2674650,07/01/2015 12:00:00 AM,160,268,244
Piedmont,Roanoke City,51770,2457,8454,10911,3766,18902,22668,394654,2266141,2660795,08/01/2015 12:00:00 AM,161,268,244
Piedmont,Roanoke City,51770,2471,8525,10996,3791,18954,22745,398986,2275945,2674931,06/01/2015 12:00:00 AM,161,267,243
Piedmont,Roanoke City,51770,2484,8484,10968,3842,18838,22680,405973,2270946,2676919,05/01/2015 12:00:00 AM,163,268,244
Piedmont,Roanoke City,51770,2493,8639,11132,3858,19097,22955,402806,2286469,2689275,03/01/2015 12:00:00 AM,162,265,242
Piedmont,Roanoke City,51770,2494,8536,11030,3861,18925,22786,409228,2289786,2699014,04/01/2015 12:00:00 AM,164,268,245
Piedmont,Roanoke City,51770,2514,8660,11174,3920,19080,23000,415926,2301452,2717378,02/01/2015 12:00:00 AM,165,266,243
Piedmont,Roanoke City,51770,2552,8769,11321,3997,19231,23228,416290,2296230,2712520,01/01/2015 12:00:00 AM,163,262,240
Piedmont,Roanoke City,51770,2553,8806,11359,4054,19271,23325,431479,2334933,2766412,12/01/2014 12:00:00 AM,169,265,244
Piedmont,Roanoke City,51770,2564,8917,11481,4102,19401,23503,436321,2357845,2794166,11/01/2014 12:00:00 AM,170,264,243
Piedmont,Roanoke City,51770,2575,8987,11562,4149,19470,23619,449529,2373483,2823012,10/01/2014 12:00:00 AM,175,264,244
Piedmont,Roanoke City,51770,2590,9499,12089,4189,20239,24428,422864,2403914,2826778,09/01/2014 12:00:00 AM,163,253,234
Piedmont,Roanoke City,51770,2592,9640,12232,4164,20382,24546,415472,2437808,2853280,08/01/2014 12:00:00 AM,160,253,233
Piedmont,Roanoke City,51770,2606,10016,12622,4202,20795,24997,420785,2539732,2960517,05/01/2014 12:00:00 AM,161,254,235
Piedmont,Roanoke City,51770,2620,9719,12339,4267,20385,24652,429961,2455944,2885905,07/01/2014 12:00:00 AM,164,253,234
Piedmont,Roanoke City,51770,2621,9873,12494,4272,20559,24831,429581,2488518,2918099,06/01/2014 12:00:00 AM,164,252,234
Piedmont,Roanoke City,51770,2645,10062,12707,4339,20763,25102,441840,2530143,2971983,04/01/2014 12:00:00 AM,167,251,234
Piedmont,Roanoke City,51770,2658,10188,12846,4376,20883,25259,444796,2532642,2977438,03/01/2014 12:00:00 AM,167,249,232
Piedmont,Roanoke City,51770,2680,10190,12870,4424,20902,25326,451178,2543184,2994362,02/01/2014 12:00:00 AM,168,250,233
Piedmont,Roanoke City,51770,2693,10292,12985,4411,21077,25488,444267,2524412,2968679,01/01/2014 12:00:00 AM,165,245,229
Piedmont,Roanoke City,51770,2709,9480,12189,4632,19592,24224,528755,2562919,3091674,03/01/2012 12:00:00 AM,195,270,254
Piedmont,Roanoke City,51770,2712,9720,12432,4587,20169,24756,518133,2623819,3141952,06/01/2012 12:00:00 AM,191,270,253
Piedmont,Roanoke City,51770,2716,10089,12805,4520,20724,25244,508004,2711805,3219809,04/01/2013 12:00:00 AM,187,269,251
Piedmont,Roanoke City,51770,2719,10261,12980,4458,21150,25608,463186,2559052,3022238,11/01/2013 12:00:00 AM,170,249,233
Piedmont,Roanoke City,51770,2723,9729,12452,4634,20224,24858,551473,2737743,3289216,07/01/2012 12:00:00 AM,203,281,264
Piedmont,Roanoke City,51770,2728,10251,12979,4477,21061,25538,461614,2538343,2999957,12/01/2013 12:00:00 AM,169,248,231
Piedmont,Roanoke City,51770,2732,9493,12225,4694,19645,24339,532438,2561612,3094050,04/01/2012 12:00:00 AM,195,270,253
Piedmont,Roanoke City,51770,2732,9774,12506,4619,20362,24981,525284,2659356,3184640,09/01/2012 12:00:00 AM,192,272,255
Piedmont,Roanoke City,51770,2734,9323,12057,4745,19274,24019,548145,2491623,3039768,01/01/2012 12:00:00 AM,200,267,252
Piedmont,Roanoke City,51770,2736,10054,12790,4608,20622,25230,518554,2695208,3213762,03/01/2013 12:00:00 AM,190,268,251
Piedmont,Roanoke City,51770,2738,9593,12331,4644,19874,24518,525581,2588134,3113715,05/01/2012 12:00:00 AM,192,270,253
Piedmont,Roanoke City,51770,2740,9786,12526,4681,20330,25011,533584,2655107,3188691,08/01/2012 12:00:00 AM,195,271,255
Piedmont,Roanoke City,51770,2744,10167,12911,4547,20895,25442,510799,2740659,3251458,05/01/2013 12:00:00 AM,186,270,252
Piedmont,Roanoke City,51770,2747,10355,13102,4475,21329,25804,502651,2777030,3279681,10/01/2013 12:00:00 AM,183,268,250
Piedmont,Roanoke City,51770,2757,9843,12600,4644,20442,25086,528526,2667302,3195828,10/01/2012 12:00:00 AM,192,271,254
Piedmont,Roanoke City,51770,2763,10199,12962,4586,20927,25513,525491,2779375,3304866,06/01/2013 12:00:00 AM,190,273,255
Piedmont,Roanoke City,51770,2764,10318,13082,4548,21176,25724,514888,2760934,3275822,08/01/2013 12:00:00 AM,186,268,250
Piedmont,Roanoke City,51770,2765,9432,12197,4801,19536,24337,557062,2553749,3110811,02/01/2012 12:00:00 AM,201,271,255
Piedmont,Roanoke City,51770,2767,10360,13127,4548,21283,25831,505315,2770917,3276232,09/01/2013 12:00:00 AM,183,267,250
Piedmont,Roanoke City,51770,2772,10206,12978,4587,20951,25538,519838,2740199,3260037,07/01/2013 12:00:00 AM,188,268,251
Piedmont,Roanoke City,51770,2775,10017,12792,4688,20549,25237,528155,2679526,3207681,02/01/2013 12:00:00 AM,190,267,251
Piedmont,Roanoke City,51770,2787,9941,12728,4747,20398,25145,529452,2633503,3162955,01/01/2013 12:00:00 AM,190,265,249
Piedmont,Roanoke City,51770,2794,9850,12644,4769,20341,25110,549651,2644467,3194118,11/01/2012 12:00:00 AM,197,268,253
Piedmont,Roanoke City,51770,2798,9888,12686,4733,20429,25162,540858,2660223,3201081,12/01/2012 12:00:00 AM,193,269,252
Piedmont,Roanoke County,51161,584,2725,3309,731,5854,6585,165195,1245670,1410865,02/01/2021 12:00:00 AM,283,457,426
Piedmont,Roanoke County,51161,586,2290,2876,735,5106,5841,67367,551569,618936,06/01/2019 12:00:00 AM,115,241,215
Piedmont,Roanoke County,51161,586,2290,2876,735,5146,5881,67963,561777,629740,07/01/2019 12:00:00 AM,116,245,219
Piedmont,Roanoke County,51161,587,2147,2734,755,4751,5506,70404,522577,592981,02/01/2019 12:00:00 AM,120,243,217
Piedmont,Roanoke County,51161,590,2220,2810,737,4966,5703,68660,543321,611981,02/01/2020 12:00:00 AM,116,245,218
Piedmont,Roanoke County,51161,590,2231,2821,738,4964,5702,67544,539218,606762,01/01/2020 12:00:00 AM,114,242,215
Piedmont,Roanoke County,51161,591,2285,2876,741,5096,5837,66654,553422,620076,05/01/2019 12:00:00 AM,113,242,216
Piedmont,Roanoke County,51161,593,2645,3238,786,5969,6755,77339,684095,761434,02/01/2017 12:00:00 AM,130,259,235
Piedmont,Roanoke County,51161,594,2283,2877,748,5017,5765,138989,854696,993685,03/01/2020 12:00:00 AM,234,374,345
Piedmont,Roanoke County,51161,594,2297,2891,762,5141,5903,74108,581816,655924,10/01/2018 12:00:00 AM,125,253,227
Piedmont,Roanoke County,51161,597,2261,2858,752,5096,5848,71069,555480,626549,11/01/2019 12:00:00 AM,119,246,219
Piedmont,Roanoke County,51161,598,2312,2910,766,5174,5940,71437,564469,635906,08/01/2019 12:00:00 AM,119,244,219
Piedmont,Roanoke County,51161,599,2270,2869,773,5077,5850,72013,555588,627601,03/01/2019 12:00:00 AM,120,245,219
Piedmont,Roanoke County,51161,599,2271,2870,777,5093,5870,72774,591093,663867,01/01/2019 12:00:00 AM,121,260,231
Piedmont,Roanoke County,51161,599,2289,2888,750,5090,5840,70885,562451,633336,12/01/2019 12:00:00 AM,118,246,219
Piedmont,Roanoke County,51161,599,2311,2910,768,5193,5961,74580,583544.35,658124.35,11/01/2018 12:00:00 AM,125,253,226
Piedmont,Roanoke County,51161,600,2281,2881,756,5086,5842,68105,556884,624989,04/01/2019 12:00:00 AM,114,244,217
Piedmont,Roanoke County,51161,600,2708,3308,789,5820,6609,179230,1211753,1390983,01/01/2021 12:00:00 AM,299,447,420
Piedmont,Roanoke County,51161,602,2253,2855,776,5052,5828,77183,555407,632590,12/01/2018 12:00:00 AM,128,247,222
Piedmont,Roanoke County,51161,602,2729,3331,776,5813,6589,184937,1315575,1500512,04/01/2021 12:00:00 AM,307,482,450
Piedmont,Roanoke County,51161,604,2320,2924,776,5227,6003,71619,564900,636519,09/01/2019 12:00:00 AM,119,243,218
Piedmont,Roanoke County,51161,604,2388,2992,813,5292,6105,78731,589607,668338,08/01/2018 12:00:00 AM,130,247,223
Piedmont,Roanoke County,51161,604,2698,3302,778,5937,6715,151055,1084759,1235814,10/01/2020 12:00:00 AM,250,402,374
Piedmont,Roanoke County,51161,605,2736,3341,777,5951,6728,152209,1099305,1251514,11/01/2020 12:00:00 AM,252,402,375
Piedmont,Roanoke County,51161,605,2747,3352,779,5854,6633,173881,1234805,1408686,03/01/2021 12:00:00 AM,287,450,420
Piedmont,Roanoke County,51161,608,2341,2949,812,5205,6017,79186,586978,666164,09/01/2018 12:00:00 AM,130,251,226
Piedmont,Roanoke County,51161,609,2423,3032,826,5413,6239,82265,612926,695191,04/01/2018 12:00:00 AM,135,253,229
Piedmont,Roanoke County,51161,610,2318,2928,781,5198,5979,74112,577859,651971,10/01/2019 12:00:00 AM,121,249,223
Piedmont,Roanoke County,51161,610,2652,3262,797,5963,6760,79043,684570,763613,03/01/2017 12:00:00 AM,130,258,234
Piedmont,Roanoke County,51161,611,2644,3255,797,5943,6740,79631,685178,764809,04/01/2017 12:00:00 AM,130,259,235
Piedmont,Roanoke County,51161,611,2722,3333,793,5898,6691,156168,1080218,1236386,12/01/2020 12:00:00 AM,256,397,371
Piedmont,Roanoke County,51161,612,2439,3051,823,5449,6272,79906,614683,694589,03/01/2018 12:00:00 AM,131,252,228
Piedmont,Roanoke County,51161,613,2603,3216,804,5835,6639,80924,662659,743583,06/01/2017 12:00:00 AM,132,255,231
Piedmont,Roanoke County,51161,613,2678,3291,816,6125,6941,79456,697358,776814,07/01/2016 12:00:00 AM,130,260,236
Piedmont,Roanoke County,51161,614,2607,3221,795,5845,6640,80245,674339,754584,05/01/2017 12:00:00 AM,131,259,234
Piedmont,Roanoke County,51161,614,2722,3336,813,6193,7006,77864,695836,773700,11/01/2016 12:00:00 AM,127,256,232
Piedmont,Roanoke County,51161,615,2382,2997,828,5368,6196,81087,608828,689915,05/01/2018 12:00:00 AM,132,256,230
Piedmont,Roanoke County,51161,615,2705,3320,819,6178,6997,79341,704834,784175,08/01/2016 12:00:00 AM,129,261,236
Piedmont,Roanoke County,51161,616,2379,2995,845,5299,6144,82608,598305,680913,07/01/2018 12:00:00 AM,134,251,227
Piedmont,Roanoke County,51161,616,2434,3050,820,5488,6308,80045,621680,701725,02/01/2018 12:00:00 AM,130,255,230
Piedmont,Roanoke County,51161,616,2729,3345,796,5801,6597,187980,1315675,1503655,05/01/2021 12:00:00 AM,305,482,450
Piedmont,Roanoke County,51161,617,2781,3398,865,6384,7249,83342,715872,799214,03/01/2016 12:00:00 AM,135,257,235
Piedmont,Roanoke County,51161,618,2698,3316,817,6129,6946,78993,683067,762060,12/01/2016 12:00:00 AM,128,253,230
Piedmont,Roanoke County,51161,618,2711,3329,827,6211,7038,82337,701803,784140,09/01/2016 12:00:00 AM,133,259,236
Piedmont,Roanoke County,51161,618,2714,3332,831,6182,7013,82102,695562,777664,10/01/2016 12:00:00 AM,133,256,233
Piedmont,Roanoke County,51161,620,2710,3330,809,5940,6749,153747,1019417,1173164,09/01/2020 12:00:00 AM,248,376,352
Piedmont,Roanoke County,51161,621,2401,3022,845,5318,6163,80453,597200,677653,06/01/2018 12:00:00 AM,130,249,224
Piedmont,Roanoke County,51161,622,2802,3424,875,6482,7357,85358,732189,817547,02/01/2016 12:00:00 AM,137,261,239
Piedmont,Roanoke County,51161,623,2603,3226,798,5604,6402,149046,970670,1119716,06/01/2020 12:00:00 AM,239,373,347
Piedmont,Roanoke County,51161,623,2610,3233,826,5854,6680,84697,669398,754095,07/01/2017 12:00:00 AM,136,256,233
Piedmont,Roanoke County,51161,624,2538,3162,801,5591,6392,148596,978023,1126619,04/01/2020 12:00:00 AM,238,385,356
Piedmont,Roanoke County,51161,624,2579,3203,840,5817,6657,85831,665178,751009,08/01/2017 12:00:00 AM,138,258,234
Piedmont,Roanoke County,51161,624,2692,3316,812,5847,6659,148697,999559,1148256,08/01/2020 12:00:00 AM,238,371,346
Piedmont,Roanoke County,51161,625,2770,3395,879,6391,7270,85566,719961,805527,01/01/2016 12:00:00 AM,137,260,237
Piedmont,Roanoke County,51161,627,2575,3202,810,5612,6422,150865,968722,1119587,05/01/2020 12:00:00 AM,241,376,350
Piedmont,Roanoke County,51161,627,2849,3476,903,6570,7473,87392,738239,825631,10/01/2015 12:00:00 AM,139,259,238
Piedmont,Roanoke County,51161,628,2652,3280,807,5718,6525,149103,984383,1133486,07/01/2020 12:00:00 AM,237,371,346
Piedmont,Roanoke County,51161,628,2746,3374,857,6305,7162,83885,742711,826596,06/01/2016 12:00:00 AM,134,270,245
Piedmont,Roanoke County,51161,628,2890,3518,928,6588,7516,91696,754662,846358,02/01/2015 12:00:00 AM,146,261,241
Piedmont,Roanoke County,51161,629,2698,3327,834,6142,6976,80906,685914,766820,01/01/2017 12:00:00 AM,129,254,230
Piedmont,Roanoke County,51161,629,2854,3483,882,6587,7469,85300,737900,823200,11/01/2015 12:00:00 AM,136,259,236
Piedmont,Roanoke County,51161,630,2738,3368,870,6327,7197,83680,702405,786085,04/01/2016 12:00:00 AM,133,257,233
Piedmont,Roanoke County,51161,631,2743,3374,812,5828,6640,197158,1319688,1516846,06/01/2021 12:00:00 AM,312,481,450
Piedmont,Roanoke County,51161,631,2800,3431,893,6428,7321,88220,717816,806036,12/01/2015 12:00:00 AM,140,256,235
Piedmont,Roanoke County,51161,631,2823,3454,903,6592,7495,89441,747366,836807,07/01/2015 12:00:00 AM,142,265,242
Piedmont,Roanoke County,51161,631,2860,3491,907,6609,7516,91160,749582,840742,06/01/2015 12:00:00 AM,144,262,241
Piedmont,Roanoke County,51161,632,2885,3517,909,6678,7587,90586,759277,849863,04/01/2015 12:00:00 AM,143,263,242
Piedmont,Roanoke County,51161,634,2463,3097,849,5487,6336,84362,617948,702310,01/01/2018 12:00:00 AM,133,251,227
Piedmont,Roanoke County,51161,635,2492,3127,843,5552,6395,85165,627072,712237,12/01/2017 12:00:00 AM,134,252,228
Piedmont,Roanoke County,51161,635,2728,3363,882,6294,7176,85397,720674,806071,05/01/2016 12:00:00 AM,134,264,240
Piedmont,Roanoke County,51161,635,2845,3480,920,6555,7475,92461,745784,838245,05/01/2015 12:00:00 AM,146,262,241
Piedmont,Roanoke County,51161,635,3051,3686,925,6932,7857,96934,803981,900915,10/01/2014 12:00:00 AM,153,264,244
Piedmont,Roanoke County,51161,636,2851,3487,917,6592,7509,94372,749652,844024,09/01/2015 12:00:00 AM,148,263,242
Piedmont,Roanoke County,51161,636,2925,3561,934,6655,7589,94697,750811,845508,01/01/2015 12:00:00 AM,149,257,237
Piedmont,Roanoke County,51161,636,3002,3638,935,6840,7775,97994,798126,896120,11/01/2014 12:00:00 AM,154,266,246
Piedmont,Roanoke County,51161,637,2535,3172,852,5665,6517,87030,646653.74,733683.74,10/01/2017 12:00:00 AM,137,255,231
Piedmont,Roanoke County,51161,637,2912,3549,936,6663,7599,92898,759404,852302,03/01/2015 12:00:00 AM,146,261,240
Piedmont,Roanoke County,51161,638,2816,3454,920,6596,7516,90952,744520,835472,08/01/2015 12:00:00 AM,143,264,242
Piedmont,Roanoke County,51161,639,2960,3599,939,6721,7660,97556,774899,872455,12/01/2014 12:00:00 AM,153,262,242
Piedmont,Roanoke County,51161,642,2551,3193,858,5753,6611,87044,661705,748749,09/01/2017 12:00:00 AM,136,259,234
Piedmont,Roanoke County,51161,645,3136,3781,941,7123,8064,104246,889739,993985,09/01/2012 12:00:00 AM,162,284,263
Piedmont,Roanoke County,51161,646,2539,3185,871,5679,6550,89608,649628,739236,11/01/2017 12:00:00 AM,139,256,232
Piedmont,Roanoke County,51161,646,3075,3721,945,6904,7849,92736,769714,862450,09/01/2014 12:00:00 AM,144,250,232
Piedmont,Roanoke County,51161,648,3121,3769,946,7038,7984,93805,785403,879208,08/01/2014 12:00:00 AM,145,252,233
Piedmont,Roanoke County,51161,650,3101,3751,1020,6996,8016,113470,881689,995159,07/01/2012 12:00:00 AM,175,284,265
Piedmont,Roanoke County,51161,652,3000,3652,1034,6772,7806,113216,827492,940708,01/01/2012 12:00:00 AM,174,276,258
Piedmont,Roanoke County,51161,654,3150,3804,951,7107,8058,95473,791996,887469,07/01/2014 12:00:00 AM,146,251,233
Piedmont,Roanoke County,51161,659,3121,3780,999,7059,8058,110418,879927,990345,08/01/2012 12:00:00 AM,168,282,262
Piedmont,Roanoke County,51161,662,3019,3681,1062,6827,7889,117405,841601,959006,03/01/2012 12:00:00 AM,177,279,261
Piedmont,Roanoke County,51161,663,3029,3692,1049,6830,7879,116751,844388,961139,02/01/2012 12:00:00 AM,176,279,260
Piedmont,Roanoke County,51161,663,3291,3954,1016,7434,8450,112639,908013,1020652,07/01/2013 12:00:00 AM,170,276,258
Piedmont,Roanoke County,51161,665,3144,3809,999,7124,8123,110746,882238,992984,11/01/2012 12:00:00 AM,167,281,261
Piedmont,Roanoke County,51161,665,3183,3848,965,7130,8095,95764,802552,898316,06/01/2014 12:00:00 AM,144,252,233
Piedmont,Roanoke County,51161,665,3223,3888,984,7240,8224,97417,818158,915575,03/01/2014 12:00:00 AM,146,254,235
Piedmont,Roanoke County,51161,666,3141,3807,1006,7100,8106,111419,886780,998199,10/01/2012 12:00:00 AM,167,282,262
Piedmont,Roanoke County,51161,666,3231,3897,963,7248,8211,96438,819758,916196,04/01/2014 12:00:00 AM,145,254,235
Piedmont,Roanoke County,51161,667,3085,3752,1061,6977,8038,116947,867805,984752,06/01/2012 12:00:00 AM,175,281,262
Piedmont,Roanoke County,51161,668,3338,4006,1009,7485,8494,114488,914355,1028843,10/01/2013 12:00:00 AM,171,274,257
Piedmont,Roanoke County,51161,669,3038,3707,1073,6866,7939,116943,857462,974405,04/01/2012 12:00:00 AM,175,282,263
Piedmont,Roanoke County,51161,670,3213,3883,1002,7207,8209,100996,813982,914978,02/01/2014 12:00:00 AM,151,253,236
Piedmont,Roanoke County,51161,670,3357,4027,1013,7585,8598,112455,928339,1040794,09/01/2013 12:00:00 AM,168,277,258
Piedmont,Roanoke County,51161,671,3161,3832,1019,7138,8157,111228,884222,995450,12/01/2012 12:00:00 AM,166,280,260
Piedmont,Roanoke County,51161,672,3243,3915,1044,7321,8365,116449,903732,1020181,06/01/2013 12:00:00 AM,173,279,261
Piedmont,Roanoke County,51161,673,3246,3919,994,7271,8265,100851,808110,908961,01/01/2014 12:00:00 AM,150,249,232
Piedmont,Roanoke County,51161,674,3213,3887,983,7180,8163,99455,809473,908928,05/01/2014 12:00:00 AM,148,252,234
Piedmont,Roanoke County,51161,674,3273,3947,1051,7373,8424,115232,900600,1015832,05/01/2013 12:00:00 AM,171,275,257
Piedmont,Roanoke County,51161,674,3324,3998,1035,7459,8494,109967,844050,954017,11/01/2013 12:00:00 AM,163,254,239
Piedmont,Roanoke County,51161,674,3328,4002,1046,7494,8540,116926,913254,1030180,08/01/2013 12:00:00 AM,173,274,257
Piedmont,Roanoke County,51161,676,3057,3733,1088,6886,7974,118722,858493,977215,05/01/2012 12:00:00 AM,176,281,262
Piedmont,Roanoke County,51161,678,3190,3868,1041,7196,8237,115456,888932,1004388,02/01/2013 12:00:00 AM,170,279,260
Piedmont,Roanoke County,51161,679,3155,3834,1050,7088,8138,113946,865714,979660,01/01/2013 12:00:00 AM,168,274,256
Piedmont,Roanoke County,51161,679,3210,3889,1058,7208,8266,118065,883763,1001828,04/01/2013 12:00:00 AM,174,275,258
Piedmont,Roanoke County,51161,683,3214,3897,1060,7256,8316,118399,892201,1010600,03/01/2013 12:00:00 AM,173,278,259
Piedmont,Roanoke County,51161,689,3263,3952,1048,7336,8384,110295,827705,938000,12/01/2013 12:00:00 AM,160,254,237
Piedmont,Rockbridge County,51163,175,840,1015,221,1925,2146,21822,215217,237039,09/01/2017 12:00:00 AM,125,256,234
Piedmont,Rockbridge County,51163,178,810,988,219,1873,2092,20313,208719,229032,11/01/2017 12:00:00 AM,114,258,232
Piedmont,Rockbridge County,51163,178,822,1000,220,1893,2113,19933,211448,231381,10/01/2017 12:00:00 AM,112,257,231
Piedmont,Rockbridge County,51163,182,773,955,223,1802,2025,19222,201578,220800,06/01/2018 12:00:00 AM,106,261,231
Piedmont,Rockbridge County,51163,182,790,972,232,1797,2029,21350,198330,219680,06/01/2019 12:00:00 AM,117,251,226
Piedmont,Rockbridge County,51163,183,795,978,228,1853,2081,20566,209212,229778,08/01/2018 12:00:00 AM,112,263,235
Piedmont,Rockbridge County,51163,183,850,1033,232,1933,2165,21218,222784,244002,08/01/2017 12:00:00 AM,116,262,236
Piedmont,Rockbridge County,51163,184,809,993,223,1879,2102,20741,210824,231565,12/01/2017 12:00:00 AM,113,261,233
Piedmont,Rockbridge County,51163,185,791,976,227,1819,2046,20186,203723,223909,05/01/2018 12:00:00 AM,109,258,229
Piedmont,Rockbridge County,51163,185,803,988,232,1837,2069,21928,200178,222106,05/01/2019 12:00:00 AM,119,249,225
Piedmont,Rockbridge County,51163,186,788,974,243,1811,2054,23378,198098,221476,08/01/2019 12:00:00 AM,126,251,227
Piedmont,Rockbridge County,51163,186,804,990,230,1848,2078,20334,209568,229902,03/01/2018 12:00:00 AM,109,261,232
Piedmont,Rockbridge County,51163,187,767,954,244,1772,2016,23435,192619,216054,11/01/2019 12:00:00 AM,125,251,226
Piedmont,Rockbridge County,51163,187,773,960,237,1758,1995,23359,190249,213608,02/01/2019 12:00:00 AM,125,246,223
Piedmont,Rockbridge County,51163,187,776,963,230,1801,2031,20155,204006,224161,07/01/2018 12:00:00 AM,108,263,233
Piedmont,Rockbridge County,51163,187,783,970,243,1787,2030,22627,199296,221923,07/01/2019 12:00:00 AM,121,255,229
Piedmont,Rockbridge County,51163,187,789,976,243,1836,2079,23221,202633,225854,09/01/2018 12:00:00 AM,124,257,231
Piedmont,Rockbridge County,51163,188,781,969,241,1796,2037,23148,196016,219164,10/01/2019 12:00:00 AM,123,251,226
Piedmont,Rockbridge County,51163,188,786,974,238,1788,2026,22529,198824,221353,04/01/2019 12:00:00 AM,120,253,227
Piedmont,Rockbridge County,51163,188,803,991,234,1854,2088,20874,213610,234484,02/01/2018 12:00:00 AM,111,266,237
Piedmont,Rockbridge County,51163,188,841,1029,238,1957,2195,21881,226428,248309,07/01/2017 12:00:00 AM,116,269,241
Piedmont,Rockbridge County,51163,188,847,1035,233,2006,2239,20935,226047,246982,06/01/2017 12:00:00 AM,111,267,239
Piedmont,Rockbridge County,51163,188,876,1064,235,2043,2278,20856,229724,250580,03/01/2017 12:00:00 AM,111,262,236
Piedmont,Rockbridge County,51163,188,914,1102,240,2079,2319,57292,453078,510370,05/01/2021 12:00:00 AM,305,496,463
Piedmont,Rockbridge County,51163,189,754,943,249,1751,2000,23959,193354,217313,02/01/2020 12:00:00 AM,127,256,230
Piedmont,Rockbridge County,51163,189,772,961,245,1795,2040,23110,195661,218771,01/01/2020 12:00:00 AM,122,253,228
Piedmont,Rockbridge County,51163,189,800,989,249,1815,2064,24926,201727,226653,03/01/2019 12:00:00 AM,132,252,229
Piedmont,Rockbridge County,51163,189,807,996,242,1874,2116,23634,204776,228410,11/01/2018 12:00:00 AM,125,254,229
Piedmont,Rockbridge County,51163,190,762,952,251,1778,2029,45955,299383,345338,03/01/2020 12:00:00 AM,242,393,363
Piedmont,Rockbridge County,51163,190,799,989,239,1837,2076,21136,204101,225237,04/01/2018 12:00:00 AM,111,255,228
Piedmont,Rockbridge County,51163,190,801,991,249,1844,2093,24770,203454,228224,10/01/2018 12:00:00 AM,130,254,230
Piedmont,Rockbridge County,51163,190,898,1088,225,2142,2367,19112,226318,245430,06/01/2016 12:00:00 AM,101,252,226
Piedmont,Rockbridge County,51163,190,913,1103,228,2161,2389,20035,231999,252034,09/01/2016 12:00:00 AM,105,254,228
Piedmont,Rockbridge County,51163,190,925,1115,226,2196,2422,19917,239045,258962,10/01/2016 12:00:00 AM,105,258,232
Piedmont,Rockbridge County,51163,191,778,969,246,1795,2041,23536,197654,221190,09/01/2019 12:00:00 AM,123,254,228
Piedmont,Rockbridge County,51163,191,780,971,248,1809,2057,23210,202279,225489,12/01/2019 12:00:00 AM,122,259,232
Piedmont,Rockbridge County,51163,191,811,1002,243,1874,2117,24074,204565,228639,12/01/2018 12:00:00 AM,126,252,228
Piedmont,Rockbridge County,51163,191,912,1103,241,2144,2385,22213,231737,253950,11/01/2016 12:00:00 AM,116,254,230
Piedmont,Rockbridge County,51163,192,803,995,241,1833,2074,21591,206134,227725,01/01/2018 12:00:00 AM,112,257,229
Piedmont,Rockbridge County,51163,192,830,1022,253,1906,2159,47103,328000,375103,04/01/2020 12:00:00 AM,245,395,367
Piedmont,Rockbridge County,51163,192,918,1110,243,2093,2336,57623,461647,519270,04/01/2021 12:00:00 AM,300,503,468
Piedmont,Rockbridge County,51163,193,813,1006,248,1880,2128,24935,214489,239424,01/01/2019 12:00:00 AM,129,264,238
Piedmont,Rockbridge County,51163,193,913,1106,245,2051,2296,58396,459828,518224,06/01/2021 12:00:00 AM,303,504,469
Piedmont,Rockbridge County,51163,193,926,1119,242,2121,2363,54986,439752,494738,03/01/2021 12:00:00 AM,285,475,442
Piedmont,Rockbridge County,51163,194,856,1050,243,2013,2256,22828,229340,252168,05/01/2017 12:00:00 AM,118,268,240
Piedmont,Rockbridge County,51163,194,900,1094,235,2149,2384,20647,230516,251163,07/01/2016 12:00:00 AM,106,256,230
Piedmont,Rockbridge County,51163,194,902,1096,246,2054,2300,45934,354932,400866,09/01/2020 12:00:00 AM,237,393,366
Piedmont,Rockbridge County,51163,194,906,1100,237,2165,2402,21581,233498,255079,05/01/2016 12:00:00 AM,111,258,232
Piedmont,Rockbridge County,51163,194,908,1102,247,2126,2373,22253,233319,255572,12/01/2016 12:00:00 AM,115,257,232
Piedmont,Rockbridge County,51163,194,914,1108,238,2169,2407,19963,233215,253178,08/01/2016 12:00:00 AM,103,255,229
Piedmont,Rockbridge County,51163,194,937,1131,245,2146,2391,56165,451698,507863,02/01/2021 12:00:00 AM,290,482,449
Piedmont,Rockbridge County,51163,195,854,1049,255,1949,2204,46883,330817,377700,05/01/2020 12:00:00 AM,240,387,360
Piedmont,Rockbridge County,51163,195,857,1052,254,1941,2195,47212,333324,380536,06/01/2020 12:00:00 AM,242,389,362
Piedmont,Rockbridge County,51163,195,873,1068,250,2012,2262,46083,345617,391700,08/01/2020 12:00:00 AM,236,396,367
Piedmont,Rockbridge County,51163,195,909,1104,250,2074,2324,49977,380034,430011,11/01/2020 12:00:00 AM,256,418,390
Piedmont,Rockbridge County,51163,195,913,1108,242,2133,2375,21295,235975,257270,01/01/2017 12:00:00 AM,109,258,232
Piedmont,Rockbridge County,51163,195,923,1118,251,2119,2370,55973,437847,493820,01/01/2021 12:00:00 AM,287,474,442
Piedmont,Rockbridge County,51163,195,927,1122,248,2125,2373,47430,388343,435773,10/01/2020 12:00:00 AM,243,419,388
Piedmont,Rockbridge County,51163,196,917,1113,256,2081,2337,49579,376918,426497,12/01/2020 12:00:00 AM,253,411,383
Piedmont,Rockbridge County,51163,197,855,1052,246,2032,2278,21850,229946,251796,04/01/2017 12:00:00 AM,111,269,239
Piedmont,Rockbridge County,51163,197,871,1068,254,1976,2230,47184,341710,388894,07/01/2020 12:00:00 AM,240,392,364
Piedmont,Rockbridge County,51163,197,924,1121,246,2156,2402,21612,237233,258845,02/01/2017 12:00:00 AM,110,257,231
Piedmont,Rockbridge County,51163,197,958,1155,245,2299,2544,21070,262165,283235,05/01/2015 12:00:00 AM,107,274,245
Piedmont,Rockbridge County,51163,198,951,1149,243,2288,2531,20451,257451,277902,07/01/2015 12:00:00 AM,103,271,242
Piedmont,Rockbridge County,51163,199,924,1123,245,2222,2467,22857,240640,263497,04/01/2016 12:00:00 AM,115,260,235
Piedmont,Rockbridge County,51163,199,947,1146,245,2251,2496,20888,252464,273352,06/01/2015 12:00:00 AM,105,267,239
Piedmont,Rockbridge County,51163,200,937,1137,255,2246,2501,22101,252155,274256,09/01/2015 12:00:00 AM,111,269,241
Piedmont,Rockbridge County,51163,201,967,1168,255,2306,2561,23098,259429,282527,04/01/2015 12:00:00 AM,115,268,242
Piedmont,Rockbridge County,51163,202,927,1129,257,2236,2493,22805,243572,266377,02/01/2016 12:00:00 AM,113,263,236
Piedmont,Rockbridge County,51163,202,931,1133,255,2237,2492,22383,240445,262828,03/01/2016 12:00:00 AM,111,258,232
Piedmont,Rockbridge County,51163,202,953,1155,254,2300,2554,22027,259713,281740,08/01/2015 12:00:00 AM,109,273,244
Piedmont,Rockbridge County,51163,203,1054,1257,262,2453,2715,24501,266886,291387,12/01/2013 12:00:00 AM,121,253,232
Piedmont,Rockbridge County,51163,204,1041,1245,251,2431,2682,24117,282791,306908,05/01/2013 12:00:00 AM,118,272,247
Piedmont,Rockbridge County,51163,205,1030,1235,262,2413,2675,26377,286247,312624,08/01/2013 12:00:00 AM,129,278,253
Piedmont,Rockbridge County,51163,205,1036,1241,266,2430,2696,26271,287954,314225,07/01/2013 12:00:00 AM,128,278,253
Piedmont,Rockbridge County,51163,205,1059,1264,267,2462,2729,24400,262570,286970,01/01/2014 12:00:00 AM,119,248,227
Piedmont,Rockbridge County,51163,205,934,1139,254,2272,2526,22867,251725,274592,10/01/2015 12:00:00 AM,112,270,241
Piedmont,Rockbridge County,51163,206,1027,1233,268,2362,2630,25174,261499,286673,06/01/2014 12:00:00 AM,122,255,233
Piedmont,Rockbridge County,51163,206,1077,1283,265,2464,2729,24736,271662,296398,04/01/2014 12:00:00 AM,120,252,231
Piedmont,Rockbridge County,51163,206,928,1134,257,2248,2505,23178,246772,269950,11/01/2015 12:00:00 AM,113,266,238
Piedmont,Rockbridge County,51163,206,954,1160,275,2257,2532,24400,253331,277731,03/01/2015 12:00:00 AM,118,266,239
Piedmont,Rockbridge County,51163,206,964,1170,274,2240,2514,24496,248911,273407,02/01/2015 12:00:00 AM,119,258,234
Piedmont,Rockbridge County,51163,206,971,1177,267,2261,2528,23243,249052,272295,01/01/2015 12:00:00 AM,113,256,231
Piedmont,Rockbridge County,51163,207,1023,1230,262,2385,2647,25800,281690,307490,04/01/2013 12:00:00 AM,125,275,250
Piedmont,Rockbridge County,51163,208,1034,1242,274,2437,2711,27902,284998,312900,09/01/2013 12:00:00 AM,134,276,252
Piedmont,Rockbridge County,51163,208,1041,1249,267,2451,2718,26583,288166,314749,06/01/2013 12:00:00 AM,128,277,252
Piedmont,Rockbridge County,51163,208,1041,1249,273,2440,2713,25956,262686,288642,11/01/2013 12:00:00 AM,125,252,231
Piedmont,Rockbridge County,51163,208,996,1204,272,2295,2567,26545,272341,298886,10/01/2012 12:00:00 AM,128,273,248
Piedmont,Rockbridge County,51163,209,1001,1210,269,2294,2563,24111,252480,276591,09/01/2014 12:00:00 AM,115,252,229
Piedmont,Rockbridge County,51163,209,1005,1214,273,2323,2596,24076,256825,280901,07/01/2014 12:00:00 AM,115,256,231
Piedmont,Rockbridge County,51163,209,1012,1221,272,2355,2627,24137,259954,284091,08/01/2014 12:00:00 AM,115,257,233
Piedmont,Rockbridge County,51163,209,1015,1224,265,2345,2610,26446,280654,307100,03/01/2013 12:00:00 AM,127,277,251
Piedmont,Rockbridge County,51163,209,1067,1276,276,2450,2726,25318,268696,294014,03/01/2014 12:00:00 AM,121,252,230
Piedmont,Rockbridge County,51163,209,995,1204,286,2338,2624,28113,274486,302599,01/01/2012 12:00:00 AM,135,276,251
Piedmont,Rockbridge County,51163,210,1006,1216,268,2312,2580,26510,273810,300320,12/01/2012 12:00:00 AM,126,272,247
Piedmont,Rockbridge County,51163,210,1015,1225,267,2343,2610,25622,274325,299947,01/01/2013 12:00:00 AM,122,270,245
Piedmont,Rockbridge County,51163,210,1017,1227,293,2392,2685,28881,283350,312231,02/01/2012 12:00:00 AM,138,279,254
Piedmont,Rockbridge County,51163,210,1053,1263,273,2421,2694,25742,267483,293225,05/01/2014 12:00:00 AM,123,254,232
Piedmont,Rockbridge County,51163,210,1058,1268,275,2434,2709,25086,266161,291247,02/01/2014 12:00:00 AM,119,252,230
Piedmont,Rockbridge County,51163,210,926,1136,269,2224,2493,24603,240482,265085,01/01/2016 12:00:00 AM,117,260,233
Piedmont,Rockbridge County,51163,210,930,1140,266,2242,2508,24152,245121,269273,12/01/2015 12:00:00 AM,115,264,236
Piedmont,Rockbridge County,51163,211,965,1176,285,2299,2584,28289,271537,299826,05/01/2012 12:00:00 AM,134,281,255
Piedmont,Rockbridge County,51163,211,971,1182,288,2307,2595,28634,272049,300683,06/01/2012 12:00:00 AM,136,280,254
Piedmont,Rockbridge County,51163,211,974,1185,280,2258,2538,27871,267594,295465,09/01/2012 12:00:00 AM,132,275,249
Piedmont,Rockbridge County,51163,211,980,1191,277,2305,2582,25464,257685,283149,12/01/2014 12:00:00 AM,121,263,238
Piedmont,Rockbridge County,51163,211,998,1209,277,2285,2562,26721,268205,294926,11/01/2012 12:00:00 AM,127,269,244
Piedmont,Rockbridge County,51163,212,966,1178,281,2258,2539,27318,254673,281991,11/01/2014 12:00:00 AM,129,264,239
Piedmont,Rockbridge County,51163,212,967,1179,285,2282,2567,28890,275775,304665,07/01/2012 12:00:00 AM,136,285,258
Piedmont,Rockbridge County,51163,212,992,1204,281,2304,2585,27383,264343,291726,10/01/2014 12:00:00 AM,129,266,242
Piedmont,Rockbridge County,51163,214,1017,1231,274,2361,2635,26933,279416,306349,02/01/2013 12:00:00 AM,126,275,249
Piedmont,Rockbridge County,51163,214,1041,1255,283,2447,2730,28759,285253,314012,10/01/2013 12:00:00 AM,134,274,250
Piedmont,Rockbridge County,51163,214,970,1184,290,2305,2595,28963,273153,302116,04/01/2012 12:00:00 AM,135,282,255
Piedmont,Rockbridge County,51163,214,974,1188,287,2278,2565,28325,267994,296319,08/01/2012 12:00:00 AM,132,275,249
Piedmont,Rockbridge County,51163,214,998,1212,296,2370,2666,28898,281876,310774,03/01/2012 12:00:00 AM,135,282,256
Piedmont,Salem City,51775,0,0,0,0,0,0,0,0,0,05/01/2016 12:00:00 AM,,,
Piedmont,Salem City,51775,0,0,0,0,0,0,0,0,0,06/01/2016 12:00:00 AM,,,
Piedmont,Salem City,51775,0,1,1,0,1,1,0,118,118,04/01/2016 12:00:00 AM,,118,118
Piedmont,Salem City,51775,0,1,1,0,2,2,0,120,120,01/01/2014 12:00:00 AM,,120,120
Piedmont,Salem City,51775,0,1,1,0,2,2,0,120,120,02/01/2014 12:00:00 AM,,120,120
Piedmont,Salem City,51775,0,1,1,0,2,2,0,120,120,03/01/2014 12:00:00 AM,,120,120
Piedmont,Salem City,51775,0,1,1,0,2,2,0,120,120,05/01/2014 12:00:00 AM,,120,120
Piedmont,Salem City,51775,0,1,1,0,2,2,0,120,120,06/01/2014 12:00:00 AM,,120,120
Piedmont,Salem City,51775,0,1,1,0,2,2,0,120,120,07/01/2014 12:00:00 AM,,120,120
Piedmont,Salem City,51775,0,1,1,0,2,2,0,171,171,09/01/2015 12:00:00 AM,,171,171
Piedmont,Salem City,51775,0,1,1,0,3,3,0,338,338,02/01/2015 12:00:00 AM,,338,338
Piedmont,Salem City,51775,0,1,1,0,3,3,0,338,338,03/01/2015 12:00:00 AM,,338,338
Piedmont,Salem City,51775,0,1,1,0,4,4,0,187,187,04/01/2013 12:00:00 AM,,187,187
Piedmont,Salem City,51775,0,1,1,0,4,4,0,620,620,10/01/2015 12:00:00 AM,,620,620
Piedmont,Salem City,51775,0,1,1,0,4,4,0,620,620,11/01/2015 12:00:00 AM,,620,620
Piedmont,Salem City,51775,0,2,2,0,3,3,0,186,186,04/01/2014 12:00:00 AM,,93,93
Piedmont,Salem City,51775,0,2,2,0,3,3,0,309,309,08/01/2014 12:00:00 AM,,155,155
Piedmont,Salem City,51775,0,2,2,0,3,3,0,309,309,09/01/2014 12:00:00 AM,,155,155
Piedmont,Salem City,51775,0,2,2,0,3,3,0,326,326,10/01/2014 12:00:00 AM,,163,163
Piedmont,Salem City,51775,0,2,2,0,4,4,0,366,366,01/01/2012 12:00:00 AM,,183,183
Piedmont,Salem City,51775,0,2,2,0,8,8,0,935,935,09/01/2013 12:00:00 AM,,468,468
Piedmont,Salem City,51775,0,2,2,0,9,9,0,1050,1050,04/01/2015 12:00:00 AM,,525,525
Piedmont,Salem City,51775,0,2,2,0,9,9,0,1050,1050,05/01/2015 12:00:00 AM,,525,525
Piedmont,Salem City,51775,0,3,3,0,4,4,0,686,686,11/01/2014 12:00:00 AM,,229,229
Piedmont,Salem City,51775,0,3,3,0,7,7,0,1095,1095,12/01/2015 12:00:00 AM,,365,365
Piedmont,Salem City,51775,0,3,3,0,7,7,0,737,737,03/01/2016 12:00:00 AM,,246,246
Piedmont,Salem City,51775,0,4,4,0,11,11,0,1357,1357,02/01/2016 12:00:00 AM,,339,339
Piedmont,Salem City,51775,0,4,4,0,9,9,0,1452,1452,01/01/2016 12:00:00 AM,,363,363
Piedmont,Salem City,51775,1,0,1,1,0,1,90,0,90,03/01/2012 12:00:00 AM,90,,90
Piedmont,Salem City,51775,1,0,1,1,0,1,90,0,90,04/01/2012 12:00:00 AM,90,,90
Piedmont,Salem City,51775,1,0,1,3,0,3,508,0,508,07/01/2012 12:00:00 AM,508,,508
Piedmont,Salem City,51775,1,1,2,1,3,4,90,166,256,02/01/2012 12:00:00 AM,90,166,128
Piedmont,Salem City,51775,1,1,2,3,2,5,508,359,867,08/01/2012 12:00:00 AM,508,359,434
Piedmont,South Boston City,51780,0,0,0,0,0,0,0,0,0,05/01/2016 12:00:00 AM,,,
Piedmont,South Boston City,51780,0,0,0,0,0,0,0,0,0,06/01/2016 12:00:00 AM,,,
Piedmont,South Boston City,51780,0,1,1,0,1,1,0,194,194,04/01/2016 12:00:00 AM,,194,194
Piedmont,South Boston City,51780,0,1,1,0,1,1,0,200,200,01/01/2012 12:00:00 AM,,200,200
Piedmont,South Boston City,51780,0,1,1,0,4,4,0,623,623,06/01/2015 12:00:00 AM,,623,623
Piedmont,South Boston City,51780,0,1,1,0,4,4,0,623,623,07/01/2015 12:00:00 AM,,623,623
Piedmont,South Boston City,51780,0,1,1,0,4,4,0,623,623,08/01/2015 12:00:00 AM,,623,623
Piedmont,South Boston City,51780,1,0,1,2,0,2,97,0,97,12/01/2014 12:00:00 AM,97,,97
Piedmont,Staunton City,51790,265,1057,1322,362,2199,2561,36075,248130,284205,04/01/2018 12:00:00 AM,136,235,215
Piedmont,Staunton City,51790,266,1195,1461,354,2461,2815,78512,522232,600744,02/01/2021 12:00:00 AM,295,437,411
Piedmont,Staunton City,51790,268,1183,1451,368,2430,2798,86054,552266,638320,04/01/2021 12:00:00 AM,321,467,440
Piedmont,Staunton City,51790,270,1046,1316,377,2219,2596,38304,247753,286057,05/01/2018 12:00:00 AM,142,237,217
Piedmont,Staunton City,51790,271,1212,1483,367,2480,2847,81643,522524,604167,03/01/2021 12:00:00 AM,301,431,407
Piedmont,Staunton City,51790,274,1066,1340,375,2212,2587,37059,253103,290162,03/01/2018 12:00:00 AM,135,237,217
Piedmont,Staunton City,51790,276,1057,1333,387,2278,2665,40042,261076,301118,05/01/2017 12:00:00 AM,145,247,226
Piedmont,Staunton City,51790,279,1012,1291,412,2146,2558,41012,230742,271754,07/01/2018 12:00:00 AM,147,228,210
Piedmont,Staunton City,51790,279,1036,1315,410,2154,2564,40852,236799,277651,09/01/2018 12:00:00 AM,146,229,211
Piedmont,Staunton City,51790,279,1172,1451,395,2408,2803,90686,542292,632978,05/01/2021 12:00:00 AM,325,463,436
Piedmont,Staunton City,51790,280,1040,1320,407,2179,2586,41204,238792,279996,06/01/2018 12:00:00 AM,147,230,212
Piedmont,Staunton City,51790,280,1088,1368,390,2280,2670,37374,259962,297336,01/01/2018 12:00:00 AM,133,239,217
Piedmont,Staunton City,51790,280,1181,1461,400,2404,2804,95703,543038,638741,06/01/2021 12:00:00 AM,342,460,437
Piedmont,Staunton City,51790,281,1076,1357,390,2253,2643,39457,256387,295844,02/01/2018 12:00:00 AM,140,238,218
Piedmont,Staunton City,51790,281,999,1280,398,2142,2540,38234,234722,272956,02/01/2019 12:00:00 AM,136,235,213
Piedmont,Staunton City,51790,282,1025,1307,410,2162,2572,43488,240298,283786,08/01/2018 12:00:00 AM,154,234,217
Piedmont,Staunton City,51790,282,1070,1352,385,2295,2680,39526,261711,301237,04/01/2017 12:00:00 AM,140,245,223
Piedmont,Staunton City,51790,283,1072,1355,379,2261,2640,39149,261556,300705,07/01/2017 12:00:00 AM,138,244,222
Piedmont,Staunton City,51790,284,1045,1329,419,2155,2574,42405,245032,287437,07/01/2019 12:00:00 AM,149,234,216
Piedmont,Staunton City,51790,284,1089,1373,387,2350,2737,38327,272077,310404,03/01/2017 12:00:00 AM,135,250,226
Piedmont,Staunton City,51790,285,1054,1339,403,2186,2589,40205,244793,284998,05/01/2019 12:00:00 AM,141,232,213
Piedmont,Staunton City,51790,285,1069,1354,388,2267,2655,40822,260770,301592,06/01/2017 12:00:00 AM,143,244,223
Piedmont,Staunton City,51790,286,1019,1305,425,2155,2580,42650,237124,279774,10/01/2018 12:00:00 AM,149,233,214
Piedmont,Staunton City,51790,286,1059,1345,396,2229,2625,40715,252207,292922,12/01/2017 12:00:00 AM,142,238,218
Piedmont,Staunton City,51790,286,1087,1373,397,2300,2697,40525,260504,301029,08/01/2017 12:00:00 AM,142,240,219
Piedmont,Staunton City,51790,286,1091,1377,399,2286,2685,40112,267421,307533,09/01/2017 12:00:00 AM,140,245,223
Piedmont,Staunton City,51790,287,1034,1321,413,2155,2568,41743,243640,285383,06/01/2019 12:00:00 AM,145,236,216
Piedmont,Staunton City,51790,287,1069,1356,402,2213,2615,40908,250666,291574,10/01/2017 12:00:00 AM,143,234,215
Piedmont,Staunton City,51790,288,1037,1325,405,2232,2637,38936,244605,283541,03/01/2019 12:00:00 AM,135,236,214
Piedmont,Staunton City,51790,288,1053,1341,402,2213,2615,38354,246656,285010,04/01/2019 12:00:00 AM,133,234,213
Piedmont,Staunton City,51790,288,1112,1400,398,2395,2793,39003,265117,304120,02/01/2017 12:00:00 AM,135,238,217
Piedmont,Staunton City,51790,289,1041,1330,425,2232,2657,43798,249158,292956,11/01/2018 12:00:00 AM,152,239,220
Piedmont,Staunton City,51790,290,1033,1323,410,2198,2608,39945,247887,287832,01/01/2019 12:00:00 AM,138,240,218
Piedmont,Staunton City,51790,290,1033,1323,420,2208,2628,41280,249582,290862,12/01/2018 12:00:00 AM,142,242,220
Piedmont,Staunton City,51790,290,1157,1447,414,2318,2732,79842,424706,504548,12/01/2020 12:00:00 AM,275,367,349
Piedmont,Staunton City,51790,291,1074,1365,412,2247,2659,43377,256778,300155,11/01/2017 12:00:00 AM,149,239,220
Piedmont,Staunton City,51790,291,1162,1453,420,2365,2785,91912,491339,583251,01/01/2021 12:00:00 AM,316,423,401
Piedmont,Staunton City,51790,292,1179,1471,417,2378,2795,77815,444020,521835,11/01/2020 12:00:00 AM,266,377,355
Piedmont,Staunton City,51790,292,1183,1475,415,2402,2817,80958,441643,522601,10/01/2020 12:00:00 AM,277,373,354
Piedmont,Staunton City,51790,294,1018,1312,422,2078,2500,43134,233223,276357,12/01/2019 12:00:00 AM,147,229,211
Piedmont,Staunton City,51790,294,1028,1322,416,2093,2509,39551,232756,272307,01/01/2020 12:00:00 AM,135,226,206
Piedmont,Staunton City,51790,294,1193,1487,415,2393,2808,75604,414061,489665,08/01/2020 12:00:00 AM,257,347,329
Piedmont,Staunton City,51790,294,1200,1494,418,2421,2839,77896,424373,502269,09/01/2020 12:00:00 AM,265,354,336
Piedmont,Staunton City,51790,295,1009,1304,425,2069,2494,43592,230142,273734,11/01/2019 12:00:00 AM,148,228,210
Piedmont,Staunton City,51790,295,1024,1319,423,2097,2520,43754,239524,283278,10/01/2019 12:00:00 AM,148,234,215
Piedmont,Staunton City,51790,295,1097,1392,407,2387,2794,38064,263846,301910,01/01/2017 12:00:00 AM,129,241,217
Piedmont,Staunton City,51790,295,1188,1483,412,2396,2808,75232,413073,488305,07/01/2020 12:00:00 AM,255,348,329
Piedmont,Staunton City,51790,296,1115,1411,400,2443,2843,38597,268858,307455,12/01/2016 12:00:00 AM,130,241,218
Piedmont,Staunton City,51790,297,1019,1316,445,2128,2573,44450,239854,284304,08/01/2019 12:00:00 AM,150,235,216
Piedmont,Staunton City,51790,298,1014,1312,419,2069,2488,41239,229767,271006,02/01/2020 12:00:00 AM,138,227,207
Piedmont,Staunton City,51790,298,1019,1317,425,2088,2513,77392,361660,439052,03/01/2020 12:00:00 AM,260,355,333
Piedmont,Staunton City,51790,298,1167,1465,417,2342,2759,76275,408510,484785,06/01/2020 12:00:00 AM,256,350,331
Piedmont,Staunton City,51790,304,1019,1323,442,2115,2557,44172,242556,286728,09/01/2019 12:00:00 AM,145,238,217
Piedmont,Staunton City,51790,304,1130,1434,432,2300,2732,78878,396348,475226,04/01/2020 12:00:00 AM,259,351,331
Piedmont,Staunton City,51790,305,1167,1472,437,2349,2786,79708,415474,495182,05/01/2020 12:00:00 AM,261,356,336
Piedmont,Staunton City,51790,306,1126,1432,424,2468,2892,42709,267870,310579,11/01/2016 12:00:00 AM,140,238,217
Piedmont,Staunton City,51790,308,1134,1442,425,2514,2939,44407,274727,319134,10/01/2016 12:00:00 AM,144,242,221
Piedmont,Staunton City,51790,316,1195,1511,433,2660,3093,42298,289163,331461,08/01/2016 12:00:00 AM,134,242,219
Piedmont,Staunton City,51790,317,1140,1457,439,2547,2986,43865,274897,318762,09/01/2016 12:00:00 AM,138,241,219
Piedmont,Staunton City,51790,318,1189,1507,427,2655,3082,40463,289582,330045,07/01/2016 12:00:00 AM,127,244,219
Piedmont,Staunton City,51790,321,1189,1510,440,2629,3069,41369,288216,329585,06/01/2016 12:00:00 AM,129,242,218
Piedmont,Staunton City,51790,323,1205,1528,447,2672,3119,42383,300048,342431,05/01/2016 12:00:00 AM,131,249,224
Piedmont,Staunton City,51790,325,1236,1561,442,2716,3158,41359,306096,347455,04/01/2016 12:00:00 AM,127,248,223
Piedmont,Staunton City,51790,340,1427,1767,502,3062,3564,50395,353086,403481,12/01/2014 12:00:00 AM,148,247,228
Piedmont,Staunton City,51790,340,1450,1790,502,3140,3642,51315,360372,411687,11/01/2014 12:00:00 AM,151,249,230
Piedmont,Staunton City,51790,341,1513,1854,516,3189,3705,47280,354518,401798,08/01/2014 12:00:00 AM,139,234,217
Piedmont,Staunton City,51790,341,1583,1924,545,3271,3816,50246,364803,415049,06/01/2014 12:00:00 AM,147,230,216
Piedmont,Staunton City,51790,343,1231,1574,494,2701,3195,46910,302885,349795,03/01/2016 12:00:00 AM,137,246,222
Piedmont,Staunton City,51790,343,1342,1685,516,2902,3418,52357,334278,386635,02/01/2015 12:00:00 AM,153,249,229
Piedmont,Staunton City,51790,343,1527,1870,531,3187,3718,47440,353553,400993,07/01/2014 12:00:00 AM,138,232,214
Piedmont,Staunton City,51790,345,1393,1738,513,2998,3511,50763,343041,393804,01/01/2015 12:00:00 AM,147,246,227
Piedmont,Staunton City,51790,345,1489,1834,513,3135,3648,46890,345408,392298,09/01/2014 12:00:00 AM,136,232,214
Piedmont,Staunton City,51790,346,1614,1960,563,3307,3870,52689,372893,425582,05/01/2014 12:00:00 AM,152,231,217
Piedmont,Staunton City,51790,348,1242,1590,500,2770,3270,47474,308414,355888,01/01/2016 12:00:00 AM,136,248,224
Piedmont,Staunton City,51790,348,1466,1814,530,3143,3673,54467,361708,416175,10/01/2014 12:00:00 AM,157,247,229
Piedmont,Staunton City,51790,350,1231,1581,500,2707,3207,47678,307023,354701,02/01/2016 12:00:00 AM,136,249,224
Piedmont,Staunton City,51790,350,1603,1953,562,3284,3846,52258,373211,425469,04/01/2014 12:00:00 AM,149,233,218
Piedmont,Staunton City,51790,350,1618,1968,553,3313,3866,52399,375240,427639,03/01/2014 12:00:00 AM,150,232,217
Piedmont,Staunton City,51790,352,1284,1636,523,2819,3342,51163,316708,367871,10/01/2015 12:00:00 AM,145,247,225
Piedmont,Staunton City,51790,352,1309,1661,515,2860,3375,50424,333051,383475,06/01/2015 12:00:00 AM,143,254,231
Piedmont,Staunton City,51790,353,1293,1646,515,2838,3353,50794,321378,372172,08/01/2015 12:00:00 AM,144,249,226
Piedmont,Staunton City,51790,353,1322,1675,516,2866,3382,49590,332056,381646,05/01/2015 12:00:00 AM,140,251,228
Piedmont,Staunton City,51790,353,1611,1964,559,3268,3827,52792,370746,423538,02/01/2014 12:00:00 AM,150,230,216
Piedmont,Staunton City,51790,354,1273,1627,510,2823,3333,49788,316686,366474,11/01/2015 12:00:00 AM,141,249,225
Piedmont,Staunton City,51790,355,1254,1609,509,2782,3291,47952,310477,358429,12/01/2015 12:00:00 AM,135,248,223
Piedmont,Staunton City,51790,355,1289,1644,514,2819,3333,48747,321219,369966,07/01/2015 12:00:00 AM,137,249,225
Piedmont,Staunton City,51790,355,1290,1645,522,2857,3379,50750,326679,377429,09/01/2015 12:00:00 AM,143,253,229
Piedmont,Staunton City,51790,357,1337,1694,524,2891,3415,50761,329753,380514,04/01/2015 12:00:00 AM,142,247,225
Piedmont,Staunton City,51790,357,1648,2005,540,3336,3876,51340,379837,431177,11/01/2013 12:00:00 AM,144,230,215
Piedmont,Staunton City,51790,358,1337,1695,537,2903,3440,53437,331361,384798,03/01/2015 12:00:00 AM,149,248,227
Piedmont,Staunton City,51790,358,1699,2057,577,3483,4060,61217,436709,497926,04/01/2013 12:00:00 AM,171,257,242
Piedmont,Staunton City,51790,358,1750,2108,612,3598,4210,65726,460881,526607,09/01/2012 12:00:00 AM,184,263,250
Piedmont,Staunton City,51790,359,1689,2048,559,3479,4038,59606,439802,499408,06/01/2013 12:00:00 AM,166,260,244
Piedmont,Staunton City,51790,359,1694,2053,559,3555,4114,57165,446593,503758,02/01/2013 12:00:00 AM,159,264,245
Piedmont,Staunton City,51790,360,1677,2037,579,3485,4064,61175,436363,497538,03/01/2013 12:00:00 AM,170,260,244
Piedmont,Staunton City,51790,361,1701,2062,564,3468,4032,60881,437043,497924,05/01/2013 12:00:00 AM,169,257,241
Piedmont,Staunton City,51790,363,1649,2012,554,3344,3898,54446,379950,434396,12/01/2013 12:00:00 AM,150,230,216
Piedmont,Staunton City,51790,363,1660,2023,552,3404,3956,57816,428580,486396,10/01/2013 12:00:00 AM,159,258,240
Piedmont,Staunton City,51790,365,1607,1972,569,3250,3819,54435,363110,417545,01/01/2014 12:00:00 AM,149,226,212
Piedmont,Staunton City,51790,366,1749,2115,607,3631,4238,64188,461553,525741,10/01/2012 12:00:00 AM,175,264,249
Piedmont,Staunton City,51790,367,1693,2060,595,3446,4041,64316,432676,496992,07/01/2013 12:00:00 AM,175,256,241
Piedmont,Staunton City,51790,368,1732,2100,607,3600,4207,67029,454348,521377,11/01/2012 12:00:00 AM,182,262,248
Piedmont,Staunton City,51790,369,1708,2077,594,3595,4189,63299,451815,515114,12/01/2012 12:00:00 AM,172,265,248
Piedmont,Staunton City,51790,370,1694,2064,587,3562,4149,61375,443658,505033,01/01/2013 12:00:00 AM,166,262,245
Piedmont,Staunton City,51790,370,1696,2066,589,3446,4035,62994,430995,493989,08/01/2013 12:00:00 AM,170,254,239
Piedmont,Staunton City,51790,372,1685,2057,584,3395,3979,62268,425610,487878,09/01/2013 12:00:00 AM,167,253,237
Piedmont,Staunton City,51790,374,1764,2138,639,3627,4266,69119,461449,530568,08/01/2012 12:00:00 AM,185,262,248
Piedmont,Staunton City,51790,376,1727,2103,643,3537,4180,70172,448836,519008,06/01/2012 12:00:00 AM,187,260,247
Piedmont,Staunton City,51790,382,1713,2095,666,3519,4185,81347,474910,556257,07/01/2012 12:00:00 AM,213,277,266
Piedmont,Staunton City,51790,393,1706,2099,696,3481,4177,77188,442250,519438,05/01/2012 12:00:00 AM,196,259,247
Piedmont,Staunton City,51790,399,1681,2080,698,3453,4151,78684,430492,509176,03/01/2012 12:00:00 AM,197,256,245
Piedmont,Staunton City,51790,400,1708,2108,694,3504,4198,77164,443785,520949,04/01/2012 12:00:00 AM,193,260,247
Piedmont,Staunton City,51790,405,1633,2038,716,3321,4037,79459,410476,489935,01/01/2012 12:00:00 AM,196,251,240
Piedmont,Staunton City,51790,405,1659,2064,711,3404,4115,80197,425660,505857,02/01/2012 12:00:00 AM,198,257,245
Piedmont,Waynesboro City,51820,278,1240,1518,387,2490,2877,85013,527543,612556,02/01/2021 12:00:00 AM,306,425,404
Piedmont,Waynesboro City,51820,282,1075,1357,401,2208,2609,38896,251895,290791,11/01/2019 12:00:00 AM,138,234,214
Piedmont,Waynesboro City,51820,284,1080,1364,414,2251,2665,40322,257403,297725,09/01/2019 12:00:00 AM,142,238,218
Piedmont,Waynesboro City,51820,284,1228,1512,402,2406,2808,92627,553910,646537,04/01/2021 12:00:00 AM,326,451,428
Piedmont,Waynesboro City,51820,284,1250,1534,402,2473,2875,88396,524855,613251,03/01/2021 12:00:00 AM,311,420,400
Piedmont,Waynesboro City,51820,285,1075,1360,423,2166,2589,76268,374786,451054,03/01/2020 12:00:00 AM,268,349,332
Piedmont,Waynesboro City,51820,285,1101,1386,407,2284,2691,40437,260113,300550,10/01/2019 12:00:00 AM,142,236,217
Piedmont,Waynesboro City,51820,285,1102,1387,420,2321,2741,41830,259458,301288,08/01/2019 12:00:00 AM,147,235,217
Piedmont,Waynesboro City,51820,286,1076,1362,415,2189,2604,41536,253372,294908,12/01/2019 12:00:00 AM,145,235,217
Piedmont,Waynesboro City,51820,287,1097,1384,416,2335,2751,42049,262941,304990,07/01/2019 12:00:00 AM,147,240,220
Piedmont,Waynesboro City,51820,288,1080,1368,416,2196,2612,39707,249925,289632,01/01/2020 12:00:00 AM,138,231,212
Piedmont,Waynesboro City,51820,290,1059,1349,429,2148,2577,40909,245464,286373,02/01/2020 12:00:00 AM,141,232,212
Piedmont,Waynesboro City,51820,290,1225,1515,410,2428,2838,96633,565479,662112,05/01/2021 12:00:00 AM,333,462,437
Piedmont,Waynesboro City,51820,290,1237,1527,411,2439,2850,97254,567471,664725,06/01/2021 12:00:00 AM,335,459,435
Piedmont,Waynesboro City,51820,293,1228,1521,429,2446,2875,77883,425620,503503,05/01/2020 12:00:00 AM,266,347,331
Piedmont,Waynesboro City,51820,294,1186,1480,432,2389,2821,78789,422472,501261,04/01/2020 12:00:00 AM,268,356,339
Piedmont,Waynesboro City,51820,294,1217,1511,442,2426,2868,85415,450140,535555,12/01/2020 12:00:00 AM,291,370,354
Piedmont,Waynesboro City,51820,295,1237,1532,436,2445,2881,78702,426368,505070,06/01/2020 12:00:00 AM,267,345,330
Piedmont,Waynesboro City,51820,296,1260,1556,439,2471,2910,80375,432641,513016,07/01/2020 12:00:00 AM,272,343,330
Piedmont,Waynesboro City,51820,298,1094,1392,423,2313,2736,40023,263079,303102,05/01/2019 12:00:00 AM,134,240,218
Piedmont,Waynesboro City,51820,300,1082,1382,417,2252,2669,40551,255663,296214,02/01/2019 12:00:00 AM,135,236,214
Piedmont,Waynesboro City,51820,300,1243,1543,439,2486,2925,85042,454244,539286,10/01/2020 12:00:00 AM,283,365,350
Piedmont,Waynesboro City,51820,300,1265,1565,445,2482,2927,81406,430534,511940,08/01/2020 12:00:00 AM,271,340,327
Piedmont,Waynesboro City,51820,301,1199,1500,455,2390,2845,98412,496204,594616,01/01/2021 12:00:00 AM,327,414,396
Piedmont,Waynesboro City,51820,302,1112,1414,428,2375,2803,41874,271421,313295,04/01/2019 12:00:00 AM,139,244,222
Piedmont,Waynesboro City,51820,302,1218,1520,450,2428,2878,85864,454873,540737,11/01/2020 12:00:00 AM,284,373,356
Piedmont,Waynesboro City,51820,303,1116,1419,443,2382,2825,41908,272650,314558,06/01/2019 12:00:00 AM,138,244,222
Piedmont,Waynesboro City,51820,304,1099,1403,427,2347,2774,40820,264679,305499,03/01/2019 12:00:00 AM,134,241,218
Piedmont,Waynesboro City,51820,306,1112,1418,424,2336,2760,50909,312773.85,363682.85,11/01/2018 12:00:00 AM,166,281,256
Piedmont,Waynesboro City,51820,306,1261,1567,454,2493,2947,80911,440077,520988,09/01/2020 12:00:00 AM,264,349,332
Piedmont,Waynesboro City,51820,308,1105,1413,433,2324,2757,41623,271972,313595,01/01/2019 12:00:00 AM,135,246,222
Piedmont,Waynesboro City,51820,308,1112,1420,430,2359,2789,43193,268015,311208,12/01/2018 12:00:00 AM,140,241,219
Piedmont,Waynesboro City,51820,312,1124,1436,429,2382,2811,42783,275576,318359,09/01/2018 12:00:00 AM,137,245,222
Piedmont,Waynesboro City,51820,314,1115,1429,437,2323,2760,43132,269534,312666,10/01/2018 12:00:00 AM,137,242,219
Piedmont,Waynesboro City,51820,314,1141,1455,426,2409,2835,41028,277453,318481,08/01/2018 12:00:00 AM,131,243,219
Piedmont,Waynesboro City,51820,315,1170,1485,427,2510,2937,42012,284487,326499,06/01/2018 12:00:00 AM,133,243,220
Piedmont,Waynesboro City,51820,319,1216,1535,427,2626,3053,40072,300815,340887,01/01/2018 12:00:00 AM,126,247,222
Piedmont,Waynesboro City,51820,320,1146,1466,430,2463,2893,41237,280650,321887,07/01/2018 12:00:00 AM,129,245,220
Piedmont,Waynesboro City,51820,320,1200,1520,435,2586,3021,43874,293025,336899,05/01/2018 12:00:00 AM,137,244,222
Piedmont,Waynesboro City,51820,323,1187,1510,434,2572,3006,41598,288589,330187,02/01/2018 12:00:00 AM,129,243,219
Piedmont,Waynesboro City,51820,323,1216,1539,444,2615,3059,42345,294328,336673,03/01/2018 12:00:00 AM,131,242,219
Piedmont,Waynesboro City,51820,324,1309,1633,452,2854,3306,42608,321974,364582,12/01/2016 12:00:00 AM,132,246,223
Piedmont,Waynesboro City,51820,325,1199,1524,445,2554,2999,43040,291635,334675,04/01/2018 12:00:00 AM,132,243,220
Piedmont,Waynesboro City,51820,326,1771,2097,505,3701,4206,48438,418634,467072,12/01/2013 12:00:00 AM,149,236,223
Piedmont,Waynesboro City,51820,327,1198,1525,443,2574,3017,44560,292085,336645,12/01/2017 12:00:00 AM,136,244,221
Piedmont,Waynesboro City,51820,327,1233,1560,451,2665,3116,44206,314200,358406,06/01/2017 12:00:00 AM,135,255,230
Piedmont,Waynesboro City,51820,327,1658,1985,480,3587,4067,44978,403318,448296,05/01/2014 12:00:00 AM,138,243,226
Piedmont,Waynesboro City,51820,328,1212,1540,444,2634,3078,43967,305353,349320,10/01/2017 12:00:00 AM,134,252,227
Piedmont,Waynesboro City,51820,328,1656,1984,481,3595,4076,45218,402424,447642,06/01/2014 12:00:00 AM,138,243,226
Piedmont,Waynesboro City,51820,329,1302,1631,442,2882,3324,43308,330590,373898,03/01/2017 12:00:00 AM,132,254,229
Piedmont,Waynesboro City,51820,330,1242,1572,455,2730,3185,43411,317054,360465,05/01/2017 12:00:00 AM,132,255,229
Piedmont,Waynesboro City,51820,330,1276,1606,447,2811,3258,43840,326393,370233,04/01/2017 12:00:00 AM,133,256,231
Piedmont,Waynesboro City,51820,330,1832,2162,537,3825,4362,58639,464061,522700,10/01/2013 12:00:00 AM,178,253,242
Piedmont,Waynesboro City,51820,331,1209,1540,446,2591,3037,43374,299230,342604,11/01/2017 12:00:00 AM,131,248,222
Piedmont,Waynesboro City,51820,331,1309,1640,462,2939,3401,42605,325609,368214,09/01/2016 12:00:00 AM,129,249,225
Piedmont,Waynesboro City,51820,331,1312,1643,462,2868,3330,41609,323969,365578,01/01/2017 12:00:00 AM,126,247,223
Piedmont,Waynesboro City,51820,331,1330,1661,459,2970,3429,42743,332018,374761,08/01/2016 12:00:00 AM,129,250,226
Piedmont,Waynesboro City,51820,331,1409,1740,457,3155,3612,42201,350755,392956,09/01/2015 12:00:00 AM,127,249,226
Piedmont,Waynesboro City,51820,331,1605,1936,478,3520,3998,43561,391903,435464,08/01/2014 12:00:00 AM,132,244,225
Piedmont,Waynesboro City,51820,331,1630,1961,480,3588,4068,45601,400145,445746,07/01/2014 12:00:00 AM,138,245,227
Piedmont,Waynesboro City,51820,331,1693,2024,495,3613,4108,47381,405778,453159,04/01/2014 12:00:00 AM,143,240,224
Piedmont,Waynesboro City,51820,331,1704,2035,520,3616,4136,48847,410039,458886,02/01/2014 12:00:00 AM,148,241,225
Piedmont,Waynesboro City,51820,331,1728,2059,524,3638,4162,48836,408273,457109,01/01/2014 12:00:00 AM,148,236,222
Piedmont,Waynesboro City,51820,331,1781,2112,556,3810,4366,61093,476416,537509,05/01/2012 12:00:00 AM,185,267,255
Piedmont,Waynesboro City,51820,332,1191,1523,448,2597,3045,42798,307970,350768,09/01/2017 12:00:00 AM,129,259,230
Piedmont,Waynesboro City,51820,332,1229,1561,463,2657,3120,45904,317181,363085,08/01/2017 12:00:00 AM,138,258,233
Piedmont,Waynesboro City,51820,332,1815,2147,542,3792,4334,57770,463396,521166,09/01/2013 12:00:00 AM,174,255,243
Piedmont,Waynesboro City,51820,333,1806,2139,572,3817,4389,61024,465156,526180,01/01/2013 12:00:00 AM,183,258,246
Piedmont,Waynesboro City,51820,334,1421,1755,456,3239,3695,43835,364897,408732,07/01/2015 12:00:00 AM,131,257,233
Piedmont,Waynesboro City,51820,334,1777,2111,575,3750,4325,61322,467587,528909,04/01/2013 12:00:00 AM,184,263,251
Piedmont,Waynesboro City,51820,334,1792,2126,546,3725,4271,53962,419068,473030,11/01/2013 12:00:00 AM,162,234,222
Piedmont,Waynesboro City,51820,334,1796,2130,565,3822,4387,61859,478448,540307,06/01/2012 12:00:00 AM,185,266,254
Piedmont,Waynesboro City,51820,335,1205,1540,467,2637,3104,45287,305289,350576,07/01/2017 12:00:00 AM,135,253,228
Piedmont,Waynesboro City,51820,335,1401,1736,461,3161,3622,44814,341380,386194,10/01/2015 12:00:00 AM,134,244,222
Piedmont,Waynesboro City,51820,335,1413,1748,468,3180,3648,44635,354479,399114,08/01/2015 12:00:00 AM,133,251,228
Piedmont,Waynesboro City,51820,335,1699,2034,524,3594,4118,50317,407806,458123,03/01/2014 12:00:00 AM,150,240,225
Piedmont,Waynesboro City,51820,336,1293,1629,488,2819,3307,47532,315950,363482,11/01/2016 12:00:00 AM,141,244,223
Piedmont,Waynesboro City,51820,336,1300,1636,475,2861,3336,44259,321234,365493,10/01/2016 12:00:00 AM,132,247,223
Piedmont,Waynesboro City,51820,336,1782,2118,574,3767,4341,61907,472788,534695,03/01/2013 12:00:00 AM,184,265,252
Piedmont,Waynesboro City,51820,336,1791,2127,567,3813,4380,67622,505813,573435,07/01/2012 12:00:00 AM,201,282,270
Piedmont,Waynesboro City,51820,337,1807,2144,580,3837,4417,64826,481644,546470,08/01/2012 12:00:00 AM,192,267,255
Piedmont,Waynesboro City,51820,338,1745,2083,574,3742,4316,61971,471003,532974,02/01/2012 12:00:00 AM,183,270,256
Piedmont,Waynesboro City,51820,338,1790,2128,580,3785,4365,64930,474496,539426,09/01/2012 12:00:00 AM,192,265,253
Piedmont,Waynesboro City,51820,339,1328,1667,473,2929,3402,44204,332319,376523,02/01/2017 12:00:00 AM,130,250,226
Piedmont,Waynesboro City,51820,339,1338,1677,469,3005,3474,44225,338949,383174,07/01/2016 12:00:00 AM,130,253,228
Piedmont,Waynesboro City,51820,339,1403,1742,468,3230,3698,43606,354936,398542,04/01/2015 12:00:00 AM,129,253,229
Piedmont,Waynesboro City,51820,339,1405,1744,465,3242,3707,42989,353621,396610,05/01/2015 12:00:00 AM,127,252,227
Piedmont,Waynesboro City,51820,339,1469,1808,477,3338,3815,46129,370534,416663,01/01/2015 12:00:00 AM,136,252,230
Piedmont,Waynesboro City,51820,340,1485,1825,480,3342,3822,47490,373493,420983,12/01/2014 12:00:00 AM,140,252,231
Piedmont,Waynesboro City,51820,341,1788,2129,583,3777,4360,64499,467228,531727,10/01/2012 12:00:00 AM,189,261,250
Piedmont,Waynesboro City,51820,341,1789,2130,593,3772,4365,63297,469440,532737,02/01/2013 12:00:00 AM,186,262,250
Piedmont,Waynesboro City,51820,341,1799,2140,596,3808,4404,68044,475099,543143,11/01/2012 12:00:00 AM,200,264,254
Piedmont,Waynesboro City,51820,341,1805,2146,589,3811,4400,60641,466324,526965,05/01/2013 12:00:00 AM,178,258,246
Piedmont,Waynesboro City,51820,342,1388,1730,480,3119,3599,46415,347176,393591,11/01/2015 12:00:00 AM,136,250,228
Piedmont,Waynesboro City,51820,342,1419,1761,470,3238,3708,44012,358585,402597,06/01/2015 12:00:00 AM,129,253,229
Piedmont,Waynesboro City,51820,342,1759,2101,585,3758,4343,64461,473109,537570,04/01/2012 12:00:00 AM,188,269,256
Piedmont,Waynesboro City,51820,342,1778,2120,593,3754,4347,65925,468218,534143,12/01/2012 12:00:00 AM,193,263,252
Piedmont,Waynesboro City,51820,342,1813,2155,584,3811,4395,61428,462038,523466,07/01/2013 12:00:00 AM,180,255,243
Piedmont,Waynesboro City,51820,343,1499,1842,487,3343,3830,49293,376314,425607,11/01/2014 12:00:00 AM,144,251,231
Piedmont,Waynesboro City,51820,343,1749,2092,582,3763,4345,63796,470153,533949,03/01/2012 12:00:00 AM,186,269,255
Piedmont,Waynesboro City,51820,343,1754,2097,577,3781,4358,62014,476599,538613,01/01/2012 12:00:00 AM,181,272,257
Piedmont,Waynesboro City,51820,343,1807,2150,594,3794,4388,62776,460727,523503,06/01/2013 12:00:00 AM,183,255,243
Piedmont,Waynesboro City,51820,345,1403,1748,481,3233,3714,45646,356864,402510,03/01/2015 12:00:00 AM,132,254,230
Piedmont,Waynesboro City,51820,345,1407,1752,468,3165,3633,45220,348812,394032,12/01/2015 12:00:00 AM,131,248,225
Piedmont,Waynesboro City,51820,345,1416,1761,481,3247,3728,45890,361309,407199,02/01/2015 12:00:00 AM,133,255,231
Piedmont,Waynesboro City,51820,345,1584,1929,508,3488,3996,47837,384216,432053,09/01/2014 12:00:00 AM,139,243,224
Piedmont,Waynesboro City,51820,345,1810,2155,584,3774,4358,62163,459179,521342,08/01/2013 12:00:00 AM,180,254,242
Piedmont,Waynesboro City,51820,349,1372,1721,495,3107,3602,49183,345615,394798,02/01/2016 12:00:00 AM,141,252,229
Piedmont,Waynesboro City,51820,350,1381,1731,489,3087,3576,47915,345914,393829,03/01/2016 12:00:00 AM,137,250,228
Piedmont,Waynesboro City,51820,350,1519,1869,506,3389,3895,51362,384045,435407,10/01/2014 12:00:00 AM,147,253,233
Piedmont,Waynesboro City,51820,352,1354,1706,496,3050,3546,47658,342001,389659,06/01/2016 12:00:00 AM,135,253,228
Piedmont,Waynesboro City,51820,352,1359,1711,493,3050,3543,48494,345144,393638,04/01/2016 12:00:00 AM,138,254,230
Piedmont,Waynesboro City,51820,354,1380,1734,492,3122,3614,47351,343613,390964,01/01/2016 12:00:00 AM,134,249,225
Piedmont,Waynesboro City,51820,363,1346,1709,520,3028,3548,51185,344524,395709,05/01/2016 12:00:00 AM,141,256,232
Western,Bland County,51021,32,198,230,47,393,440,3885,39172,43057,09/01/2019 12:00:00 AM,121,198,187
Western,Bland County,51021,32,202,234,47,403,450,3345,39640,42985,10/01/2019 12:00:00 AM,105,196,184
Western,Bland County,51021,32,210,242,47,408,455,3159,38402,41561,01/01/2020 12:00:00 AM,99,183,172
Western,Bland County,51021,33,204,237,55,386,441,3671,39275,42946,02/01/2020 12:00:00 AM,111,193,181
Western,Bland County,51021,33,208,241,49,401,450,3495,36833,40328,11/01/2019 12:00:00 AM,106,177,167
Western,Bland County,51021,33,213,246,49,415,464,3394,37698,41092,12/01/2019 12:00:00 AM,103,177,167
Western,Bland County,51021,34,198,232,51,393,444,3877,40516,44393,05/01/2019 12:00:00 AM,114,205,191
Western,Bland County,51021,35,187,222,57,370,427,4868,36089,40957,02/01/2019 12:00:00 AM,139,193,184
Western,Bland County,51021,35,192,227,52,380,432,4165,37987,42152,07/01/2019 12:00:00 AM,119,198,186
Western,Bland County,51021,35,194,229,48,383,431,3893,36981,40874,08/01/2019 12:00:00 AM,111,191,178
Western,Bland County,51021,35,202,237,58,379,437,10114,65715,75829,03/01/2020 12:00:00 AM,289,325,320
Western,Bland County,51021,35,235,270,53,455,508,9006,78455,87461,09/01/2020 12:00:00 AM,257,334,324
Western,Bland County,51021,35,236,271,54,449,503,10095,81985,92080,11/01/2020 12:00:00 AM,288,347,340
Western,Bland County,51021,35,243,278,48,472,520,10763,100806,111569,02/01/2021 12:00:00 AM,308,415,401
Western,Bland County,51021,36,190,226,61,389,450,5565,40608,46173,01/01/2019 12:00:00 AM,155,214,204
Western,Bland County,51021,36,195,231,55,390,445,4102,39620,43722,06/01/2019 12:00:00 AM,114,203,189
Western,Bland County,51021,36,229,265,57,451,508,10015,79062,89077,08/01/2020 12:00:00 AM,278,345,336
Western,Bland County,51021,36,237,273,56,463,519,10779,84728,95507,10/01/2020 12:00:00 AM,299,358,350
Western,Bland County,51021,36,245,281,50,481,531,11228,107086,118314,04/01/2021 12:00:00 AM,312,437,421
Western,Bland County,51021,37,196,233,62,377,439,4730,39008,43738,04/01/2019 12:00:00 AM,128,199,188
Western,Bland County,51021,37,227,264,58,445,503,10355,77563,87918,05/01/2020 12:00:00 AM,280,342,333
Western,Bland County,51021,37,230,267,57,457,514,10194,78680,88874,07/01/2020 12:00:00 AM,276,342,333
Western,Bland County,51021,37,231,268,57,455,512,10194,79433,89627,06/01/2020 12:00:00 AM,276,344,334
Western,Bland County,51021,37,235,272,56,455,511,12075,94689,106764,01/01/2021 12:00:00 AM,326,403,393
Western,Bland County,51021,37,239,276,51,465,516,11951,105839,117790,05/01/2021 12:00:00 AM,323,443,427
Western,Bland County,51021,37,239,276,56,454,510,10704,85009,95713,12/01/2020 12:00:00 AM,289,356,347
Western,Bland County,51021,37,240,277,50,468,518,11415,104403,115818,06/01/2021 12:00:00 AM,309,435,418
Western,Bland County,51021,38,219,257,61,423,484,10644,74228,84872,04/01/2020 12:00:00 AM,280,339,330
Western,Bland County,51021,38,242,280,56,470,526,12019,98520,110539,03/01/2021 12:00:00 AM,316,407,395
Western,Bland County,51021,39,189,228,67,393,460,5769,40196,45965,12/01/2018 12:00:00 AM,148,213,202
Western,Bland County,51021,39,199,238,67,409,476,5700,41820,47520,10/01/2018 12:00:00 AM,146,210,200
Western,Bland County,51021,39,199,238,67,410,477,5677,41925,47602,11/01/2018 12:00:00 AM,146,211,200
Western,Bland County,51021,39,201,240,64,398,462,5021,39447,44468,03/01/2019 12:00:00 AM,129,196,185
Western,Bland County,51021,43,199,242,77,414,491,6811,42227,49038,09/01/2018 12:00:00 AM,158,212,203
Western,Bland County,51021,45,192,237,77,406,483,5213,39963,45176,08/01/2018 12:00:00 AM,116,208,191
Western,Bland County,51021,45,196,241,64,420,484,4891,40500,45391,03/01/2018 12:00:00 AM,109,207,188
Western,Bland County,51021,45,198,243,69,427,496,4782,40926,45708,04/01/2018 12:00:00 AM,106,207,188
Western,Bland County,51021,46,192,238,71,414,485,5810,40623,46433,02/01/2018 12:00:00 AM,126,212,195
Western,Bland County,51021,46,204,250,61,450,511,5375,42797,48172,04/01/2017 12:00:00 AM,117,210,193
Western,Bland County,51021,47,195,242,77,414,491,6164,39542,45706,06/01/2018 12:00:00 AM,131,203,189
Western,Bland County,51021,47,196,243,60,454,514,5587,44680,50267,06/01/2016 12:00:00 AM,119,228,207
Western,Bland County,51021,47,196,243,76,408,484,5412,39826,45238,07/01/2018 12:00:00 AM,115,203,186
Western,Bland County,51021,47,198,245,61,453,514,5370,45521,50891,08/01/2016 12:00:00 AM,114,230,208
Western,Bland County,51021,47,198,245,75,424,499,5812,40880,46692,05/01/2018 12:00:00 AM,124,206,191
Western,Bland County,51021,47,248,295,59,557,616,5562,60972,66534,05/01/2012 12:00:00 AM,118,246,226
Western,Bland County,51021,47,253,300,58,569,627,5533,67865,73398,09/01/2012 12:00:00 AM,118,268,245
Western,Bland County,51021,48,199,247,68,426,494,6135,38813,44948,06/01/2017 12:00:00 AM,128,195,182
Western,Bland County,51021,48,201,249,66,446,512,5656,42230,47886,05/01/2017 12:00:00 AM,118,210,192
Western,Bland County,51021,48,245,293,64,543,607,6672,61815,68487,07/01/2012 12:00:00 AM,139,252,234
Western,Bland County,51021,49,193,242,67,433,500,6701,42793,49494,07/01/2016 12:00:00 AM,137,222,205
Western,Bland County,51021,49,211,260,70,463,533,6452,45170,51622,03/01/2017 12:00:00 AM,132,214,199
Western,Bland County,51021,49,212,261,75,467,542,6481,45127,51608,02/01/2017 12:00:00 AM,132,213,198
Western,Bland County,51021,49,226,275,63,489,552,5183,52184,57367,05/01/2015 12:00:00 AM,106,231,209
Western,Bland County,51021,49,240,289,62,535,597,6037,60349,66386,04/01/2012 12:00:00 AM,123,251,230
Western,Bland County,51021,49,241,290,66,536,602,6728,60499,67227,06/01/2012 12:00:00 AM,137,251,232
Western,Bland County,51021,49,251,300,62,544,606,5965,63116,69081,08/01/2012 12:00:00 AM,122,251,230
Western,Bland County,51021,49,251,300,64,563,627,5894,67266,73160,10/01/2012 12:00:00 AM,120,268,244
Western,Bland County,51021,49,258,307,68,547,615,7483,61386,68869,09/01/2013 12:00:00 AM,153,238,224
Western,Bland County,51021,50,193,243,73,418,491,6360,39903,46263,07/01/2017 12:00:00 AM,127,207,190
Western,Bland County,51021,50,194,244,80,411,491,7364,40885,48249,01/01/2018 12:00:00 AM,147,211,198
Western,Bland County,51021,50,202,252,72,453,525,6764,43252,50016,09/01/2016 12:00:00 AM,135,214,198
Western,Bland County,51021,50,222,272,65,467,532,5197,49825,55022,04/01/2015 12:00:00 AM,104,224,202
Western,Bland County,51021,50,230,280,66,492,558,5819,49194,55013,07/01/2015 12:00:00 AM,116,214,196
Western,Bland County,51021,50,236,286,65,536,601,6056,59752,65808,03/01/2012 12:00:00 AM,121,253,230
Western,Bland County,51021,50,242,292,61,517,578,4606,50858,55464,09/01/2014 12:00:00 AM,92,210,190
Western,Bland County,51021,50,246,296,65,545,610,6328,59997,66325,05/01/2013 12:00:00 AM,127,244,224
Western,Bland County,51021,50,247,297,60,524,584,5294,53334,58628,04/01/2014 12:00:00 AM,106,216,197
Western,Bland County,51021,50,254,304,66,577,643,6534,65105,71639,12/01/2012 12:00:00 AM,131,256,236
Western,Bland County,51021,50,255,305,64,572,636,6114,64547,70661,11/01/2012 12:00:00 AM,122,253,232
Western,Bland County,51021,50,259,309,68,565,633,6994,61996,68990,08/01/2013 12:00:00 AM,140,239,223
Western,Bland County,51021,51,195,246,76,411,487,7046,40663,47709,08/01/2017 12:00:00 AM,138,209,194
Western,Bland County,51021,51,233,284,70,523,593,6823,58649,65472,02/01/2012 12:00:00 AM,134,252,231
Western,Bland County,51021,51,236,287,71,539,610,6783,59265,66048,04/01/2013 12:00:00 AM,133,251,230
Western,Bland County,51021,51,242,293,62,518,580,4651,50589,55240,08/01/2014 12:00:00 AM,91,209,189
Western,Bland County,51021,51,247,298,68,556,624,6574,60167,66741,02/01/2013 12:00:00 AM,129,244,224
Western,Bland County,51021,51,250,301,72,554,626,7455,60089,67544,06/01/2013 12:00:00 AM,146,240,224
Western,Bland County,51021,51,256,307,58,562,620,4920,59295,64215,03/01/2014 12:00:00 AM,96,232,209
Western,Bland County,51021,51,263,314,64,562,626,5753,56027,61780,11/01/2013 12:00:00 AM,113,213,197
Western,Bland County,51021,51,265,316,68,571,639,7336,63152,70488,10/01/2013 12:00:00 AM,144,238,223
Western,Bland County,51021,52,187,239,82,393,475,7654,38852,46506,12/01/2017 12:00:00 AM,147,208,195
Western,Bland County,51021,52,188,240,79,382,461,7702,36398,44100,10/01/2017 12:00:00 AM,148,194,184
Western,Bland County,51021,52,206,258,79,457,536,7693,44749,52442,11/01/2016 12:00:00 AM,148,217,203
Western,Bland County,51021,52,229,281,65,513,578,5640,51447,57087,11/01/2015 12:00:00 AM,108,225,203
Western,Bland County,51021,52,229,281,70,492,562,5901,50549,56450,08/01/2015 12:00:00 AM,113,221,201
Western,Bland County,51021,52,234,286,70,496,566,5525,52950,58475,03/01/2015 12:00:00 AM,106,226,204
Western,Bland County,51021,52,256,308,65,556,621,6017,56847,62864,02/01/2014 12:00:00 AM,116,222,204
Western,Bland County,51021,53,188,241,79,390,469,7655,37828,45483,09/01/2017 12:00:00 AM,144,201,189
Western,Bland County,51021,53,197,250,66,445,511,5819,44500,50319,05/01/2016 12:00:00 AM,110,226,201
Western,Bland County,51021,53,210,263,80,465,545,7899,44417,52316,01/01/2017 12:00:00 AM,149,212,199
Western,Bland County,51021,53,210,263,80,470,550,7843,45189,53032,12/01/2016 12:00:00 AM,148,215,202
Western,Bland County,51021,53,216,269,66,495,561,5778,49197,54975,01/01/2016 12:00:00 AM,109,228,204
Western,Bland County,51021,53,221,274,73,470,543,6540,48103,54643,06/01/2015 12:00:00 AM,123,218,199
Western,Bland County,51021,53,230,283,70,503,573,6168,51243,57411,09/01/2015 12:00:00 AM,116,223,203
Western,Bland County,51021,53,233,286,70,488,558,5799,50785,56584,12/01/2014 12:00:00 AM,109,218,198
Western,Bland County,51021,53,235,288,75,496,571,6421,51261,57682,01/01/2015 12:00:00 AM,121,218,200
Western,Bland County,51021,53,236,289,73,530,603,7316,58722,66038,03/01/2013 12:00:00 AM,138,249,229
Western,Bland County,51021,53,238,291,67,507,574,5154,50713,55867,07/01/2014 12:00:00 AM,97,213,192
Western,Bland County,51021,53,242,295,66,510,576,5414,52744,58158,10/01/2014 12:00:00 AM,102,218,197
Western,Bland County,51021,53,248,301,73,558,631,6527,62425,68952,01/01/2013 12:00:00 AM,123,252,229
Western,Bland County,51021,53,251,304,76,554,630,8111,59686,67797,07/01/2013 12:00:00 AM,153,238,223
Western,Bland County,51021,53,262,315,67,580,647,6156,58572,64728,01/01/2014 12:00:00 AM,116,224,205
Western,Bland County,51021,54,218,272,68,503,571,6027,48599,54626,02/01/2016 12:00:00 AM,112,223,201
Western,Bland County,51021,54,223,277,66,504,570,5835,49926,55761,12/01/2015 12:00:00 AM,108,224,201
Western,Bland County,51021,54,229,283,77,484,561,6953,51232,58185,02/01/2015 12:00:00 AM,129,224,206
Western,Bland County,51021,54,231,285,69,508,577,5670,49839,55509,06/01/2014 12:00:00 AM,105,216,195
Western,Bland County,51021,54,244,298,69,527,596,5822,52357,58179,05/01/2014 12:00:00 AM,108,215,195
Western,Bland County,51021,55,190,245,87,395,482,8310,38464,46774,11/01/2017 12:00:00 AM,151,202,191
Western,Bland County,51021,55,201,256,86,446,532,8487,43420,51907,10/01/2016 12:00:00 AM,154,216,203
Western,Bland County,51021,55,208,263,72,479,551,6531,47556,54087,03/01/2016 12:00:00 AM,119,229,206
Western,Bland County,51021,55,210,265,71,478,549,6343,46920,53263,04/01/2016 12:00:00 AM,115,223,201
Western,Bland County,51021,55,233,288,78,505,583,7645,49146,56791,10/01/2015 12:00:00 AM,139,211,197
Western,Bland County,51021,55,233,288,81,518,599,8577,57223,65800,01/01/2012 12:00:00 AM,156,246,228
Western,Bland County,51021,55,240,295,75,507,582,6984,53524,60508,11/01/2014 12:00:00 AM,127,223,205
Western,Bland County,51021,55,263,318,69,571,640,6577,58540,65117,12/01/2013 12:00:00 AM,120,223,205
Western,Bristol City,51520,380,1607,1987,553,3331,3884,53617,410479,464096,07/01/2017 12:00:00 AM,141,255,234
Western,Bristol City,51520,383,1639,2022,568,3367,3935,54159,415230,469389,05/01/2017 12:00:00 AM,141,253,232
Western,Bristol City,51520,384,1632,2016,566,3360,3926,55882,420837,476719,06/01/2017 12:00:00 AM,146,258,236
Western,Bristol City,51520,385,1639,2024,550,3387,3937,53368,416922,470290,08/01/2017 12:00:00 AM,139,254,232
Western,Bristol City,51520,390,1654,2044,569,3409,3978,55412,425240,480652,03/01/2017 12:00:00 AM,142,257,235
Western,Bristol City,51520,393,1644,2037,579,3396,3975,56531,426675,483206,04/01/2017 12:00:00 AM,144,260,237
Western,Bristol City,51520,399,1589,1988,572,3293,3865,55584,412217,467801,09/01/2017 12:00:00 AM,139,259,235
Western,Bristol City,51520,399,1678,2077,576,3536,4112,53381,434445,487826,02/01/2017 12:00:00 AM,134,259,235
Western,Bristol City,51520,407,1615,2022,585,3320,3905,58240,411264,469504,10/01/2017 12:00:00 AM,143,255,232
Western,Bristol City,51520,408,1677,2085,601,3539,4140,55797,433137,488934,01/01/2017 12:00:00 AM,137,258,235
Western,Bristol City,51520,411,1671,2082,610,3524,4134,56746,433012,489758,12/01/2016 12:00:00 AM,138,259,235
Western,Bristol City,51520,415,1591,2006,594,3329,3923,58695,406886,465581,11/01/2017 12:00:00 AM,141,256,232
Western,Bristol City,51520,418,1587,2005,597,3310,3907,57599,405597,463196,12/01/2017 12:00:00 AM,138,256,231
Western,Bristol City,51520,419,1662,2081,638,3528,4166,61711,430739,492450,11/01/2016 12:00:00 AM,147,259,237
Western,Bristol City,51520,420,1583,2003,640,3272,3912,59212,392119,451331,01/01/2020 12:00:00 AM,141,248,225
Western,Bristol City,51520,420,1594,2014,630,3317,3947,61130,398354,459484,02/01/2020 12:00:00 AM,146,250,228
Western,Bristol City,51520,420,1608,2028,621,3373,3994,58599,409117,467716,11/01/2019 12:00:00 AM,140,254,231
Western,Bristol City,51520,421,1597,2018,606,3337,3943,56827,406423,463250,01/01/2018 12:00:00 AM,135,254,230
Western,Bristol City,51520,421,1617,2038,619,3375,3994,110424,582112,692536,03/01/2020 12:00:00 AM,262,360,340
Western,Bristol City,51520,423,1582,2005,605,3315,3920,58840,406563,465403,02/01/2018 12:00:00 AM,139,257,232
Western,Bristol City,51520,424,1665,2089,646,3532,4178,64634,428725,493359,09/01/2016 12:00:00 AM,152,257,236
Western,Bristol City,51520,424,1893,2317,542,3836,4378,125173,821699,946872,02/01/2021 12:00:00 AM,295,434,409
Western,Bristol City,51520,425,1685,2110,656,3535,4191,64977,435585,500562,10/01/2016 12:00:00 AM,153,259,237
Western,Bristol City,51520,427,1605,2032,617,3344,3961,57935,398373,456308,04/01/2019 12:00:00 AM,136,248,225
Western,Bristol City,51520,428,1582,2010,618,3279,3897,60694,397159,457853,03/01/2018 12:00:00 AM,142,251,228
Western,Bristol City,51520,428,1626,2054,645,3402,4047,61492,419638,481130,12/01/2019 12:00:00 AM,144,258,234
Western,Bristol City,51520,430,1520,1950,626,3148,3774,62651,377743,440394,02/01/2019 12:00:00 AM,146,249,226
Western,Bristol City,51520,430,1591,2021,627,3363,3990,59453,398562,458015,06/01/2019 12:00:00 AM,138,251,227
Western,Bristol City,51520,431,1643,2074,666,3492,4158,63716,422547,486263,07/01/2016 12:00:00 AM,148,257,234
Western,Bristol City,51520,431,1672,2103,660,3567,4227,64266,432598,496864,08/01/2016 12:00:00 AM,149,259,236
Western,Bristol City,51520,433,1587,2020,614,3335,3949,57945,396449,454394,05/01/2018 12:00:00 AM,134,250,225
Western,Bristol City,51520,433,1646,2079,633,3453,4086,60838,424618,485456,10/01/2019 12:00:00 AM,141,258,234
Western,Bristol City,51520,435,1576,2011,629,3296,3925,59648,397769,457417,04/01/2018 12:00:00 AM,137,252,227
Western,Bristol City,51520,435,1590,2025,641,3302,3943,61896,395838,457734,03/01/2019 12:00:00 AM,142,249,226
Western,Bristol City,51520,436,1580,2016,643,3306,3949,60272,391675,451947,05/01/2019 12:00:00 AM,138,248,224
Western,Bristol City,51520,437,1602,2039,624,3388,4012,60289,405532,465821,06/01/2018 12:00:00 AM,138,253,228
Western,Bristol City,51520,437,1860,2297,588,3737,4325,130750,780389,911139,03/01/2021 12:00:00 AM,299,420,397
Western,Bristol City,51520,438,1584,2022,651,3349,4000,61474,404493,465967,08/01/2019 12:00:00 AM,140,255,230
Western,Bristol City,51520,438,1616,2054,617,3404,4021,57772,412326,470098,10/01/2018 12:00:00 AM,132,255,229
Western,Bristol City,51520,439,1814,2253,612,3622,4234,143578,844791,988369,04/01/2021 12:00:00 AM,327,466,439
Western,Bristol City,51520,441,1591,2032,626,3346,3972,61121,405872,466993,07/01/2018 12:00:00 AM,139,255,230
Western,Bristol City,51520,441,1626,2067,640,3390,4030,64185,418733,482918,12/01/2018 12:00:00 AM,146,258,234
Western,Bristol City,51520,441,1647,2088,653,3483,4136,62778,420897,483675,09/01/2019 12:00:00 AM,142,256,232
Western,Bristol City,51520,442,1611,2053,687,3440,4127,66637,417867,484504,05/01/2016 12:00:00 AM,151,259,236
Western,Bristol City,51520,442,1753,2195,651,3636,4287,117834,634837,752671,04/01/2020 12:00:00 AM,267,362,343
Western,Bristol City,51520,443,1590,2033,637,3360,3997,62721,408002,470723,08/01/2018 12:00:00 AM,142,257,232
Western,Bristol City,51520,443,1622,2065,663,3397,4060,64702,410154,474856,07/01/2019 12:00:00 AM,146,253,230
Western,Bristol City,51520,444,1599,2043,636,3373,4009,61820,411722,473542,11/01/2018 12:00:00 AM,139,257,232
Western,Bristol City,51520,445,1601,2046,642,3378,4020,63522,407752,471274,09/01/2018 12:00:00 AM,143,255,230
Western,Bristol City,51520,446,1640,2086,693,3495,4188,68772,427382,496154,06/01/2016 12:00:00 AM,154,261,238
Western,Bristol City,51520,448,1775,2223,644,3542,4186,149195,826943,976138,05/01/2021 12:00:00 AM,333,466,439
Western,Bristol City,51520,449,1598,2047,663,3309,3972,64233,420915,485148,01/01/2019 12:00:00 AM,143,263,237
Western,Bristol City,51520,452,1800,2252,673,3737,4410,122710,651465,774175,05/01/2020 12:00:00 AM,271,362,344
Western,Bristol City,51520,453,1638,2091,684,3483,4167,67619,426471,494090,04/01/2016 12:00:00 AM,149,260,236
Western,Bristol City,51520,454,1828,2282,675,3749,4424,121858,654075,775933,06/01/2020 12:00:00 AM,268,358,340
Western,Bristol City,51520,455,1776,2231,659,3532,4191,150800,823560,974360,06/01/2021 12:00:00 AM,331,464,437
Western,Bristol City,51520,462,1903,2365,700,3877,4577,126281,671754,798035,08/01/2020 12:00:00 AM,273,353,337
Western,Bristol City,51520,464,1637,2101,716,3482,4198,70405,423187,493592,03/01/2016 12:00:00 AM,152,259,235
Western,Bristol City,51520,464,1641,2105,714,3523,4237,70840,429653,500493,02/01/2016 12:00:00 AM,153,262,238
Western,Bristol City,51520,467,1672,2139,719,3546,4265,73828,440816,514644,11/01/2015 12:00:00 AM,158,264,241
Western,Bristol City,51520,469,1689,2158,720,3622,4342,73479,441633,515112,07/01/2015 12:00:00 AM,157,261,239
Western,Bristol City,51520,469,1693,2162,727,3584,4311,74911,444078,518989,09/01/2015 12:00:00 AM,160,262,240
Western,Bristol City,51520,471,1873,2344,720,3845,4565,130710,668462,799172,07/01/2020 12:00:00 AM,278,357,341
Western,Bristol City,51520,472,1644,2116,739,3479,4218,73384,426648,500032,01/01/2016 12:00:00 AM,155,260,236
Western,Bristol City,51520,473,1678,2151,730,3564,4294,74350,442977,517327,12/01/2015 12:00:00 AM,157,264,241
Western,Bristol City,51520,473,1690,2163,735,3597,4332,76027,442380,518407,08/01/2015 12:00:00 AM,161,262,240
Western,Bristol City,51520,475,1825,2300,715,3643,4358,154014,762646,916660,01/01/2021 12:00:00 AM,324,418,399
Western,Bristol City,51520,477,1682,2159,726,3614,4340,71727,442456,514183,06/01/2015 12:00:00 AM,150,263,238
Western,Bristol City,51520,477,1684,2161,743,3572,4315,76218,445690,521908,10/01/2015 12:00:00 AM,160,265,242
Western,Bristol City,51520,478,1853,2331,719,3694,4413,136465,682791,819256,12/01/2020 12:00:00 AM,285,368,351
Western,Bristol City,51520,479,1855,2334,727,3715,4442,137375,687924,825299,11/01/2020 12:00:00 AM,287,371,354
Western,Bristol City,51520,480,1845,2325,724,3741,4465,136795,685950,822745,10/01/2020 12:00:00 AM,285,372,354
Western,Bristol City,51520,481,1856,2337,735,3770,4505,131771,654573,786344,09/01/2020 12:00:00 AM,274,353,336
Western,Bristol City,51520,488,1666,2154,738,3619,4357,73916,438761,512677,05/01/2015 12:00:00 AM,151,263,238
Western,Bristol City,51520,492,1645,2137,760,3517,4277,77102,429500,506602,04/01/2015 12:00:00 AM,157,261,237
Western,Bristol City,51520,498,1644,2142,782,3532,4314,81559,431871,513430,03/01/2015 12:00:00 AM,164,263,240
Western,Bristol City,51520,508,1653,2161,816,3544,4360,87013,434954,521967,02/01/2015 12:00:00 AM,171,263,242
Western,Bristol City,51520,529,1674,2203,865,3553,4418,91293,429315,520608,01/01/2015 12:00:00 AM,173,256,236
Western,Bristol City,51520,538,1681,2219,872,3546,4418,91761,440415,532176,12/01/2014 12:00:00 AM,171,262,240
Western,Bristol City,51520,543,1808,2351,857,3765,4622,79448,461248,540696,07/01/2014 12:00:00 AM,146,255,230
Western,Bristol City,51520,548,1694,2242,885,3585,4470,95257,446049,541306,11/01/2014 12:00:00 AM,174,263,241
Western,Bristol City,51520,550,1755,2305,901,3654,4555,88023,444612,532635,08/01/2014 12:00:00 AM,160,253,231
Western,Bristol City,51520,552,1812,2364,890,3746,4636,85509,461450,546959,06/01/2014 12:00:00 AM,155,255,231
Western,Bristol City,51520,554,1762,2316,896,3656,4552,88762,443933,532695,09/01/2014 12:00:00 AM,160,252,230
Western,Bristol City,51520,558,1873,2431,900,3883,4783,84777,473446,558223,02/01/2014 12:00:00 AM,152,253,230
Western,Bristol City,51520,559,1705,2264,914,3584,4498,99310,451519,550829,10/01/2014 12:00:00 AM,178,265,243
Western,Bristol City,51520,561,1807,2368,927,3721,4648,91461,455314,546775,05/01/2014 12:00:00 AM,163,252,231
Western,Bristol City,51520,561,1853,2414,897,3830,4727,86831,470499,557330,04/01/2014 12:00:00 AM,155,254,231
Western,Bristol City,51520,562,1873,2435,903,3888,4791,85437,473238,558675,01/01/2014 12:00:00 AM,152,253,229
Western,Bristol City,51520,563,1876,2439,911,3898,4809,87091,475494,562585,03/01/2014 12:00:00 AM,155,253,231
Western,Bristol City,51520,586,1857,2443,968,3834,4802,94979,471305,566284,12/01/2013 12:00:00 AM,162,254,232
Western,Bristol City,51520,596,1866,2462,986,3823,4809,98843,468433,567276,11/01/2013 12:00:00 AM,166,251,230
Western,Bristol City,51520,599,1860,2459,1002,3817,4819,112124,505248,617372,10/01/2013 12:00:00 AM,187,272,251
Western,Bristol City,51520,612,1866,2478,1025,3788,4813,116247,503930,620177,09/01/2013 12:00:00 AM,190,270,250
Western,Bristol City,51520,621,1879,2500,1052,3803,4855,120996,504388,625384,08/01/2013 12:00:00 AM,195,268,250
Western,Bristol City,51520,625,1870,2495,1049,3822,4871,118968,516642,635610,07/01/2013 12:00:00 AM,190,276,255
Western,Bristol City,51520,631,1849,2480,1072,3759,4831,122925,497541,620466,05/01/2013 12:00:00 AM,195,269,250
Western,Bristol City,51520,639,1864,2503,1085,3802,4887,125358,509603,634961,06/01/2013 12:00:00 AM,196,273,254
Western,Bristol City,51520,645,1850,2495,1110,3751,4861,127294,498588,625882,04/01/2013 12:00:00 AM,197,270,251
Western,Bristol City,51520,647,1833,2480,1133,3720,4853,133092,490662,623754,03/01/2013 12:00:00 AM,206,268,252
Western,Bristol City,51520,653,1812,2465,1164,3637,4801,139010,481718,620728,02/01/2013 12:00:00 AM,213,266,252
Western,Bristol City,51520,654,1810,2464,1159,3658,4817,136434,479397,615831,01/01/2013 12:00:00 AM,209,265,250
Western,Bristol City,51520,659,1756,2415,1189,3549,4738,136065,463885,599950,06/01/2012 12:00:00 AM,206,264,248
Western,Bristol City,51520,661,1715,2376,1183,3502,4685,135161,454103,589264,04/01/2012 12:00:00 AM,204,265,248
Western,Bristol City,51520,661,1730,2391,1186,3509,4695,135919,458246,594165,05/01/2012 12:00:00 AM,206,265,249
Western,Bristol City,51520,661,1799,2460,1150,3672,4822,135757,480093,615850,09/01/2012 12:00:00 AM,205,267,250
Western,Bristol City,51520,668,1711,2379,1201,3489,4690,139515,451726,591241,03/01/2012 12:00:00 AM,209,264,249
Western,Bristol City,51520,671,1765,2436,1203,3559,4762,139758,466911,606669,07/01/2012 12:00:00 AM,208,265,249
Western,Bristol City,51520,673,1788,2461,1198,3605,4803,142327,473212,615539,08/01/2012 12:00:00 AM,211,265,250
Western,Bristol City,51520,675,1812,2487,1204,3669,4873,143944,484839,628783,11/01/2012 12:00:00 AM,213,268,253
Western,Bristol City,51520,678,1799,2477,1217,3622,4839,146961,478447,625408,12/01/2012 12:00:00 AM,217,266,252
Western,Bristol City,51520,679,1701,2380,1220,3471,4691,140796,446775,587571,02/01/2012 12:00:00 AM,207,263,247
Western,Bristol City,51520,679,1706,2385,1209,3473,4682,137115,438339,575454,01/01/2012 12:00:00 AM,202,257,241
Western,Bristol City,51520,682,1796,2478,1221,3625,4846,147348,473621,620969,10/01/2012 12:00:00 AM,216,264,251
Western,Buchanan County,51027,617,1809,2426,744,3632,4376,49498,421793,471291,01/01/2020 12:00:00 AM,80,233,194
Western,Buchanan County,51027,619,1806,2425,750,3653,4403,51615,428975,480590,12/01/2019 12:00:00 AM,83,238,198
Western,Buchanan County,51027,619,1814,2433,747,3651,4398,50344,425272,475616,02/01/2020 12:00:00 AM,81,234,195
Western,Buchanan County,51027,620,1778,2398,753,3609,4362,51547,420764,472311,11/01/2019 12:00:00 AM,83,237,197
Western,Buchanan County,51027,621,1821,2442,754,3677,4431,140134,633119,773253,03/01/2020 12:00:00 AM,226,348,317
Western,Buchanan County,51027,624,1793,2417,757,3634,4391,51566,427506.62,479072.62,10/01/2019 12:00:00 AM,83,238,198
Western,Buchanan County,51027,628,1897,2525,764,3846,4610,142344,668026,810370,04/01/2020 12:00:00 AM,227,352,321
Western,Buchanan County,51027,633,1925,2558,769,3884,4653,144262,673918,818180,05/01/2020 12:00:00 AM,228,350,320
Western,Buchanan County,51027,635,1771,2406,764,3627,4391,51952,419489,471441,09/01/2019 12:00:00 AM,82,237,196
Western,Buchanan County,51027,640,1762,2402,769,3628,4397,53155,418420,471575,08/01/2019 12:00:00 AM,83,237,196
Western,Buchanan County,51027,641,1729,2370,777,3565,4342,55213,417596.23,472809.23,04/01/2019 12:00:00 AM,86,242,199
Western,Buchanan County,51027,641,1940,2581,778,3902,4680,144839,675969,820808,06/01/2020 12:00:00 AM,226,348,318
Western,Buchanan County,51027,644,1752,2396,776,3607,4383,54149,419432,473581,07/01/2019 12:00:00 AM,84,239,198
Western,Buchanan County,51027,646,1726,2372,780,3547,4327,54687,412747,467434,06/01/2019 12:00:00 AM,85,239,197
Western,Buchanan County,51027,647,1744,2391,786,3571,4357,56538,417365,473903,03/01/2019 12:00:00 AM,87,239,198
Western,Buchanan County,51027,649,1726,2375,788,3541,4329,56164,412207,468371,05/01/2019 12:00:00 AM,87,239,197
Western,Buchanan County,51027,651,1675,2326,798,3453,4251,56355,398222,454577,02/01/2019 12:00:00 AM,87,238,195
Western,Buchanan County,51027,652,1982,2634,797,4003,4800,149490,695542,845032,07/01/2020 12:00:00 AM,229,351,321
Western,Buchanan County,51027,655,1647,2302,796,3400,4196,57569,402400,459969,01/01/2019 12:00:00 AM,88,244,200
Western,Buchanan County,51027,658,1977,2635,801,3987,4788,149918,691354,841272,09/01/2020 12:00:00 AM,228,350,319
Western,Buchanan County,51027,659,1981,2640,802,4021,4823,151315,690290,841605,08/01/2020 12:00:00 AM,230,348,319
Western,Buchanan County,51027,671,1625,2296,817,3386,4203,62818,407447.53,470265.53,12/01/2018 12:00:00 AM,94,251,205
Western,Buchanan County,51027,672,1978,2650,813,4008,4821,159286,743022,902308,10/01/2020 12:00:00 AM,237,376,340
Western,Buchanan County,51027,674,1979,2653,817,4031,4848,161385,738430,899815,11/01/2020 12:00:00 AM,239,373,339
Western,Buchanan County,51027,675,1622,2297,827,3411,4238,62293,405747,468040,11/01/2018 12:00:00 AM,92,250,204
Western,Buchanan County,51027,680,1680,2360,843,3560,4403,61489,419714,481203,09/01/2017 12:00:00 AM,90,250,204
Western,Buchanan County,51027,682,1640,2322,837,3446,4283,63697,408598,472295,10/01/2018 12:00:00 AM,93,249,203
Western,Buchanan County,51027,684,1950,2634,817,3857,4674,191966,890916.13,1082882.13,06/01/2021 12:00:00 AM,281,457,411
Western,Buchanan County,51027,686,1950,2636,818,3865,4683,190807,900775,1091582,05/01/2021 12:00:00 AM,278,462,414
Western,Buchanan County,51027,687,1697,2384,861,3572,4433,66346,420883,487229,10/01/2017 12:00:00 AM,97,248,204
Western,Buchanan County,51027,688,1686,2374,862,3557,4419,66344,417436,483780,11/01/2017 12:00:00 AM,96,248,204
Western,Buchanan County,51027,688,1977,2665,817,3965,4782,186745,833591,1020336,02/01/2021 12:00:00 AM,271,422,383
Western,Buchanan County,51027,689,1959,2648,819,3864,4683,192473,893650,1086123,04/01/2021 12:00:00 AM,279,456,410
Western,Buchanan County,51027,689,2006,2695,834,4037,4871,165006,740916,905922,12/01/2020 12:00:00 AM,239,369,336
Western,Buchanan County,51027,691,1644,2335,853,3458,4311,61966,408239,470205,08/01/2018 12:00:00 AM,90,248,201
Western,Buchanan County,51027,692,1704,2396,847,3540,4387,60792,415749,476541,03/01/2018 12:00:00 AM,88,244,199
Western,Buchanan County,51027,693,1658,2351,861,3475,4336,63910,409138,473048,06/01/2018 12:00:00 AM,92,247,201
Western,Buchanan County,51027,694,1711,2405,864,3602,4466,65515,426810,492325,12/01/2017 12:00:00 AM,94,249,205
Western,Buchanan County,51027,694,1983,2677,825,3930,4755,185780,828017,1013797,03/01/2021 12:00:00 AM,268,418,379
Western,Buchanan County,51027,695,1694,2389,866,3548,4414,62855,415480,478335,01/01/2018 12:00:00 AM,90,245,200
Western,Buchanan County,51027,696,1636,2332,866,3455,4321,63861,409075,472936,09/01/2018 12:00:00 AM,92,250,203
Western,Buchanan County,51027,696,1692,2388,861,3516,4377,63182,410936,474118,02/01/2018 12:00:00 AM,91,243,199
Western,Buchanan County,51027,696,1701,2397,874,3618,4492,64851,429235,494086,08/01/2017 12:00:00 AM,93,252,206
Western,Buchanan County,51027,697,1659,2356,862,3465,4327,64069,408679,472748,05/01/2018 12:00:00 AM,92,246,201
Western,Buchanan County,51027,697,1982,2679,841,3979,4820,189928,839250,1029178,01/01/2021 12:00:00 AM,272,423,384
Western,Buchanan County,51027,699,1654,2353,867,3465,4332,65771.36,411971.94,477743.3,07/01/2018 12:00:00 AM,94,249,203
Western,Buchanan County,51027,699,1706,2405,882,3611,4493,67394,424222,491616,07/01/2017 12:00:00 AM,96,249,204
Western,Buchanan County,51027,700,1677,2377,861,3474,4335,63287,412499,475786,04/01/2018 12:00:00 AM,90,246,200
Western,Buchanan County,51027,703,1729,2432,888,3682,4570,68191,438487,506678,06/01/2017 12:00:00 AM,97,254,208
Western,Buchanan County,51027,708,1742,2450,894,3724,4618,67164,439015,506179,04/01/2017 12:00:00 AM,95,252,207
Western,Buchanan County,51027,710,1746,2456,898,3704,4602,69628.86,443113.79,512742.65,05/01/2017 12:00:00 AM,98,254,209
Western,Buchanan County,51027,715,1780,2495,904,3806,4710,69026,453913.98,522939.98,03/01/2017 12:00:00 AM,97,255,210
Western,Buchanan County,51027,720,1811,2531,908,3885,4793,68666,458886,527552,02/01/2017 12:00:00 AM,95,253,208
Western,Buchanan County,51027,726,1789,2515,920,3834,4754,69343,450805,520148,01/01/2017 12:00:00 AM,96,252,207
Western,Buchanan County,51027,734,1818,2552,934,3899,4833,71684,457103,528787,12/01/2016 12:00:00 AM,98,251,207
Western,Buchanan County,51027,740,1804,2544,952,3898,4850,73291,453707,526998,11/01/2016 12:00:00 AM,99,252,207
Western,Buchanan County,51027,747,1802,2549,954,3983,4937,73109,460133,533242,05/01/2016 12:00:00 AM,98,255,209
Western,Buchanan County,51027,747,1815,2562,939,4008,4947,69941,465947,535888,04/01/2016 12:00:00 AM,94,257,209
Western,Buchanan County,51027,749,1813,2562,946,4008,4954,69859,464754,534613,03/01/2016 12:00:00 AM,93,256,209
Western,Buchanan County,51027,750,1807,2557,958,3922,4880,74205,460064,534269,10/01/2016 12:00:00 AM,99,255,209
Western,Buchanan County,51027,755,1805,2560,973,3942,4915,76279,463692,539971,08/01/2016 12:00:00 AM,101,257,211
Western,Buchanan County,51027,757,1779,2536,949,3918,4867,70084,456710,526794,01/01/2016 12:00:00 AM,93,257,208
Western,Buchanan County,51027,758,1598,2356,1006,3632,4638,78390,430519,508909,01/01/2012 12:00:00 AM,103,269,216
Western,Buchanan County,51027,759,1795,2554,953,3971,4924,69645,459741,529386,02/01/2016 12:00:00 AM,92,256,207
Western,Buchanan County,51027,759,1797,2556,964,3980,4944,74430,463102,537532,07/01/2016 12:00:00 AM,98,258,210
Western,Buchanan County,51027,760,1608,2368,1013,3640,4653,80559,435380,515939,02/01/2012 12:00:00 AM,106,271,218
Western,Buchanan County,51027,761,1695,2456,973,3738,4711,73103,437878,510981,09/01/2015 12:00:00 AM,96,258,208
Western,Buchanan County,51027,762,1812,2574,988,3956,4944,78554,462561,541115,09/01/2016 12:00:00 AM,103,255,210
Western,Buchanan County,51027,765,1686,2451,991,3783,4774,73972,434421,508393,07/01/2015 12:00:00 AM,97,258,207
Western,Buchanan County,51027,765,1784,2549,989,3941,4930,77199,456028,533227,06/01/2016 12:00:00 AM,101,256,209
Western,Buchanan County,51027,767,1735,2502,971,3824,4795,71328,448423,519751,11/01/2015 12:00:00 AM,93,258,208
Western,Buchanan County,51027,769,1599,2368,1027,3625,4652,81420,431994,513414,03/01/2012 12:00:00 AM,106,270,217
Western,Buchanan County,51027,770,1694,2464,995,3779,4774,75496,436807,512303,08/01/2015 12:00:00 AM,98,258,208
Western,Buchanan County,51027,771,1771,2542,971,3897,4868,72419,454071,526490,12/01/2015 12:00:00 AM,94,256,207
Western,Buchanan County,51027,775,1600,2375,1038,3615,4653,82576,427636,510212,04/01/2012 12:00:00 AM,107,267,215
Western,Buchanan County,51027,775,1680,2455,1018,3746,4764,69142,410836,479978,09/01/2014 12:00:00 AM,89,245,196
Western,Buchanan County,51027,775,1705,2480,997,3739,4736,74068,433166,507234,10/01/2015 12:00:00 AM,96,254,205
Western,Buchanan County,51027,776,1597,2373,1030,3602,4632,81642,429443,511085,05/01/2012 12:00:00 AM,105,269,215
Western,Buchanan County,51027,776,1676,2452,1025,3767,4792,76956,426014,502970,06/01/2015 12:00:00 AM,99,254,205
Western,Buchanan County,51027,782,1728,2510,1056,3851,4907,89009,461045,550054,12/01/2012 12:00:00 AM,114,267,219
Western,Buchanan County,51027,784,1634,2418,1046,3658,4704,81239,413731,494970,10/01/2014 12:00:00 AM,104,253,205
Western,Buchanan County,51027,784,1696,2480,1044,3779,4823,70706,408990,479696,08/01/2014 12:00:00 AM,90,241,193
Western,Buchanan County,51027,786,1659,2445,1045,3720,4765,78761,413237,491998,05/01/2015 12:00:00 AM,100,249,201
Western,Buchanan County,51027,787,1716,2503,1077,3792,4869,91655,459630,551285,11/01/2012 12:00:00 AM,116,268,220
Western,Buchanan County,51027,788,1625,2413,1062,3623,4685,83454,409208,492662,11/01/2014 12:00:00 AM,106,252,204
Western,Buchanan County,51027,788,1634,2422,1040,3627,4667,76580,404434,481014,01/01/2015 12:00:00 AM,97,248,199
Western,Buchanan County,51027,788,1727,2515,1093,3831,4924,89417,463738,553155,09/01/2013 12:00:00 AM,113,269,220
Western,Buchanan County,51027,788,1745,2533,1068,3901,4969,88251,466344,554595,01/01/2013 12:00:00 AM,112,267,219
Western,Buchanan County,51027,788,1746,2534,1047,3916,4963,86689,466687,553376,02/01/2013 12:00:00 AM,110,267,218
Western,Buchanan County,51027,790,1610,2400,1073,3608,4681,85515,433230,518745,06/01/2012 12:00:00 AM,108,269,216
Western,Buchanan County,51027,790,1614,2404,1052,3576,4628,80262,402362,482624,02/01/2015 12:00:00 AM,102,249,201
Western,Buchanan County,51027,790,1624,2414,1053,3609,4662,82483,409069,491552,12/01/2014 12:00:00 AM,104,252,204
Western,Buchanan County,51027,791,1632,2423,1075,3628,4703,89078,440983,530061,07/01/2012 12:00:00 AM,113,270,219
Western,Buchanan County,51027,792,1635,2427,1045,3622,4667,78579,406027,484606,03/01/2015 12:00:00 AM,99,248,200
Western,Buchanan County,51027,792,1643,2435,1080,3626,4706,91059,442520,533579,09/01/2012 12:00:00 AM,115,269,219
Western,Buchanan County,51027,792,1730,2522,1085,3824,4909,79155,423931,503086,11/01/2013 12:00:00 AM,100,245,199
Western,Buchanan County,51027,792,1741,2533,1069,3908,4977,87177,465450,552627,04/01/2013 12:00:00 AM,110,267,218
Western,Buchanan County,51027,793,1679,2472,1067,3726,4793,73165,407111,480276,06/01/2014 12:00:00 AM,92,242,194
Western,Buchanan County,51027,793,1686,2479,1065,3739,4804,72287,404114,476401,07/01/2014 12:00:00 AM,91,240,192
Western,Buchanan County,51027,793,1733,2526,1102,3845,4947,90968,461789,552757,10/01/2013 12:00:00 AM,115,266,219
Western,Buchanan County,51027,795,1692,2487,1092,3734,4826,94333,452128,546461,10/01/2012 12:00:00 AM,119,267,220
Western,Buchanan County,51027,795,1739,2534,1092,3805,4897,78814,421209,500023,12/01/2013 12:00:00 AM,99,242,197
Western,Buchanan County,51027,796,1706,2502,1070,3770,4840,72189,416277,488466,05/01/2014 12:00:00 AM,91,244,195
Western,Buchanan County,51027,797,1647,2444,1084,3622,4706,90004,439906,529910,08/01/2012 12:00:00 AM,113,267,217
Western,Buchanan County,51027,797,1734,2531,1105,3850,4955,91624,461405,553029,08/01/2013 12:00:00 AM,115,266,219
Western,Buchanan County,51027,798,1636,2434,1061,3658,4719,80740,411060,491800,04/01/2015 12:00:00 AM,101,251,202
Western,Buchanan County,51027,799,1736,2535,1076,3893,4969,87409,464905,552314,03/01/2013 12:00:00 AM,109,268,218
Western,Buchanan County,51027,799,1740,2539,1095,3901,4996,89222,461197,550419,05/01/2013 12:00:00 AM,112,265,217
Western,Buchanan County,51027,801,1724,2525,1096,3885,4981,90758,461232,551990,06/01/2013 12:00:00 AM,113,268,219
Western,Buchanan County,51027,802,1717,2519,1110,3769,4879,79609,418825,498434,02/01/2014 12:00:00 AM,99,244,198
Western,Buchanan County,51027,802,1748,2550,1109,3825,4934,77831,416927,494758,01/01/2014 12:00:00 AM,97,239,194
Western,Buchanan County,51027,804,1690,2494,1097,3731,4828,77118,412460,489578,04/01/2014 12:00:00 AM,96,244,196
Western,Buchanan County,51027,806,1718,2524,1114,3837,4951,91579,460620,552199,07/01/2013 12:00:00 AM,114,268,219
Western,Buchanan County,51027,809,1697,2506,1133,3738,4871,82564,414037,496601,03/01/2014 12:00:00 AM,102,244,198
Western,Carroll County,51035,296,1689,1985,395,3602,3997,71743,616626,688369,03/01/2020 12:00:00 AM,242,365,347
Western,Carroll County,51035,300,1666,1966,403,3562,3965,34814,382566,417380,02/01/2020 12:00:00 AM,116,230,212
Western,Carroll County,51035,300,1668,1968,396,3592,3988,36114,381764,417878,12/01/2019 12:00:00 AM,120,229,212
Western,Carroll County,51035,302,1797,2099,379,3726,4105,85499,798602,884101,02/01/2021 12:00:00 AM,283,444,421
Western,Carroll County,51035,303,1789,2092,406,3771,4177,74318,649940,724258,04/01/2020 12:00:00 AM,245,363,346
Western,Carroll County,51035,307,1671,1978,401,3599,4000,37426,389291,426717,10/01/2019 12:00:00 AM,122,233,216
Western,Carroll County,51035,307,1672,1979,421,3567,3988,37165,380633,417798,01/01/2020 12:00:00 AM,121,228,211
Western,Carroll County,51035,307,1821,2128,416,3834,4250,76273,657590,733863,05/01/2020 12:00:00 AM,248,361,345
Western,Carroll County,51035,308,1670,1978,407,3591,3998,37760,385037,422797,11/01/2019 12:00:00 AM,123,231,214
Western,Carroll County,51035,311,1638,1949,409,3518,3927,36850,382737,419587,09/01/2019 12:00:00 AM,118,234,215
Western,Carroll County,51035,312,1638,1950,397,3511,3908,35610,376971,412581,05/01/2019 12:00:00 AM,114,230,212
Western,Carroll County,51035,312,1830,2142,423,3847,4270,77660,662792,740452,06/01/2020 12:00:00 AM,249,362,346
Western,Carroll County,51035,313,1809,2122,404,3765,4169,89712,786474,876186,03/01/2021 12:00:00 AM,287,435,413
Western,Carroll County,51035,314,1633,1947,409,3470,3879,37141,372921,410062,06/01/2019 12:00:00 AM,118,228,211
Western,Carroll County,51035,314,1767,2081,420,3666,4086,95941,833631,929572,05/01/2021 12:00:00 AM,306,472,447
Western,Carroll County,51035,314,1848,2162,422,3886,4308,78286,669442,747728,08/01/2020 12:00:00 AM,249,362,346
Western,Carroll County,51035,315,1624,1939,410,3478,3888,37105,372053,409158,07/01/2019 12:00:00 AM,118,229,211
Western,Carroll County,51035,315,1647,1962,410,3534,3944,37884,379724,417608,08/01/2019 12:00:00 AM,120,231,213
Western,Carroll County,51035,315,1786,2101,419,3696,4115,97897,847770,945667,04/01/2021 12:00:00 AM,311,475,450
Western,Carroll County,51035,317,1628,1945,411,3480,3891,37458,375215,412673,04/01/2019 12:00:00 AM,118,230,212
Western,Carroll County,51035,317,1776,2093,431,3731,4162,82607,681296,763903,11/01/2020 12:00:00 AM,261,384,365
Western,Carroll County,51035,317,1865,2182,427,3935,4362,78234,677009,755243,07/01/2020 12:00:00 AM,247,363,346
Western,Carroll County,51035,318,1655,1973,408,3552,3960,36016,380231,416247,03/01/2019 12:00:00 AM,113,230,211
Western,Carroll County,51035,318,1743,2061,433,3584,4017,95938,755986,851924,01/01/2021 12:00:00 AM,302,434,413
Western,Carroll County,51035,318,1836,2154,439,3866,4305,80000,672900,752900,09/01/2020 12:00:00 AM,252,367,350
Western,Carroll County,51035,320,1770,2090,433,3692,4125,83933,673379,757312,12/01/2020 12:00:00 AM,262,380,362
Western,Carroll County,51035,321,1808,2129,437,3792,4229,84687,688050,772737,10/01/2020 12:00:00 AM,264,381,363
Western,Carroll County,51035,322,1662,1984,425,3641,4066,37720,402004,439724,09/01/2017 12:00:00 AM,117,242,222
Western,Carroll County,51035,323,1758,2081,439,3625,4064,100809,828680,929489,06/01/2021 12:00:00 AM,312,471,447
Western,Carroll County,51035,324,1629,1953,430,3509,3939,40170,379427,419597,12/01/2018 12:00:00 AM,124,233,215
Western,Carroll County,51035,325,1709,2034,429,3788,4217,36086,416787,452873,06/01/2017 12:00:00 AM,111,244,223
Western,Carroll County,51035,327,1688,2015,430,3729,4159,38872,416341,455213,08/01/2017 12:00:00 AM,119,247,226
Western,Carroll County,51035,327,1690,2017,430,3760,4190,39304,411638,450942,07/01/2017 12:00:00 AM,120,244,224
Western,Carroll County,51035,329,1645,1974,434,3589,4023,38258,393069,431327,10/01/2017 12:00:00 AM,116,239,219
Western,Carroll County,51035,329,1668,1997,435,3647,4082,39979,389931,429910,01/01/2018 12:00:00 AM,122,234,215
Western,Carroll County,51035,330,1645,1975,433,3605,4038,38693,392339,431032,11/01/2017 12:00:00 AM,117,239,218
Western,Carroll County,51035,331,1578,1909,431,3364,3795,39387,364779,404166,02/01/2019 12:00:00 AM,119,231,212
Western,Carroll County,51035,331,1630,1961,439,3517,3956,41591,381016,422607,11/01/2018 12:00:00 AM,126,234,216
Western,Carroll County,51035,331,1666,1997,432,3664,4096,39985,392582,432567,12/01/2017 12:00:00 AM,121,236,217
Western,Carroll County,51035,331,1727,2058,431,3853,4284,38631,422781,461412,05/01/2017 12:00:00 AM,117,245,224
Western,Carroll County,51035,333,1626,1959,446,3499,3945,40779,377990,418769,09/01/2018 12:00:00 AM,122,232,214
Western,Carroll County,51035,333,1639,1972,453,3522,3975,42224,386035,428259,10/01/2018 12:00:00 AM,127,236,217
Western,Carroll County,51035,335,1621,1956,450,3541,3991,39843,384481,424324,03/01/2018 12:00:00 AM,119,237,217
Western,Carroll County,51035,335,1658,1993,441,3558,3999,38839,386209,425048,08/01/2018 12:00:00 AM,116,233,213
Western,Carroll County,51035,336,1632,1968,446,3506,3952,41400,389554,430954,01/01/2019 12:00:00 AM,123,239,219
Western,Carroll County,51035,338,1648,1986,450,3609,4059,40664,391264,431928,02/01/2018 12:00:00 AM,120,237,217
Western,Carroll County,51035,341,1641,1982,462,3556,4018,41261,383667,424928,04/01/2018 12:00:00 AM,121,234,214
Western,Carroll County,51035,341,1673,2014,455,3586,4041,39171,390304,429475,07/01/2018 12:00:00 AM,115,233,213
Western,Carroll County,51035,341,1748,2089,448,3904,4352,39260,425087,464347,04/01/2017 12:00:00 AM,115,243,222
Western,Carroll County,51035,342,1645,1987,459,3560,4019,39506,386987,426493,05/01/2018 12:00:00 AM,116,235,215
Western,Carroll County,51035,343,1646,1989,455,3560,4015,38321,380483,418804,06/01/2018 12:00:00 AM,112,231,211
Western,Carroll County,51035,344,1780,2124,456,3967,4423,40857,435925,476782,03/01/2017 12:00:00 AM,119,245,224
Western,Carroll County,51035,347,1820,2167,452,4105,4557,39061,446190,485251,02/01/2017 12:00:00 AM,113,245,224
Western,Carroll County,51035,348,1963,2311,447,4333,4780,36765,474807,511572,01/01/2016 12:00:00 AM,106,242,221
Western,Carroll County,51035,351,1808,2159,456,4053,4509,39044,435701,474745,01/01/2017 12:00:00 AM,111,241,220
Western,Carroll County,51035,353,1956,2309,459,4341,4800,37402,474569,511971,12/01/2015 12:00:00 AM,106,243,222
Western,Carroll County,51035,355,1879,2234,466,4176,4642,38937,455851,494788,04/01/2016 12:00:00 AM,110,243,221
Western,Carroll County,51035,356,1795,2151,465,4010,4475,39330,434765,474095,12/01/2016 12:00:00 AM,110,242,220
Western,Carroll County,51035,357,1823,2180,469,4088,4557,39107,437805,476912,07/01/2016 12:00:00 AM,110,240,219
Western,Carroll County,51035,358,1817,2175,475,4094,4569,40799,438742,479541,11/01/2016 12:00:00 AM,114,241,220
Western,Carroll County,51035,358,1833,2191,472,4092,4564,40198,441205,481403,06/01/2016 12:00:00 AM,112,241,220
Western,Carroll County,51035,358,1862,2220,475,4124,4599,40138,448424,488562,05/01/2016 12:00:00 AM,112,241,220
Western,Carroll County,51035,358,1906,2264,459,4231,4690,38035,468284,506319,03/01/2016 12:00:00 AM,106,246,224
Western,Carroll County,51035,359,1923,2282,477,4255,4732,39609,478067,517676,02/01/2016 12:00:00 AM,110,249,227
Western,Carroll County,51035,361,1826,2187,469,4119,4588,39544,443140,482684,08/01/2016 12:00:00 AM,110,243,221
Western,Carroll County,51035,361,2025,2386,482,4536,5018,42696,501694,544390,06/01/2015 12:00:00 AM,118,248,228
Western,Carroll County,51035,362,1821,2183,481,4086,4567,43026,438903,481929,09/01/2016 12:00:00 AM,119,241,221
Western,Carroll County,51035,364,1963,2327,487,4377,4864,41130,479314,520444,10/01/2015 12:00:00 AM,113,244,224
Western,Carroll County,51035,365,1817,2182,486,4074,4560,42697,440664,483361,10/01/2016 12:00:00 AM,117,243,222
Western,Carroll County,51035,366,2038,2404,490,4588,5078,43227,510788,554015,05/01/2015 12:00:00 AM,118,251,230
Western,Carroll County,51035,367,1942,2309,486,4322,4808,39689,475340,515029,11/01/2015 12:00:00 AM,108,245,223
Western,Carroll County,51035,370,2034,2404,501,4548,5049,45493,493505,538998,07/01/2015 12:00:00 AM,123,243,224
Western,Carroll County,51035,372,1983,2355,495,4417,4912,43761,487289,531050,09/01/2015 12:00:00 AM,118,246,225
Western,Carroll County,51035,373,2029,2402,506,4518,5024,45311,496855,542166,08/01/2015 12:00:00 AM,121,245,226
Western,Carroll County,51035,375,2049,2424,511,4581,5092,45107,507183,552290,04/01/2015 12:00:00 AM,120,248,228
Western,Carroll County,51035,376,2192,2568,515,4823,5338,41136,516620,557756,05/01/2014 12:00:00 AM,109,236,217
Western,Carroll County,51035,377,2154,2531,519,4759,5278,40993,506631,547624,06/01/2014 12:00:00 AM,109,235,216
Western,Carroll County,51035,380,2265,2645,502,5003,5505,38891,534904,573795,01/01/2014 12:00:00 AM,102,236,217
Western,Carroll County,51035,382,2197,2579,520,4827,5347,40481,523552,564033,04/01/2014 12:00:00 AM,106,238,219
Western,Carroll County,51035,383,2031,2414,527,4566,5093,47114,505381,552495,02/01/2015 12:00:00 AM,123,249,229
Western,Carroll County,51035,385,2219,2604,518,4869,5387,41342,523244,564586,03/01/2014 12:00:00 AM,107,236,217
Western,Carroll County,51035,386,2043,2429,533,4560,5093,47784,501177,548961,03/01/2015 12:00:00 AM,124,245,226
Western,Carroll County,51035,386,2228,2614,567,4993,5560,55321,590174,645495,08/01/2012 12:00:00 AM,143,265,247
Western,Carroll County,51035,386,2286,2672,537,5083,5620,49711,599842,649553,08/01/2013 12:00:00 AM,129,262,243
Western,Carroll County,51035,387,2037,2424,536,4577,5113,48711,502863,551574,10/01/2014 12:00:00 AM,126,247,228
Western,Carroll County,51035,387,2069,2456,542,4605,5147,44193,489049,533242,07/01/2014 12:00:00 AM,114,236,217
Western,Carroll County,51035,387,2247,2634,526,4940,5466,41511,533677,575188,02/01/2014 12:00:00 AM,107,238,218
Western,Carroll County,51035,388,2048,2436,528,4598,5126,43318,484148,527466,08/01/2014 12:00:00 AM,112,236,217
Western,Carroll County,51035,388,2215,2603,580,4970,5550,56949,591674,648623,07/01/2012 12:00:00 AM,147,267,249
Western,Carroll County,51035,389,2246,2635,536,4975,5511,44167,542609,586776,12/01/2013 12:00:00 AM,114,242,223
Western,Carroll County,51035,392,2281,2673,549,5072,5621,51315,599251,650566,09/01/2013 12:00:00 AM,131,263,243
Western,Carroll County,51035,393,2248,2641,552,4983,5535,49062,543643,592705,11/01/2013 12:00:00 AM,125,242,224
Western,Carroll County,51035,394,2015,2409,554,4487,5041,50337,487962,538299,01/01/2015 12:00:00 AM,128,242,223
Western,Carroll County,51035,395,2024,2419,549,4525,5074,50315,491614,541929,11/01/2014 12:00:00 AM,127,243,224
Western,Carroll County,51035,395,2236,2631,616,4951,5567,59889,585822,645711,04/01/2012 12:00:00 AM,152,262,245
Western,Carroll County,51035,396,2039,2435,555,4605,5160,45628,481910,527538,09/01/2014 12:00:00 AM,115,236,217
Western,Carroll County,51035,396,2196,2592,605,4906,5511,57985,582329,640314,06/01/2012 12:00:00 AM,146,265,247
Western,Carroll County,51035,396,2244,2640,591,5041,5632,57352,594704,652056,09/01/2012 12:00:00 AM,145,265,247
Western,Carroll County,51035,397,2022,2419,567,4541,5108,54320,492469,546789,12/01/2014 12:00:00 AM,137,244,226
Western,Carroll County,51035,397,2207,2604,617,4872,5489,60246,573432,633678,05/01/2012 12:00:00 AM,152,260,243
Western,Carroll County,51035,397,2246,2643,613,4949,5562,59173,586395,645568,03/01/2012 12:00:00 AM,149,261,244
Western,Carroll County,51035,398,2265,2663,559,5058,5617,52227,601877,654104,06/01/2013 12:00:00 AM,131,266,246
Western,Carroll County,51035,400,2272,2672,603,5066,5669,60293,598094,658387,10/01/2012 12:00:00 AM,151,263,246
Western,Carroll County,51035,401,2247,2648,635,4925,5560,63618,580595,644213,02/01/2012 12:00:00 AM,159,258,243
Western,Carroll County,51035,401,2274,2675,563,5086,5649,51168,601168,652336,07/01/2013 12:00:00 AM,128,264,244
Western,Carroll County,51035,402,2258,2660,574,5012,5586,56159,593453,649612,10/01/2013 12:00:00 AM,140,263,244
Western,Carroll County,51035,403,2267,2670,583,5024,5607,55288,596231,651519,02/01/2013 12:00:00 AM,137,263,244
Western,Carroll County,51035,407,2245,2652,598,4975,5573,58126,590981,649107,03/01/2013 12:00:00 AM,143,263,245
Western,Carroll County,51035,407,2258,2665,584,5038,5622,55093,599629,654722,05/01/2013 12:00:00 AM,135,266,246
Western,Carroll County,51035,409,2234,2643,644,4898,5542,64028,574072,638100,01/01/2012 12:00:00 AM,157,257,241
Western,Carroll County,51035,410,2230,2640,596,4953,5549,57209,587996,645205,04/01/2013 12:00:00 AM,140,264,244
Western,Carroll County,51035,411,2275,2686,606,5033,5639,57129,584463,641592,01/01/2013 12:00:00 AM,139,257,239
Western,Carroll County,51035,411,2282,2693,601,5078,5679,58031,594758,652789,12/01/2012 12:00:00 AM,141,261,242
Western,Carroll County,51035,418,2292,2710,623,5091,5714,60309,601718,662027,11/01/2012 12:00:00 AM,144,263,244
Western,Dickenson County,51051,342,1011,1353,399,2111,2510,21660,236763,258423,01/01/2020 12:00:00 AM,63,234,191
Western,Dickenson County,51051,344,1010,1354,404,2106,2510,76129,363211,439340,03/01/2020 12:00:00 AM,221,360,324
Western,Dickenson County,51051,346,1023,1369,404,2127,2531,22334,239422,261756,02/01/2020 12:00:00 AM,65,234,191
Western,Dickenson County,51051,346,1024,1370,405,2131,2536,23310,240877,264187,12/01/2019 12:00:00 AM,67,235,193
Western,Dickenson County,51051,348,1082,1430,407,2249,2656,76842,396355,473197,04/01/2020 12:00:00 AM,221,366,331
Western,Dickenson County,51051,350,1009,1359,413,2093,2506,24262,237415,261677,11/01/2019 12:00:00 AM,69,235,193
Western,Dickenson County,51051,350,1098,1448,410,2272,2682,77509,397712,475221,05/01/2020 12:00:00 AM,221,362,328
Western,Dickenson County,51051,352,1001,1353,428,2127,2555,25881,239119,265000,05/01/2019 12:00:00 AM,74,239,196
Western,Dickenson County,51051,352,998,1350,413,2100,2513,25017,234106,259123,09/01/2019 12:00:00 AM,71,235,192
Western,Dickenson County,51051,353,1010,1363,417,2112,2529,24495,236309,260804,10/01/2019 12:00:00 AM,69,234,191
Western,Dickenson County,51051,353,1010,1363,423,2154,2577,25082,242728,267810,07/01/2019 12:00:00 AM,71,240,196
Western,Dickenson County,51051,353,1109,1462,413,2290,2703,78605,396585,475190,06/01/2020 12:00:00 AM,223,358,325
Western,Dickenson County,51051,353,990,1343,418,2097,2515,24637,233887,258524,08/01/2019 12:00:00 AM,70,236,192
Western,Dickenson County,51051,357,1006,1363,431,2152,2583,25433,240671,266104,06/01/2019 12:00:00 AM,71,239,195
Western,Dickenson County,51051,360,986,1346,449,2082,2531,28855,234867,263722,02/01/2019 12:00:00 AM,80,238,196
Western,Dickenson County,51051,361,1131,1492,427,2337,2764,80346,404926,485272,08/01/2020 12:00:00 AM,223,358,325
Western,Dickenson County,51051,361,1135,1496,426,2368,2794,80181,410572,490753,07/01/2020 12:00:00 AM,222,362,328
Western,Dickenson County,51051,362,1010,1372,445,2142,2587,27921,240064,267985,03/01/2019 12:00:00 AM,77,238,195
Western,Dickenson County,51051,364,1031,1395,453,2229,2682,31490,253121,284611,10/01/2018 12:00:00 AM,87,246,204
Western,Dickenson County,51051,364,1124,1488,430,2335,2765,80518,408299,488817,09/01/2020 12:00:00 AM,221,363,329
Western,Dickenson County,51051,366,1009,1375,454,2124,2578,27756,240402,268158,04/01/2019 12:00:00 AM,76,238,195
Western,Dickenson County,51051,367,1112,1479,433,2356,2789,85920,439085,525005,10/01/2020 12:00:00 AM,234,395,355
Western,Dickenson County,51051,367,1116,1483,436,2359,2795,85052,440138,525190,11/01/2020 12:00:00 AM,232,394,354
Western,Dickenson County,51051,368,1029,1397,462,2211,2673,32811,246284,279095,11/01/2018 12:00:00 AM,89,239,200
Western,Dickenson County,51051,370,1108,1478,466,2434,2900,32321,272317,304638,02/01/2018 12:00:00 AM,87,246,206
Western,Dickenson County,51051,371,1011,1382,466,2143,2609,29816,247291,277107,01/01/2019 12:00:00 AM,80,245,201
Western,Dickenson County,51051,371,1058,1429,461,2312,2773,31687,263791,295478,06/01/2018 12:00:00 AM,85,249,207
Western,Dickenson County,51051,371,1065,1436,457,2330,2787,32574,260347,292921,04/01/2018 12:00:00 AM,88,244,204
Western,Dickenson County,51051,372,1054,1426,457,2295,2752,31929,260397,292326,09/01/2018 12:00:00 AM,86,247,205
Western,Dickenson County,51051,372,1092,1464,466,2410,2876,32990,272431,305421,03/01/2018 12:00:00 AM,89,249,209
Western,Dickenson County,51051,372,1125,1497,449,2371,2820,89061,435103,524164,12/01/2020 12:00:00 AM,239,387,350
Western,Dickenson County,51051,374,1035,1409,470,2197,2667,33681,247319,281000,12/01/2018 12:00:00 AM,90,239,199
Western,Dickenson County,51051,374,1104,1478,473,2423,2896,34513,272470,306983,12/01/2017 12:00:00 AM,92,247,208
Western,Dickenson County,51051,374,1114,1488,449,2358,2807,102653,491206,593859,01/01/2021 12:00:00 AM,274,441,399
Western,Dickenson County,51051,375,1053,1428,462,2273,2735,31892,259408,291300,08/01/2018 12:00:00 AM,85,246,204
Western,Dickenson County,51051,375,1115,1490,465,2446,2911,33057,280234,313291,11/01/2017 12:00:00 AM,88,251,210
Western,Dickenson County,51051,376,1105,1481,472,2408,2880,32522,267708,300230,01/01/2018 12:00:00 AM,86,242,203
Western,Dickenson County,51051,377,1047,1424,469,2277,2746,32757,264262,297019,07/01/2018 12:00:00 AM,87,252,209
Western,Dickenson County,51051,377,1134,1511,450,2410,2860,102025,520194,622219,02/01/2021 12:00:00 AM,271,459,412
Western,Dickenson County,51051,379,1063,1442,476,2315,2791,33158,258360,291518,05/01/2018 12:00:00 AM,87,243,202
Western,Dickenson County,51051,379,1117,1496,475,2450,2925,33730,277274,311004,10/01/2017 12:00:00 AM,89,248,208
Western,Dickenson County,51051,382,1120,1502,479,2444,2923,33808,281835,315643,09/01/2017 12:00:00 AM,89,252,210
Western,Dickenson County,51051,384,1157,1541,477,2562,3039,34056,286619,320675,05/01/2017 12:00:00 AM,89,248,208
Western,Dickenson County,51051,388,1112,1500,467,2336,2803,108609,534393,643002,04/01/2021 12:00:00 AM,280,481,429
Western,Dickenson County,51051,388,1128,1516,467,2397,2864,106197,501495,607692,03/01/2021 12:00:00 AM,274,445,401
Western,Dickenson County,51051,388,1130,1518,477,2474,2951,32320,285584,317904,08/01/2017 12:00:00 AM,83,253,209
Western,Dickenson County,51051,388,1132,1520,473,2495,2968,33522,280150,313672,06/01/2017 12:00:00 AM,86,247,206
Western,Dickenson County,51051,388,1187,1575,467,2652,3119,32569,296698,329267,03/01/2017 12:00:00 AM,84,250,209
Western,Dickenson County,51051,389,1096,1485,461,2298,2759,106015.92,523059,629074.92,06/01/2021 12:00:00 AM,273,477,424
Western,Dickenson County,51051,390,1180,1570,474,2616,3090,32937,293442,326379,04/01/2017 12:00:00 AM,84,249,208
Western,Dickenson County,51051,391,1098,1489,468,2304,2772,109336,528641,637977,05/01/2021 12:00:00 AM,280,481,428
Western,Dickenson County,51051,391,1121,1512,486,2493,2979,35347,282623,317970,07/01/2017 12:00:00 AM,90,252,210
Western,Dickenson County,51051,391,1227,1618,475,2769,3244,32768,308381,341149,01/01/2017 12:00:00 AM,84,251,211
Western,Dickenson County,51051,391,1235,1626,474,2869,3343,32492,321847,354339,08/01/2016 12:00:00 AM,83,261,218
Western,Dickenson County,51051,393,1218,1611,471,2754,3225,31700,311110,342810,02/01/2017 12:00:00 AM,81,255,213
Western,Dickenson County,51051,395,1230,1625,487,2785,3272,34409,313800,348209,12/01/2016 12:00:00 AM,87,255,214
Western,Dickenson County,51051,395,1236,1631,481,2868,3349,33118,314775,347893,09/01/2016 12:00:00 AM,84,255,213
Western,Dickenson County,51051,398,1218,1616,491,2781,3272,34448,310511,344959,11/01/2016 12:00:00 AM,87,255,213
Western,Dickenson County,51051,399,1224,1623,486,2837,3323,33348,314587,347935,07/01/2016 12:00:00 AM,84,257,214
Western,Dickenson County,51051,399,1237,1636,487,2880,3367,33687,324151,357838,06/01/2016 12:00:00 AM,84,262,219
Western,Dickenson County,51051,401,1236,1637,493,2846,3339,34141,320447,354588,10/01/2016 12:00:00 AM,85,259,217
Western,Dickenson County,51051,406,1234,1640,501,2877,3378,35089,317564,352653,05/01/2016 12:00:00 AM,86,257,215
Western,Dickenson County,51051,407,1243,1650,493,2884,3377,33602,320524,354126,04/01/2016 12:00:00 AM,83,258,215
Western,Dickenson County,51051,408,1250,1658,490,2843,3333,32771,321805,354576,11/01/2015 12:00:00 AM,80,257,214
Western,Dickenson County,51051,409,1244,1653,492,2835,3327,32681,314885,347566,10/01/2015 12:00:00 AM,80,253,210
Western,Dickenson County,51051,416,1266,1682,503,2870,3373,33569,324895,358464,12/01/2015 12:00:00 AM,81,257,213
Western,Dickenson County,51051,419,1221,1640,501,2780,3281,33691,313915,347606,09/01/2015 12:00:00 AM,80,257,212
Western,Dickenson County,51051,422,1239,1661,519,2882,3401,36757,317817,354574,03/01/2016 12:00:00 AM,87,257,213
Western,Dickenson County,51051,422,1261,1683,518,2860,3378,36157,319045,355202,01/01/2016 12:00:00 AM,86,253,211
Western,Dickenson County,51051,425,1247,1672,530,2855,3385,37554,316706,354260,02/01/2016 12:00:00 AM,88,254,212
Western,Dickenson County,51051,427,1165,1592,519,2674,3193,34595,301225,335820,07/01/2015 12:00:00 AM,81,259,211
Western,Dickenson County,51051,428,1151,1579,534,2706,3240,37338,297544,334882,02/01/2015 12:00:00 AM,87,259,212
Western,Dickenson County,51051,428,1189,1617,521,2729,3250,35738,309139,344877,08/01/2015 12:00:00 AM,84,260,213
Western,Dickenson County,51051,429,1150,1579,538,2699,3237,37666,296435,334101,01/01/2015 12:00:00 AM,88,258,212
Western,Dickenson County,51051,431,1153,1584,545,2735,3280,39523,302577,342100,11/01/2014 12:00:00 AM,92,262,216
Western,Dickenson County,51051,432,1150,1582,549,2703,3252,41127,297224,338351,12/01/2014 12:00:00 AM,95,258,214
Western,Dickenson County,51051,432,1183,1615,543,2764,3307,38146,306468,344614,03/01/2015 12:00:00 AM,88,259,213
Western,Dickenson County,51051,437,1174,1611,543,2744,3287,38128,304846,342974,04/01/2015 12:00:00 AM,87,260,213
Western,Dickenson County,51051,438,1131,1569,560,2661,3221,40796,294434,335230,10/01/2014 12:00:00 AM,93,260,214
Western,Dickenson County,51051,439,1156,1595,538,2671,3209,36923,297802,334725,06/01/2015 12:00:00 AM,84,258,210
Western,Dickenson County,51051,440,1129,1569,561,2657,3218,36933,279923,316856,09/01/2014 12:00:00 AM,84,248,202
Western,Dickenson County,51051,440,1130,1570,554,2656,3210,35601,278416,314017,08/01/2014 12:00:00 AM,81,246,200
Western,Dickenson County,51051,444,1162,1606,552,2712,3264,39434,301055,340489,05/01/2015 12:00:00 AM,89,259,212
Western,Dickenson County,51051,448,1151,1599,564,2673,3237,37104,282332,319436,07/01/2014 12:00:00 AM,83,245,200
Western,Dickenson County,51051,450,1239,1689,558,2845,3403,35290,307222,342512,03/01/2014 12:00:00 AM,78,248,203
Western,Dickenson County,51051,453,1222,1675,576,2853,3429,45428,338515,383943,11/01/2012 12:00:00 AM,100,277,229
Western,Dickenson County,51051,455,1236,1691,582,2855,3437,43709,336616,380325,01/01/2013 12:00:00 AM,96,272,225
Western,Dickenson County,51051,455,1245,1700,569,2857,3426,36119,310026,346145,04/01/2014 12:00:00 AM,79,249,204
Western,Dickenson County,51051,456,1194,1650,555,2750,3305,35925,296250,332175,06/01/2014 12:00:00 AM,79,248,201
Western,Dickenson County,51051,456,1246,1702,581,2848,3429,38517,305630,344147,02/01/2014 12:00:00 AM,84,245,202
Western,Dickenson County,51051,457,1231,1688,566,2809,3375,36641,303229,339870,05/01/2014 12:00:00 AM,80,246,201
Western,Dickenson County,51051,458,1209,1667,580,2755,3335,37697,290477,328174,01/01/2014 12:00:00 AM,82,240,197
Western,Dickenson County,51051,458,1245,1703,592,2866,3458,45688,341874,387562,02/01/2013 12:00:00 AM,100,275,228
Western,Dickenson County,51051,460,1163,1623,590,2702,3292,44638,317163,361801,06/01/2012 12:00:00 AM,97,273,223
Western,Dickenson County,51051,460,1215,1675,586,2769,3355,39220,297760,336980,12/01/2013 12:00:00 AM,85,245,201
Western,Dickenson County,51051,462,1139,1601,603,2624,3227,45802,309226,355028,04/01/2012 12:00:00 AM,99,271,222
Western,Dickenson County,51051,462,1221,1683,600,2825,3425,49478,332967,382445,12/01/2012 12:00:00 AM,107,273,227
Western,Dickenson County,51051,462,1248,1710,598,2856,3454,46299,341572,387871,03/01/2013 12:00:00 AM,100,274,227
Western,Dickenson County,51051,463,1177,1640,590,2739,3329,44706,317532,362238,09/01/2012 12:00:00 AM,97,270,221
Western,Dickenson County,51051,463,1188,1651,591,2746,3337,44653,322620,367273,08/01/2012 12:00:00 AM,96,272,222
Western,Dickenson County,51051,464,1224,1688,592,2782,3374,39716,299911,339627,11/01/2013 12:00:00 AM,86,245,201
Western,Dickenson County,51051,464,1237,1701,609,2822,3431,46158,334967,381125,09/01/2013 12:00:00 AM,99,271,224
Western,Dickenson County,51051,465,1160,1625,596,2688,3284,44461,315758,360219,07/01/2012 12:00:00 AM,96,272,222
Western,Dickenson County,51051,465,1193,1658,599,2774,3373,47273,326202,373475,10/01/2012 12:00:00 AM,102,273,225
Western,Dickenson County,51051,466,1249,1715,611,2828,3439,48987,335300,384287,06/01/2013 12:00:00 AM,105,268,224
Western,Dickenson County,51051,467,1227,1694,606,2796,3402,47100,332787,379887,10/01/2013 12:00:00 AM,101,271,224
Western,Dickenson County,51051,467,1237,1704,614,2833,3447,47243,334245,381488,07/01/2013 12:00:00 AM,101,270,224
Western,Dickenson County,51051,468,1244,1712,610,2856,3466,45684,340387,386071,08/01/2013 12:00:00 AM,98,274,226
Western,Dickenson County,51051,469,1136,1605,618,2626,3244,47376,308549,355925,05/01/2012 12:00:00 AM,101,272,222
Western,Dickenson County,51051,470,1129,1599,620,2611,3231,48078,307989,356067,03/01/2012 12:00:00 AM,102,273,223
Western,Dickenson County,51051,472,1250,1722,613,2859,3472,48564,337323,385887,05/01/2013 12:00:00 AM,103,270,224
Western,Dickenson County,51051,473,1235,1708,619,2836,3455,50013,335239,385252,04/01/2013 12:00:00 AM,106,271,226
Western,Dickenson County,51051,476,1109,1585,650,2553,3203,52081,300584,352665,02/01/2012 12:00:00 AM,109,271,223
Western,Dickenson County,51051,486,1135,1621,669,2572,3241,52541,299683,352224,01/01/2012 12:00:00 AM,108,264,217
Western,Floyd County,51063,126,653,779,165,1416,1581,37619,319175,356794,05/01/2021 12:00:00 AM,299,489,458
Western,Floyd County,51063,126,653,779,170,1434,1604,32634,261233,293867,12/01/2020 12:00:00 AM,259,400,377
Western,Floyd County,51063,126,665,791,165,1434,1599,38658,321951,360609,06/01/2021 12:00:00 AM,307,484,456
Western,Floyd County,51063,129,600,729,168,1299,1467,15515,141899,157414,08/01/2019 12:00:00 AM,120,236,216
Western,Floyd County,51063,130,624,754,174,1346,1520,16671,149822,166493,01/01/2020 12:00:00 AM,128,240,221
Western,Floyd County,51063,130,665,795,176,1439,1615,38618,300922,339540,01/01/2021 12:00:00 AM,297,453,427
Western,Floyd County,51063,130,665,795,177,1445,1622,33616,260749,294365,11/01/2020 12:00:00 AM,259,392,370
Western,Floyd County,51063,130,666,796,175,1445,1620,40476,325372,365848,04/01/2021 12:00:00 AM,311,489,460
Western,Floyd County,51063,131,634,765,175,1387,1562,17310,154386,171696,02/01/2020 12:00:00 AM,132,244,224
Western,Floyd County,51063,131,663,794,178,1436,1614,35436,261851,297287,10/01/2020 12:00:00 AM,271,395,374
Western,Floyd County,51063,132,603,735,171,1299,1470,16070,141017,157087,06/01/2019 12:00:00 AM,122,234,214
Western,Floyd County,51063,132,617,749,178,1328,1506,17154,142033,159187,11/01/2019 12:00:00 AM,130,230,213
Western,Floyd County,51063,132,618,750,171,1362,1533,15577,150715,166292,02/01/2019 12:00:00 AM,118,244,222
Western,Floyd County,51063,132,665,797,179,1458,1637,39017,301991,341008,03/01/2021 12:00:00 AM,296,454,428
Western,Floyd County,51063,132,674,806,175,1459,1634,39107,309027,348134,02/01/2021 12:00:00 AM,296,458,432
Western,Floyd County,51063,133,592,725,173,1281,1454,16530,139328,155858,07/01/2019 12:00:00 AM,124,235,215
Western,Floyd County,51063,133,614,747,170,1348,1518,16393,144040,160433,05/01/2019 12:00:00 AM,123,235,215
Western,Floyd County,51063,133,632,765,172,1383,1555,15404,150915,166319,04/01/2019 12:00:00 AM,116,239,217
Western,Floyd County,51063,134,608,742,176,1281,1457,16455,139803,156258,10/01/2019 12:00:00 AM,123,230,211
Western,Floyd County,51063,134,612,746,178,1331,1509,16933,146019,162952,09/01/2019 12:00:00 AM,126,239,218
Western,Floyd County,51063,134,677,811,179,1465,1644,32586,252066,284652,09/01/2020 12:00:00 AM,243,372,351
Western,Floyd County,51063,135,627,762,174,1372,1546,16029,152265,168294,03/01/2019 12:00:00 AM,119,243,221
Western,Floyd County,51063,135,633,768,187,1357,1544,17826,149658,167484,12/01/2019 12:00:00 AM,132,236,218
Western,Floyd County,51063,135,671,806,180,1573,1753,17673,180638,198311,04/01/2017 12:00:00 AM,131,269,246
Western,Floyd County,51063,136,629,765,186,1381,1567,36305,237192,273497,03/01/2020 12:00:00 AM,267,377,358
Western,Floyd County,51063,136,658,794,174,1453,1627,16011,169645,185656,01/01/2019 12:00:00 AM,118,258,234
Western,Floyd County,51063,136,683,819,184,1468,1652,33807,249199,283006,08/01/2020 12:00:00 AM,249,365,346
Western,Floyd County,51063,136,687,823,179,1587,1766,15946,171839,187785,06/01/2015 12:00:00 AM,117,250,228
Western,Floyd County,51063,136,689,825,176,1595,1771,14912,172071,186983,08/01/2015 12:00:00 AM,110,250,227
Western,Floyd County,51063,136,691,827,186,1595,1781,18092,183769,201861,06/01/2017 12:00:00 AM,133,266,244
Western,Floyd County,51063,136,696,832,182,1606,1788,15984,173148,189132,05/01/2015 12:00:00 AM,118,249,227
Western,Floyd County,51063,137,672,809,186,1475,1661,34123,252233,286356,04/01/2020 12:00:00 AM,249,375,354
Western,Floyd County,51063,137,681,818,178,1585,1763,15581,168862,184443,07/01/2015 12:00:00 AM,114,248,225
Western,Floyd County,51063,137,688,825,176,1608,1784,15469,173825,189294,09/01/2015 12:00:00 AM,113,253,229
Western,Floyd County,51063,137,689,826,180,1609,1789,17173,179697,196870,03/01/2017 12:00:00 AM,125,261,238
Western,Floyd County,51063,138,685,823,180,1604,1784,15336,173793,189129,10/01/2015 12:00:00 AM,111,254,230
Western,Floyd County,51063,138,688,826,183,1593,1776,17942,183257,201199,05/01/2017 12:00:00 AM,130,266,244
Western,Floyd County,51063,138,695,833,189,1496,1685,34544,258222,292766,07/01/2020 12:00:00 AM,250,372,351
Western,Floyd County,51063,139,683,822,190,1467,1657,34849,251770,286619,06/01/2020 12:00:00 AM,251,369,349
Western,Floyd County,51063,139,686,825,187,1511,1698,34306,261178,295484,05/01/2020 12:00:00 AM,247,381,358
Western,Floyd County,51063,140,665,805,173,1447,1620,16288,161667,177955,10/01/2018 12:00:00 AM,116,243,221
Western,Floyd County,51063,140,665,805,201,1552,1753,19305,163696,183001,02/01/2016 12:00:00 AM,138,246,227
Western,Floyd County,51063,140,681,821,193,1606,1799,17132,174364,191496,10/01/2016 12:00:00 AM,122,256,233
Western,Floyd County,51063,140,694,834,198,1599,1797,20226,185127,205353,09/01/2017 12:00:00 AM,144,267,246
Western,Floyd County,51063,140,701,841,200,1612,1812,20722,186238,206960,07/01/2017 12:00:00 AM,148,266,246
Western,Floyd County,51063,141,647,788,181,1443,1624,17118,160214,177332,12/01/2018 12:00:00 AM,121,248,225
Western,Floyd County,51063,141,673,814,199,1587,1786,18013,172014,190027,09/01/2016 12:00:00 AM,128,256,233
Western,Floyd County,51063,141,686,827,189,1573,1762,16780,169528,186308,04/01/2015 12:00:00 AM,119,247,225
Western,Floyd County,51063,142,664,806,180,1461,1641,16682,163830,180512,11/01/2018 12:00:00 AM,117,247,224
Western,Floyd County,51063,142,667,809,195,1565,1760,18112,169913,188025,11/01/2016 12:00:00 AM,128,255,232
Western,Floyd County,51063,142,699,841,202,1611,1813,20923,184446,205369,08/01/2017 12:00:00 AM,147,264,244
Western,Floyd County,51063,143,662,805,183,1469,1652,17348,161013,178361,09/01/2018 12:00:00 AM,121,243,222
Western,Floyd County,51063,143,666,809,204,1566,1770,18920,163753,182673,06/01/2016 12:00:00 AM,132,246,226
Western,Floyd County,51063,143,669,812,201,1583,1784,17760,166410,184170,07/01/2016 12:00:00 AM,124,249,227
Western,Floyd County,51063,143,673,816,200,1595,1795,17782,168829,186611,12/01/2015 12:00:00 AM,124,251,229
Western,Floyd County,51063,144,658,802,189,1513,1702,19002,170016,189018,05/01/2018 12:00:00 AM,132,258,236
Western,Floyd County,51063,144,658,802,210,1549,1759,19591,163760,183351,05/01/2016 12:00:00 AM,136,249,229
Western,Floyd County,51063,144,669,813,195,1567,1762,16786,167913,184699,11/01/2015 12:00:00 AM,117,251,227
Western,Floyd County,51063,144,685,829,184,1581,1765,15235,174176,189411,02/01/2015 12:00:00 AM,106,254,228
Western,Floyd County,51063,145,664,809,199,1576,1775,17665,165676,183341,08/01/2016 12:00:00 AM,122,250,227
Western,Floyd County,51063,145,672,817,206,1575,1781,18733,166524,185257,01/01/2016 12:00:00 AM,129,248,227
Western,Floyd County,51063,145,674,819,209,1581,1790,20135,167888,188023,04/01/2016 12:00:00 AM,139,249,230
Western,Floyd County,51063,145,675,820,201,1604,1805,18749,175458,194207,01/01/2017 12:00:00 AM,129,260,237
Western,Floyd County,51063,145,679,824,202,1594,1796,18597,177096,195693,12/01/2016 12:00:00 AM,128,261,237
Western,Floyd County,51063,145,680,825,207,1568,1775,16923,161555,178478,08/01/2014 12:00:00 AM,117,238,216
Western,Floyd County,51063,145,683,828,195,1578,1773,18727,180231,198958,02/01/2018 12:00:00 AM,129,264,240
Western,Floyd County,51063,145,684,829,193,1577,1770,16634,172877,189511,03/01/2015 12:00:00 AM,115,253,229
Western,Floyd County,51063,145,689,834,196,1582,1778,20257,181334.5,201591.5,03/01/2018 12:00:00 AM,140,263,242
Western,Floyd County,51063,145,701,846,196,1618,1814,20175,180249,200424,11/01/2017 12:00:00 AM,139,257,237
Western,Floyd County,51063,145,775,920,204,1731,1935,18067,187087,205154,11/01/2013 12:00:00 AM,125,241,223
Western,Floyd County,51063,146,661,807,187,1469,1656,17939,163715,181654,08/01/2018 12:00:00 AM,123,248,225
Western,Floyd County,51063,146,663,809,211,1556,1767,19284,165411,184695,03/01/2016 12:00:00 AM,132,249,228
Western,Floyd County,51063,146,666,812,193,1494,1687,19865,168372,188237,06/01/2018 12:00:00 AM,136,253,232
Western,Floyd County,51063,146,676,822,193,1563,1756,20445,178067,198512,04/01/2018 12:00:00 AM,140,263,241
Western,Floyd County,51063,147,683,830,199,1564,1763,20055,174601,194656,01/01/2018 12:00:00 AM,136,256,235
Western,Floyd County,51063,147,684,831,201,1574,1775,17629,167498,185127,01/01/2015 12:00:00 AM,120,245,223
Western,Floyd County,51063,147,690,837,211,1613,1824,22152,183967,206119,10/01/2017 12:00:00 AM,151,267,246
Western,Floyd County,51063,147,695,842,199,1628,1827,19199,180972,200171,02/01/2017 12:00:00 AM,131,260,238
Western,Floyd County,51063,147,765,912,211,1707,1918,19614,185084,204698,12/01/2013 12:00:00 AM,133,242,224
Western,Floyd County,51063,147,766,913,204,1726,1930,18073,185304,203377,01/01/2014 12:00:00 AM,123,242,223
Western,Floyd County,51063,148,659,807,195,1484,1679,19134,167915,187049,07/01/2018 12:00:00 AM,129,255,232
Western,Floyd County,51063,149,703,852,215,1638,1853,18894,167083,185977,07/01/2014 12:00:00 AM,127,238,218
Western,Floyd County,51063,149,759,908,212,1709,1921,19021,185971,204992,02/01/2014 12:00:00 AM,128,245,226
Western,Floyd County,51063,149,786,935,209,1763,1972,21609,205513,227122,10/01/2013 12:00:00 AM,145,261,243
Western,Floyd County,51063,150,675,825,205,1572,1777,18673,170245,188918,12/01/2014 12:00:00 AM,124,252,229
Western,Floyd County,51063,150,679,829,207,1587,1794,20897,178583,199480,12/01/2017 12:00:00 AM,139,263,241
Western,Floyd County,51063,150,723,873,218,1664,1882,20838,175783,196621,05/01/2014 12:00:00 AM,139,243,225
Western,Floyd County,51063,151,745,896,214,1690,1904,19262,180104,199366,04/01/2014 12:00:00 AM,128,242,223
Western,Floyd County,51063,151,777,928,204,1753,1957,19576,205315,224891,08/01/2013 12:00:00 AM,130,264,242
Western,Floyd County,51063,151,805,956,220,1852,2072,20141,222132,242273,08/01/2012 12:00:00 AM,133,276,253
Western,Floyd County,51063,152,675,827,224,1552,1776,19017,159200,178217,09/01/2014 12:00:00 AM,125,236,215
Western,Floyd County,51063,152,762,914,217,1718,1935,20011,185011,205022,03/01/2014 12:00:00 AM,132,243,224
Western,Floyd County,51063,153,666,819,224,1538,1762,20763,165403,186166,10/01/2014 12:00:00 AM,136,248,227
Western,Floyd County,51063,153,829,982,218,1904,2122,21884,234272,256156,01/01/2012 12:00:00 AM,143,283,261
Western,Floyd County,51063,154,782,936,221,1820,2041,21984,220260,242244,09/01/2012 12:00:00 AM,143,282,259
Western,Floyd County,51063,154,797,951,231,1811,2042,21975,217683,239658,07/01/2012 12:00:00 AM,143,273,252
Western,Floyd County,51063,155,707,862,236,1631,1867,21603,170999,192602,06/01/2014 12:00:00 AM,139,242,223
Western,Floyd County,51063,155,789,944,224,1764,1988,22836,207161,229997,09/01/2013 12:00:00 AM,147,263,244
Western,Floyd County,51063,156,677,833,230,1571,1801,21358,168486,189844,11/01/2014 12:00:00 AM,137,249,228
Western,Floyd County,51063,156,810,966,227,1873,2100,23692,230819,254511,02/01/2012 12:00:00 AM,152,285,263
Western,Floyd County,51063,157,775,932,218,1778,1996,20965,206674,227639,07/01/2013 12:00:00 AM,134,267,244
Western,Floyd County,51063,158,795,953,228,1805,2033,22039,218653,240692,04/01/2013 12:00:00 AM,139,275,253
Western,Floyd County,51063,159,777,936,227,1801,2028,22594,216839,239433,10/01/2012 12:00:00 AM,142,279,256
Western,Floyd County,51063,160,795,955,242,1812,2054,25364,219865,245229,06/01/2012 12:00:00 AM,159,277,257
Western,Floyd County,51063,160,803,963,232,1818,2050,24099,222743,246842,02/01/2013 12:00:00 AM,151,277,256
Western,Floyd County,51063,160,808,968,240,1867,2107,23825,227285,251110,04/01/2012 12:00:00 AM,149,281,259
Western,Floyd County,51063,161,797,958,234,1825,2059,23652,219884,243536,03/01/2013 12:00:00 AM,147,276,254
Western,Floyd County,51063,161,804,965,241,1852,2093,25099,226339,251438,03/01/2012 12:00:00 AM,156,282,261
Western,Floyd County,51063,161,809,970,243,1853,2096,25247,221777,247024,05/01/2012 12:00:00 AM,157,274,255
Western,Floyd County,51063,162,783,945,234,1774,2008,23293,212571,235864,05/01/2013 12:00:00 AM,144,271,250
Western,Floyd County,51063,163,769,932,234,1745,1979,24810,212865,237675,12/01/2012 12:00:00 AM,152,277,255
Western,Floyd County,51063,164,766,930,245,1741,1986,25307,210434,235741,11/01/2012 12:00:00 AM,154,275,253
Western,Floyd County,51063,164,792,956,238,1797,2035,22644,211918,234562,06/01/2013 12:00:00 AM,138,268,245
Western,Floyd County,51063,167,798,965,243,1800,2043,25679,215317,240996,01/01/2013 12:00:00 AM,154,270,250
Western,Galax City,51640,161,617,778,189,1247,1436,15119,142266,157385,01/01/2020 12:00:00 AM,94,231,202
Western,Galax City,51640,162,626,788,191,1297,1488,14852,144200,159052,09/01/2019 12:00:00 AM,92,230,202
Western,Galax City,51640,162,634,796,193,1292,1485,36284,222926,259210,03/01/2020 12:00:00 AM,224,352,326
Western,Galax City,51640,162,649,811,192,1332,1524,36110,231628,267738,04/01/2020 12:00:00 AM,223,357,330
Western,Galax City,51640,162,661,823,202,1391,1593,16968,158469,175437,09/01/2017 12:00:00 AM,105,240,213
Western,Galax City,51640,163,623,786,193,1264,1457,15863,141465,157328,02/01/2020 12:00:00 AM,97,227,200
Western,Galax City,51640,163,647,810,189,1324,1513,35635,228806,264441,06/01/2020 12:00:00 AM,219,354,326
Western,Galax City,51640,163,669,832,202,1411,1613,17271,160133,177404,08/01/2017 12:00:00 AM,106,239,213
Western,Galax City,51640,164,626,790,195,1261,1456,16379,142914,159293,11/01/2019 12:00:00 AM,100,228,202
Western,Galax City,51640,164,631,795,192,1274,1466,16247,147199,163446,12/01/2019 12:00:00 AM,99,233,206
Western,Galax City,51640,165,632,797,192,1303,1495,14346,144454,158800,08/01/2019 12:00:00 AM,87,229,199
Western,Galax City,51640,165,633,798,197,1295,1492,16625,145014,161639,10/01/2019 12:00:00 AM,101,229,203
Western,Galax City,51640,165,649,814,195,1332,1527,37011,230959,267970,05/01/2020 12:00:00 AM,224,356,329
Western,Galax City,51640,165,652,817,188,1337,1525,35675,229430,265105,07/01/2020 12:00:00 AM,216,352,324
Western,Galax City,51640,166,633,799,191,1295,1486,43104,267381,310485,03/01/2021 12:00:00 AM,260,422,389
Western,Galax City,51640,166,637,803,191,1312,1503,36553,228347,264900,09/01/2020 12:00:00 AM,220,358,330
Western,Galax City,51640,167,656,823,209,1380,1589,17956,157006,174962,10/01/2017 12:00:00 AM,108,239,213
Western,Galax City,51640,168,633,801,197,1293,1490,15363,146025,161388,06/01/2019 12:00:00 AM,91,231,201
Western,Galax City,51640,168,653,821,194,1338,1532,36219,231607,267826,08/01/2020 12:00:00 AM,216,355,326
Western,Galax City,51640,169,626,795,197,1276,1473,48629,289349,337978,04/01/2021 12:00:00 AM,288,462,425
Western,Galax City,51640,169,635,804,200,1293,1493,47219,293737,340956,06/01/2021 12:00:00 AM,279,463,424
Western,Galax City,51640,169,637,806,195,1316,1511,44711,281222,325933,02/01/2021 12:00:00 AM,265,441,404
Western,Galax City,51640,170,623,793,202,1264,1466,47632,288508,336140,05/01/2021 12:00:00 AM,280,463,424
Western,Galax City,51640,170,649,819,210,1384,1594,18177,155087,173264,11/01/2017 12:00:00 AM,107,239,212
Western,Galax City,51640,170,653,823,205,1371,1576,16161,153093,169254,07/01/2018 12:00:00 AM,95,234,206
Western,Galax City,51640,171,630,801,200,1291,1491,39349,236984,276333,10/01/2020 12:00:00 AM,230,376,345
Western,Galax City,51640,171,643,814,211,1357,1568,18876,152601,171477,12/01/2017 12:00:00 AM,110,237,211
Western,Galax City,51640,171,644,815,203,1318,1521,40216,240844,281060,11/01/2020 12:00:00 AM,235,374,345
Western,Galax City,51640,171,644,815,209,1369,1578,16311,154630,170941,06/01/2018 12:00:00 AM,95,240,210
Western,Galax City,51640,171,649,820,198,1336,1534,16504,148823,165327,12/01/2018 12:00:00 AM,97,229,202
Western,Galax City,51640,171,650,821,204,1325,1529,16408,150654,167062,05/01/2019 12:00:00 AM,96,232,203
Western,Galax City,51640,171,672,843,213,1446,1659,18323,164991,183314,07/01/2017 12:00:00 AM,107,246,217
Western,Galax City,51640,172,629,801,195,1266,1461,15005,142568,157573,02/01/2019 12:00:00 AM,87,227,197
Western,Galax City,51640,172,629,801,203,1285,1488,16223,140006,156229,07/01/2019 12:00:00 AM,94,223,195
Western,Galax City,51640,173,650,823,200,1335,1535,16214,153117,169331,11/01/2018 12:00:00 AM,94,236,206
Western,Galax City,51640,173,650,823,209,1360,1569,16574,151306,167880,08/01/2018 12:00:00 AM,96,233,204
Western,Galax City,51640,174,642,816,200,1321,1521,15804,150031,165835,01/01/2019 12:00:00 AM,91,234,203
Western,Galax City,51640,174,645,819,202,1342,1544,16041,151184,167225,09/01/2018 12:00:00 AM,92,234,204
Western,Galax City,51640,175,626,801,208,1286,1494,41158,233129,274287,12/01/2020 12:00:00 AM,235,372,342
Western,Galax City,51640,175,680,855,220,1477,1697,19739,169090,188829,06/01/2017 12:00:00 AM,113,249,221
Western,Galax City,51640,176,631,807,208,1309,1517,47185,276393,323578,01/01/2021 12:00:00 AM,268,438,401
Western,Galax City,51640,176,639,815,216,1349,1565,17127,149944,167071,05/01/2018 12:00:00 AM,97,235,205
Western,Galax City,51640,176,656,832,217,1384,1601,17642,156087,173729,04/01/2018 12:00:00 AM,100,238,209
Western,Galax City,51640,176,661,837,200,1354,1554,15585,152452,168037,04/01/2019 12:00:00 AM,89,231,201
Western,Galax City,51640,176,696,872,222,1507,1729,19093,177336,196429,05/01/2017 12:00:00 AM,108,255,225
Western,Galax City,51640,177,656,833,216,1371,1587,17635,154844,172479,02/01/2018 12:00:00 AM,100,236,207
Western,Galax City,51640,177,686,863,224,1510,1734,19663,176450,196113,04/01/2017 12:00:00 AM,111,257,227
Western,Galax City,51640,178,646,824,201,1309,1510,15458,145117,160575,03/01/2019 12:00:00 AM,87,225,195
Western,Galax City,51640,178,652,830,220,1359,1579,18227,154296,172523,01/01/2018 12:00:00 AM,102,237,208
Western,Galax City,51640,178,654,832,206,1349,1555,16417,153851,170268,10/01/2018 12:00:00 AM,92,235,205
Western,Galax City,51640,179,653,832,219,1381,1600,17886,157220,175106,03/01/2018 12:00:00 AM,100,241,210
Western,Galax City,51640,179,699,878,222,1533,1755,19625,181617,201242,03/01/2017 12:00:00 AM,110,260,229
Western,Galax City,51640,181,732,913,221,1587,1808,17678,180674,198352,08/01/2016 12:00:00 AM,98,247,217
Western,Galax City,51640,184,712,896,239,1536,1775,20045,174772,194817,05/01/2016 12:00:00 AM,109,245,217
Western,Galax City,51640,185,694,879,233,1528,1761,20922,175964,196886,02/01/2017 12:00:00 AM,113,254,224
Western,Galax City,51640,185,701,886,230,1536,1766,20121,176342,196463,01/01/2017 12:00:00 AM,109,252,222
Western,Galax City,51640,185,705,890,242,1532,1774,20994,175730,196724,06/01/2016 12:00:00 AM,113,249,221
Western,Galax City,51640,185,733,918,240,1554,1794,19300,179552,198852,02/01/2016 12:00:00 AM,104,245,217
Western,Galax City,51640,186,731,917,237,1568,1805,19644,178958,198602,04/01/2016 12:00:00 AM,106,245,217
Western,Galax City,51640,187,726,913,239,1572,1811,20101,179882,199983,09/01/2016 12:00:00 AM,107,248,219
Western,Galax City,51640,188,705,893,240,1533,1773,21285,173047,194332,11/01/2016 12:00:00 AM,113,245,218
Western,Galax City,51640,188,718,906,243,1565,1808,20928,179904,200832,10/01/2016 12:00:00 AM,111,251,222
Western,Galax City,51640,189,714,903,239,1545,1784,19361,172516,191877,07/01/2016 12:00:00 AM,102,242,212
Western,Galax City,51640,189,736,925,246,1552,1798,20260,177800,198060,01/01/2016 12:00:00 AM,107,242,214
Western,Galax City,51640,189,740,929,249,1563,1812,21528,177990,199518,03/01/2016 12:00:00 AM,114,241,215
Western,Galax City,51640,190,772,962,264,1606,1870,21630,185410,207040,08/01/2014 12:00:00 AM,114,240,215
Western,Galax City,51640,192,764,956,234,1595,1829,19352,184076,203428,10/01/2015 12:00:00 AM,101,241,213
Western,Galax City,51640,192,774,966,251,1611,1862,21575,188600,210175,07/01/2015 12:00:00 AM,112,244,218
Western,Galax City,51640,193,781,974,253,1620,1873,21171,192071,213242,03/01/2015 12:00:00 AM,110,246,219
Western,Galax City,51640,193,790,983,248,1632,1880,20338,194312,214650,04/01/2015 12:00:00 AM,105,246,218
Western,Galax City,51640,194,710,904,245,1540,1785,21689,176013,197702,12/01/2016 12:00:00 AM,112,248,219
Western,Galax City,51640,194,766,960,245,1594,1839,20243,185673,205916,08/01/2015 12:00:00 AM,104,242,214
Western,Galax City,51640,194,775,969,258,1613,1871,23166,193497,216663,10/01/2014 12:00:00 AM,119,250,224
Western,Galax City,51640,194,776,970,255,1608,1863,22626,193799,216425,11/01/2014 12:00:00 AM,117,250,223
Western,Galax City,51640,194,797,991,263,1625,1888,22021,190540,212561,06/01/2014 12:00:00 AM,114,239,214
Western,Galax City,51640,195,738,933,249,1553,1802,21105,181071,202176,12/01/2015 12:00:00 AM,108,245,217
Western,Galax City,51640,195,750,945,244,1566,1810,21076,180444,201520,11/01/2015 12:00:00 AM,108,241,213
Western,Galax City,51640,196,772,968,257,1582,1839,22834,190630,213464,12/01/2014 12:00:00 AM,117,247,221
Western,Galax City,51640,196,772,968,269,1597,1866,21828,181162,202990,09/01/2014 12:00:00 AM,111,235,210
Western,Galax City,51640,196,788,984,262,1614,1876,22784,190140,212924,01/01/2015 12:00:00 AM,116,241,216
Western,Galax City,51640,197,776,973,274,1604,1878,22729,186534,209263,07/01/2014 12:00:00 AM,115,240,215
Western,Galax City,51640,197,808,1005,274,1632,1906,23682,192261,215943,05/01/2014 12:00:00 AM,120,238,215
Western,Galax City,51640,198,761,959,249,1595,1844,21311,184431,205742,09/01/2015 12:00:00 AM,108,242,215
Western,Galax City,51640,198,777,975,262,1601,1863,22068,190796,212864,05/01/2015 12:00:00 AM,111,246,218
Western,Galax City,51640,198,779,977,263,1605,1868,22517,189849,212366,02/01/2015 12:00:00 AM,114,244,217
Western,Galax City,51640,198,784,982,257,1627,1884,21617,193057,214674,06/01/2015 12:00:00 AM,109,246,219
Western,Galax City,51640,200,829,1029,264,1683,1947,21608,197685,219293,03/01/2014 12:00:00 AM,108,238,213
Western,Galax City,51640,201,829,1030,278,1674,1952,23751,196481,220232,04/01/2014 12:00:00 AM,118,237,214
Western,Galax City,51640,205,830,1035,275,1703,1978,22614,197564,220178,02/01/2014 12:00:00 AM,110,238,213
Western,Galax City,51640,212,798,1010,318,1594,1912,32254,198702,230956,03/01/2013 12:00:00 AM,152,249,229
Western,Galax City,51640,212,839,1051,290,1717,2007,23519,197325,220844,01/01/2014 12:00:00 AM,111,235,210
Western,Galax City,51640,213,823,1036,323,1660,1983,32889,206002,238891,06/01/2013 12:00:00 AM,154,250,231
Western,Galax City,51640,213,844,1057,305,1747,2052,29113,220033,249146,10/01/2013 12:00:00 AM,137,261,236
Western,Galax City,51640,214,797,1011,324,1598,1922,31562,198136,229698,01/01/2013 12:00:00 AM,147,249,227
Western,Galax City,51640,214,808,1022,318,1622,1940,32194,203361,235555,04/01/2013 12:00:00 AM,150,252,230
Western,Galax City,51640,215,847,1062,306,1744,2050,26199,198474,224673,12/01/2013 12:00:00 AM,122,234,212
Western,Galax City,51640,216,845,1061,313,1742,2055,28191,197754,225945,11/01/2013 12:00:00 AM,131,234,213
Western,Galax City,51640,217,811,1028,318,1618,1936,31921,203171,235092,05/01/2013 12:00:00 AM,147,251,229
Western,Galax City,51640,218,789,1007,335,1576,1911,34020,194929,228949,02/01/2013 12:00:00 AM,156,247,227
Western,Galax City,51640,218,809,1027,335,1618,1953,33248,199486,232734,07/01/2013 12:00:00 AM,153,247,227
Western,Galax City,51640,218,840,1058,327,1710,2037,31776,212846,244622,09/01/2013 12:00:00 AM,146,253,231
Western,Galax City,51640,219,764,983,340,1540,1880,34676,190307,224983,10/01/2012 12:00:00 AM,158,249,229
Western,Galax City,51640,219,772,991,335,1544,1879,34500,190845,225345,11/01/2012 12:00:00 AM,158,247,227
Western,Galax City,51640,220,773,993,333,1560,1893,34892,194292,229184,08/01/2012 12:00:00 AM,159,251,231
Western,Galax City,51640,220,776,996,337,1562,1899,34460,195558,230018,12/01/2012 12:00:00 AM,157,252,231
Western,Galax City,51640,220,836,1056,330,1692,2022,31548,207873,239421,08/01/2013 12:00:00 AM,143,249,227
Western,Galax City,51640,221,763,984,331,1491,1822,35252,190510,225762,04/01/2012 12:00:00 AM,160,250,229
Western,Galax City,51640,222,758,980,342,1535,1877,35529,190012,225541,09/01/2012 12:00:00 AM,160,251,230
Western,Galax City,51640,226,759,985,348,1506,1854,37308,189154,226462,05/01/2012 12:00:00 AM,165,249,230
Western,Galax City,51640,226,767,993,349,1495,1844,37328,189621,226949,03/01/2012 12:00:00 AM,165,247,229
Western,Galax City,51640,227,764,991,346,1488,1834,36003,190895,226898,02/01/2012 12:00:00 AM,159,250,229
Western,Galax City,51640,227,777,1004,339,1522,1861,35144,193113,228257,01/01/2012 12:00:00 AM,155,249,227
Western,Galax City,51640,232,766,998,359,1523,1882,37956,190925,228881,06/01/2012 12:00:00 AM,164,249,229
Western,Galax City,51640,232,770,1002,350,1541,1891,35845,193585,229430,07/01/2012 12:00:00 AM,155,251,229
Western,Giles County,51071,215,810,1025,256,1902,2158,19994,208844,228838,06/01/2015 12:00:00 AM,93,258,223
Western,Giles County,51071,216,800,1016,256,1852,2108,20543,202674,223217,07/01/2015 12:00:00 AM,95,253,220
Western,Giles County,51071,217,815,1032,259,1916,2175,20319,213266,233585,05/01/2015 12:00:00 AM,94,262,226
Western,Giles County,51071,218,758,976,276,1634,1910,60561,343839,404400,02/01/2021 12:00:00 AM,278,454,414
Western,Giles County,51071,218,821,1039,262,1898,2160,20798,213102,233900,04/01/2015 12:00:00 AM,95,260,225
Western,Giles County,51071,219,655,874,277,1463,1740,23035,158671,181706,02/01/2019 12:00:00 AM,105,242,208
Western,Giles County,51071,221,798,1019,265,1847,2112,21699,203022,224721,08/01/2015 12:00:00 AM,98,254,221
Western,Giles County,51071,222,809,1031,260,1873,2133,20484,203479,223963,09/01/2015 12:00:00 AM,92,252,217
Western,Giles County,51071,222,824,1046,264,1905,2169,20999,214315,235314,03/01/2015 12:00:00 AM,95,260,225
Western,Giles County,51071,223,655,878,285,1489,1774,25549,161316,186865,11/01/2018 12:00:00 AM,115,246,213
Western,Giles County,51071,225,645,870,295,1381,1676,25741,153686,179427,10/01/2019 12:00:00 AM,114,238,206
Western,Giles County,51071,225,744,969,291,1626,1917,65229,334613,399842,03/01/2021 12:00:00 AM,290,450,413
Western,Giles County,51071,226,669,895,294,1500,1794,25328,164113,189441,01/01/2019 12:00:00 AM,112,245,212
Western,Giles County,51071,226,722,948,300,1542,1842,69695,349878,419573,06/01/2021 12:00:00 AM,308,485,443
Western,Giles County,51071,226,827,1053,274,1907,2181,21571,214566,236137,02/01/2015 12:00:00 AM,95,259,224
Western,Giles County,51071,227,644,871,289,1478,1767,25411,158480,183891,10/01/2018 12:00:00 AM,112,246,211
Western,Giles County,51071,228,643,871,302,1405,1707,26930,154266,181196,11/01/2019 12:00:00 AM,118,240,208
Western,Giles County,51071,228,668,896,292,1530,1822,23594,167785,191379,08/01/2018 12:00:00 AM,103,251,214
Western,Giles County,51071,228,730,958,299,1572,1871,69578,350681,420259,05/01/2021 12:00:00 AM,305,480,439
Western,Giles County,51071,228,743,971,301,1601,1902,69881,364552,434433,04/01/2021 12:00:00 AM,306,491,447
Western,Giles County,51071,228,842,1070,276,1937,2213,21426,216207,237633,01/01/2015 12:00:00 AM,94,257,222
Western,Giles County,51071,229,660,889,298,1491,1789,26122,159877,185999,12/01/2018 12:00:00 AM,114,242,209
Western,Giles County,51071,229,679,908,299,1556,1855,26293,168106,194399,09/01/2018 12:00:00 AM,115,248,214
Western,Giles County,51071,229,739,968,310,1608,1918,69315,338836,408151,01/01/2021 12:00:00 AM,303,459,422
Western,Giles County,51071,229,793,1022,286,1852,2138,24088,197352,221440,12/01/2015 12:00:00 AM,105,249,217
Western,Giles County,51071,229,870,1099,284,1948,2232,22553,224520,247073,11/01/2014 12:00:00 AM,98,258,225
Western,Giles County,51071,230,635,865,312,1392,1704,56136,238578,294714,03/01/2020 12:00:00 AM,244,376,341
Western,Giles County,51071,230,659,889,295,1463,1758,24810,155441,180251,04/01/2019 12:00:00 AM,108,236,203
Western,Giles County,51071,230,726,956,295,1688,1983,24977,189011,213988,02/01/2018 12:00:00 AM,109,260,224
Western,Giles County,51071,230,745,975,270,1777,2047,21394,193217,214611,10/01/2016 12:00:00 AM,93,259,220
Western,Giles County,51071,230,777,1007,283,1798,2081,23430,194775,218205,10/01/2015 12:00:00 AM,102,251,217
Western,Giles County,51071,230,890,1120,286,1960,2246,20712,220382,241094,09/01/2014 12:00:00 AM,90,248,215
Western,Giles County,51071,230,900,1130,283,1972,2255,19948,219787,239735,08/01/2014 12:00:00 AM,87,244,212
Western,Giles County,51071,231,625,856,314,1373,1687,26586,150943,177529,02/01/2020 12:00:00 AM,115,242,207
Western,Giles County,51071,231,642,873,307,1409,1716,25908,156686,182594,01/01/2020 12:00:00 AM,112,244,209
Western,Giles County,51071,231,648,879,295,1396,1691,24063,152643,176706,08/01/2019 12:00:00 AM,104,236,201
Western,Giles County,51071,231,721,952,292,1703,1995,24931,186591,211522,01/01/2018 12:00:00 AM,108,259,222
Western,Giles County,51071,231,751,982,270,1776,2046,21398,195957,217355,09/01/2016 12:00:00 AM,93,261,221
Western,Giles County,51071,231,780,1011,285,1831,2116,23861,195222,219083,11/01/2015 12:00:00 AM,103,250,217
Western,Giles County,51071,231,806,1037,280,1903,2183,23022,209199,232221,04/01/2016 12:00:00 AM,100,260,224
Western,Giles County,51071,231,846,1077,289,1916,2205,23444,217187,240631,12/01/2014 12:00:00 AM,101,257,223
Western,Giles County,51071,232,675,907,310,1459,1769,56555,253495,310050,04/01/2020 12:00:00 AM,244,376,342
Western,Giles County,51071,232,697,929,312,1521,1833,57045,260755,317800,05/01/2020 12:00:00 AM,246,374,342
Western,Giles County,51071,232,716,948,295,1690,1985,24569,184753,209322,03/01/2018 12:00:00 AM,106,258,221
Western,Giles County,51071,232,723,955,300,1710,2010,27096,188000,215096,12/01/2017 12:00:00 AM,117,260,225
Western,Giles County,51071,232,740,972,309,1631,1940,59085,293316,352401,12/01/2020 12:00:00 AM,255,396,363
Western,Giles County,51071,232,795,1027,279,1876,2155,22875,204797,227672,06/01/2016 12:00:00 AM,99,258,222
Western,Giles County,51071,233,649,882,314,1429,1743,28069,160444,188513,12/01/2019 12:00:00 AM,120,247,214
Western,Giles County,51071,233,697,930,301,1623,1924,24180,176091,200271,05/01/2018 12:00:00 AM,104,253,215
Western,Giles County,51071,233,718,951,299,1683,1982,24349,188329,212678,04/01/2018 12:00:00 AM,105,262,224
Western,Giles County,51071,233,883,1116,290,1966,2256,23779,229156,252935,10/01/2014 12:00:00 AM,102,260,227
Western,Giles County,51071,234,640,874,303,1419,1722,25215,153549,178764,07/01/2019 12:00:00 AM,108,240,205
Western,Giles County,51071,234,642,876,305,1406,1711,25585,151708,177293,06/01/2019 12:00:00 AM,109,236,202
Western,Giles County,51071,234,652,886,302,1449,1751,25688,154767,180455,05/01/2019 12:00:00 AM,110,237,204
Western,Giles County,51071,234,684,918,305,1568,1873,25178,167904,193082,06/01/2018 12:00:00 AM,108,245,210
Western,Giles County,51071,234,685,919,303,1561,1864,24992,168428,193420,07/01/2018 12:00:00 AM,107,246,210
Western,Giles County,51071,234,772,1006,278,1817,2095,21437,199794,221231,08/01/2016 12:00:00 AM,92,259,220
Western,Giles County,51071,234,794,1028,280,1884,2164,22400,204602,227002,07/01/2016 12:00:00 AM,96,258,221
Western,Giles County,51071,234,797,1031,284,1872,2156,23157,206995,230152,05/01/2016 12:00:00 AM,99,260,223
Western,Giles County,51071,234,904,1138,293,1981,2274,21253,215842,237095,07/01/2014 12:00:00 AM,91,239,208
Western,Giles County,51071,235,651,886,301,1401,1702,26724,155260,181984,09/01/2019 12:00:00 AM,114,238,205
Western,Giles County,51071,235,660,895,293,1475,1768,24646,160631.27,185277.27,03/01/2019 12:00:00 AM,105,243,207
Western,Giles County,51071,235,710,945,299,1665,1964,26993,181643,208636,10/01/2017 12:00:00 AM,115,256,221
Western,Giles County,51071,235,710,945,311,1537,1848,57418,264454,321872,06/01/2020 12:00:00 AM,244,372,341
Western,Giles County,51071,235,803,1038,287,1893,2180,23744,203597,227341,02/01/2016 12:00:00 AM,101,254,219
Western,Giles County,51071,235,803,1038,288,1869,2157,23719,200152,223871,01/01/2016 12:00:00 AM,101,249,216
Western,Giles County,51071,236,750,986,276,1782,2058,21358,195523,216881,11/01/2016 12:00:00 AM,91,261,220
Western,Giles County,51071,236,929,1165,317,2130,2447,27950,255294,283244,02/01/2012 12:00:00 AM,118,275,243
Western,Giles County,51071,237,720,957,302,1681,1983,26360,189136,215496,09/01/2017 12:00:00 AM,111,263,225
Western,Giles County,51071,237,729,966,307,1715,2022,28274,188792,217066,11/01/2017 12:00:00 AM,119,259,225
Western,Giles County,51071,237,739,976,276,1759,2035,22251,193643,215894,03/01/2017 12:00:00 AM,94,262,221
Western,Giles County,51071,237,805,1042,288,1894,2182,23867,208370,232237,03/01/2016 12:00:00 AM,101,259,223
Western,Giles County,51071,238,719,957,282,1691,1973,23412,185537,208949,04/01/2017 12:00:00 AM,98,258,218
Western,Giles County,51071,238,724,962,296,1657,1953,25268,185503,210771,08/01/2017 12:00:00 AM,106,256,219
Western,Giles County,51071,238,906,1144,323,2063,2386,29539,244169,273708,01/01/2012 12:00:00 AM,124,270,239
Western,Giles County,51071,239,736,975,318,1617,1935,58412,274885,333297,07/01/2020 12:00:00 AM,244,373,342
Western,Giles County,51071,239,755,994,277,1798,2075,21785,198326,220111,12/01/2016 12:00:00 AM,91,263,221
Western,Giles County,51071,240,722,962,302,1677,1979,26421,179503,205924,06/01/2017 12:00:00 AM,110,249,214
Western,Giles County,51071,240,739,979,317,1625,1942,58618,285148,343766,08/01/2020 12:00:00 AM,244,386,351
Western,Giles County,51071,240,756,996,280,1806,2086,22697,198692,221389,02/01/2017 12:00:00 AM,95,263,222
Western,Giles County,51071,240,758,998,279,1810,2089,22290,196038,218328,01/01/2017 12:00:00 AM,93,259,219
Western,Giles County,51071,240,914,1154,294,1995,2289,19809,216954,236763,06/01/2014 12:00:00 AM,83,237,205
Western,Giles County,51071,241,711,952,299,1657,1956,25594,180067,205661,05/01/2017 12:00:00 AM,106,253,216
Western,Giles County,51071,242,736,978,305,1670,1975,25449,183229,208678,07/01/2017 12:00:00 AM,105,249,213
Western,Giles County,51071,242,738,980,319,1618,1937,62396,296355,358751,11/01/2020 12:00:00 AM,258,402,366
Western,Giles County,51071,243,941,1184,334,2080,2414,29594,253425,283019,03/01/2013 12:00:00 AM,122,269,239
Western,Giles County,51071,244,893,1137,336,2053,2389,30374,244526,274900,04/01/2012 12:00:00 AM,124,274,242
Western,Giles County,51071,244,923,1167,301,2027,2328,22133,222018,244151,05/01/2014 12:00:00 AM,91,241,209
Western,Giles County,51071,245,746,991,322,1638,1960,58443,280398,338841,09/01/2020 12:00:00 AM,239,376,342
Western,Giles County,51071,245,877,1122,339,1946,2285,30964,232021,262985,09/01/2012 12:00:00 AM,126,265,234
Western,Giles County,51071,246,948,1194,317,2074,2391,23336,228431,251767,04/01/2014 12:00:00 AM,95,241,211
Western,Giles County,51071,247,908,1155,335,2080,2415,30074,248330,278404,03/01/2012 12:00:00 AM,122,273,241
Western,Giles County,51071,248,747,995,324,1643,1967,63707,300222,363929,10/01/2020 12:00:00 AM,257,402,366
Western,Giles County,51071,248,875,1123,339,1992,2331,30490,238121,268611,05/01/2012 12:00:00 AM,123,272,239
Western,Giles County,51071,250,924,1174,349,2052,2401,31568,249013,280581,02/01/2013 12:00:00 AM,126,269,239
Western,Giles County,51071,250,937,1187,340,2073,2413,30039,249977,280016,04/01/2013 12:00:00 AM,120,267,236
Western,Giles County,51071,251,892,1143,356,1987,2343,33670,234805,268475,10/01/2012 12:00:00 AM,134,263,235
Western,Giles County,51071,252,888,1140,356,1963,2319,32986,234799,267785,08/01/2012 12:00:00 AM,131,264,235
Western,Giles County,51071,253,958,1211,324,2111,2435,23956,226662,250618,02/01/2014 12:00:00 AM,95,237,207
Western,Giles County,51071,254,879,1133,358,1964,2322,32345,232178,264523,06/01/2012 12:00:00 AM,127,264,233
Western,Giles County,51071,254,883,1137,367,1949,2316,34642,231777,266419,07/01/2012 12:00:00 AM,136,262,234
Western,Giles County,51071,254,908,1162,354,2016,2370,33391,242193,275584,12/01/2012 12:00:00 AM,131,267,237
Western,Giles County,51071,254,969,1223,327,2120,2447,25180,228565,253745,12/01/2013 12:00:00 AM,99,236,207
Western,Giles County,51071,255,901,1156,356,2003,2359,32254,240964,273218,01/01/2013 12:00:00 AM,126,267,236
Western,Giles County,51071,255,904,1159,365,2011,2376,35270,241904,277174,11/01/2012 12:00:00 AM,138,268,239
Western,Giles County,51071,255,961,1216,329,2093,2422,24403,221703,246106,01/01/2014 12:00:00 AM,96,231,202
Western,Giles County,51071,255,969,1224,336,2108,2444,25202,224917,250119,11/01/2013 12:00:00 AM,99,232,204
Western,Giles County,51071,256,927,1183,349,2059,2408,29979,247217,277196,06/01/2013 12:00:00 AM,117,267,234
Western,Giles County,51071,256,957,1213,338,2130,2468,28442,250302,278744,07/01/2013 12:00:00 AM,111,262,230
Western,Giles County,51071,257,948,1205,332,2098,2430,24985,228094,253079,03/01/2014 12:00:00 AM,97,241,210
Western,Giles County,51071,260,962,1222,351,2093,2444,29501,244257,273758,10/01/2013 12:00:00 AM,113,254,224
Western,Giles County,51071,261,959,1220,346,2138,2484,29129,254199,283328,09/01/2013 12:00:00 AM,112,265,232
Western,Giles County,51071,262,938,1200,358,2100,2458,31638,252767,284405,05/01/2013 12:00:00 AM,121,269,237
Western,Giles County,51071,262,963,1225,342,2125,2467,28259,249362,277621,08/01/2013 12:00:00 AM,108,259,227
Western,Grayson County,51077,156,917,1073,185,1974,2159,13379,208216,221595,07/01/2019 12:00:00 AM,86,227,207
Western,Grayson County,51077,157,879,1036,185,1918,2103,13192,201180,214372,02/01/2019 12:00:00 AM,84,229,207
Western,Grayson County,51077,159,934,1093,196,1973,2169,14795,209192,223987,10/01/2019 12:00:00 AM,93,224,205
Western,Grayson County,51077,159,935,1094,197,1939,2136,14199,207636,221835,02/01/2020 12:00:00 AM,89,222,203
Western,Grayson County,51077,159,945,1104,195,1970,2165,36471,341002,377473,03/01/2020 12:00:00 AM,229,361,342
Western,Grayson County,51077,160,915,1075,188,1991,2179,13419,207950,221369,06/01/2019 12:00:00 AM,84,227,206
Western,Grayson County,51077,160,918,1078,194,2001,2195,14623,206617,221240,04/01/2019 12:00:00 AM,91,225,205
Western,Grayson County,51077,160,924,1084,197,1977,2174,14815,208884,223699,08/01/2019 12:00:00 AM,93,226,206
Western,Grayson County,51077,160,935,1095,198,1973,2171,15473,212136,227609,11/01/2019 12:00:00 AM,97,227,208
Western,Grayson County,51077,161,888,1049,192,1936,2128,15134,210883,226017,01/01/2019 12:00:00 AM,94,237,215
Western,Grayson County,51077,161,939,1100,200,1947,2147,14763,204631,219394,01/01/2020 12:00:00 AM,92,218,199
Western,Grayson County,51077,161,940,1101,197,2017,2214,15045,213463,228508,09/01/2019 12:00:00 AM,93,227,208
Western,Grayson County,51077,161,943,1104,197,1977,2174,15509,213004,228513,12/01/2019 12:00:00 AM,96,226,207
Western,Grayson County,51077,162,921,1083,197,1987,2184,15194,204300,219494,05/01/2019 12:00:00 AM,94,222,203
Western,Grayson County,51077,163,914,1077,196,1985,2181,14766,206094,220860,03/01/2019 12:00:00 AM,91,225,205
Western,Grayson County,51077,163,942,1105,188,2106,2294,13865,223676,237541,12/01/2017 12:00:00 AM,85,237,215
Western,Grayson County,51077,164,890,1054,200,1952,2152,16131,206047,222178,11/01/2018 12:00:00 AM,98,232,211
Western,Grayson County,51077,164,890,1054,202,1951,2153,16354,208578,224932,10/01/2018 12:00:00 AM,100,234,213
Western,Grayson County,51077,164,895,1059,199,1971,2170,16133,204633,220766,09/01/2018 12:00:00 AM,98,229,208
Western,Grayson County,51077,164,952,1116,190,2121,2311,14417,226093,240510,11/01/2017 12:00:00 AM,88,237,216
Western,Grayson County,51077,165,901,1066,201,1979,2180,16379,215710,232089,12/01/2018 12:00:00 AM,99,239,218
Western,Grayson County,51077,165,941,1106,189,2086,2275,13694,222126,235820,03/01/2018 12:00:00 AM,83,236,213
Western,Grayson County,51077,166,908,1074,198,1997,2195,15103,212364,227467,08/01/2018 12:00:00 AM,91,234,212
Western,Grayson County,51077,166,939,1105,196,2119,2315,14417,233858,248275,05/01/2017 12:00:00 AM,87,249,225
Western,Grayson County,51077,166,950,1116,195,2108,2303,13996,231708,245704,04/01/2017 12:00:00 AM,84,244,220
Western,Grayson County,51077,167,1008,1175,197,2261,2458,14085,239643,253728,01/01/2017 12:00:00 AM,84,238,216
Western,Grayson County,51077,167,911,1078,190,1990,2180,12885,209234,222119,06/01/2018 12:00:00 AM,77,230,206
Western,Grayson County,51077,167,916,1083,187,2013,2200,13615,214630,228245,05/01/2018 12:00:00 AM,82,234,211
Western,Grayson County,51077,167,921,1088,190,2042,2232,13430,221058,234488,02/01/2018 12:00:00 AM,80,240,216
Western,Grayson County,51077,167,980,1147,198,2210,2408,14815,244112,258927,03/01/2017 12:00:00 AM,89,249,226
Western,Grayson County,51077,168,1013,1181,200,2278,2478,14378,240666,255044,12/01/2016 12:00:00 AM,86,238,216
Western,Grayson County,51077,168,916,1084,194,2014,2208,14964,210690,225654,07/01/2018 12:00:00 AM,89,230,208
Western,Grayson County,51077,168,931,1099,191,2067,2258,13895,220408,234303,04/01/2018 12:00:00 AM,83,237,213
Western,Grayson County,51077,168,951,1119,198,2134,2332,14409,235930,250339,06/01/2017 12:00:00 AM,86,248,224
Western,Grayson County,51077,168,999,1167,207,2061,2268,39209,355548,394757,06/01/2020 12:00:00 AM,233,356,338
Western,Grayson County,51077,169,1001,1170,207,2082,2289,38903,359184,398087,07/01/2020 12:00:00 AM,230,359,340
Western,Grayson County,51077,169,946,1115,191,2090,2281,13131,225510,238641,01/01/2018 12:00:00 AM,78,238,214
Western,Grayson County,51077,169,971,1140,210,2030,2240,39034,350116,389150,04/01/2020 12:00:00 AM,231,361,341
Western,Grayson County,51077,169,985,1154,211,2036,2247,39661,353240,392901,05/01/2020 12:00:00 AM,235,359,340
Western,Grayson County,51077,169,989,1158,198,2222,2420,15866,237872,253738,02/01/2017 12:00:00 AM,94,241,219
Western,Grayson County,51077,170,946,1116,195,2102,2297,14229,224716,238945,10/01/2017 12:00:00 AM,84,238,214
Western,Grayson County,51077,170,952,1122,201,2119,2320,14865,229100,243965,09/01/2017 12:00:00 AM,87,241,217
Western,Grayson County,51077,171,1007,1178,211,2072,2283,39362,359821,399183,08/01/2020 12:00:00 AM,230,357,339
Western,Grayson County,51077,172,1026,1198,214,2328,2542,15771,245212,260983,05/01/2016 12:00:00 AM,92,239,218
Western,Grayson County,51077,172,942,1114,201,2105,2306,14957,231681,246638,07/01/2017 12:00:00 AM,87,246,221
Western,Grayson County,51077,174,1064,1238,216,2395,2611,16113,259095,275208,04/01/2016 12:00:00 AM,93,244,222
Western,Grayson County,51077,174,946,1120,209,2124,2333,15585,227541,243126,08/01/2017 12:00:00 AM,90,241,217
Western,Grayson County,51077,175,1007,1182,204,2266,2470,14536,240145,254681,11/01/2016 12:00:00 AM,83,238,215
Western,Grayson County,51077,176,1040,1216,211,2308,2519,14288,243007,257295,07/01/2016 12:00:00 AM,81,234,212
Western,Grayson County,51077,176,1041,1217,216,2333,2549,15543,246685,262228,06/01/2016 12:00:00 AM,88,237,215
Western,Grayson County,51077,176,1081,1257,218,2427,2645,16479,261503,277982,03/01/2016 12:00:00 AM,94,242,221
Western,Grayson County,51077,176,951,1127,222,1993,2215,43213,363917,407130,12/01/2020 12:00:00 AM,246,383,361
Western,Grayson County,51077,176,982,1158,217,2016,2233,40781,349850,390631,09/01/2020 12:00:00 AM,232,356,337
Western,Grayson County,51077,177,1117,1294,218,2510,2728,17209,265301,282510,12/01/2015 12:00:00 AM,97,238,218
Western,Grayson County,51077,177,928,1105,229,1918,2147,53260,430604,483864,05/01/2021 12:00:00 AM,301,464,438
Western,Grayson County,51077,177,950,1127,230,1969,2199,53068,445785,498853,04/01/2021 12:00:00 AM,300,469,443
Western,Grayson County,51077,178,1023,1201,211,2302,2513,14819,240706,255525,10/01/2016 12:00:00 AM,83,235,213
Western,Grayson County,51077,178,939,1117,235,1962,2197,53221,407882,461103,01/01/2021 12:00:00 AM,299,434,413
Western,Grayson County,51077,178,959,1137,231,2006,2237,52472,419697,472169,03/01/2021 12:00:00 AM,295,438,415
Western,Grayson County,51077,178,963,1141,224,1997,2221,43797,356475,400272,10/01/2020 12:00:00 AM,246,370,351
Western,Grayson County,51077,179,953,1132,232,2006,2238,52350,422569,474919,02/01/2021 12:00:00 AM,292,443,420
Western,Grayson County,51077,179,955,1134,225,1987,2212,44420,369001,413421,11/01/2020 12:00:00 AM,248,386,365
Western,Grayson County,51077,180,1088,1268,228,2454,2682,17686,269240,286926,09/01/2015 12:00:00 AM,98,247,226
Western,Grayson County,51077,180,1095,1275,223,2453,2676,16850,263251,280101,02/01/2016 12:00:00 AM,94,240,220
Western,Grayson County,51077,180,1137,1317,228,2557,2785,17420,281658,299078,11/01/2014 12:00:00 AM,97,248,227
Western,Grayson County,51077,180,937,1117,242,1923,2165,55877,430270,486147,06/01/2021 12:00:00 AM,310,459,435
Western,Grayson County,51077,182,1024,1206,219,2284,2503,15248,239555,254803,08/01/2016 12:00:00 AM,84,234,211
Western,Grayson County,51077,182,1104,1286,225,2492,2717,16789,269388,286177,11/01/2015 12:00:00 AM,92,244,223
Western,Grayson County,51077,182,1104,1286,227,2468,2695,17383,261680,279063,01/01/2016 12:00:00 AM,96,237,217
Western,Grayson County,51077,184,1013,1197,224,2274,2498,16129,240353,256482,09/01/2016 12:00:00 AM,88,237,214
Western,Grayson County,51077,184,1106,1290,229,2514,2743,17361,275677,293038,02/01/2015 12:00:00 AM,94,249,227
Western,Grayson County,51077,184,1129,1313,228,2578,2806,16912,281257,298169,01/01/2015 12:00:00 AM,92,249,227
Western,Grayson County,51077,186,1069,1255,240,2411,2651,18500,267932,286432,07/01/2015 12:00:00 AM,99,251,228
Western,Grayson County,51077,187,1077,1264,238,2423,2661,18147,267890,286037,08/01/2015 12:00:00 AM,97,249,226
Western,Grayson County,51077,187,1079,1266,249,2420,2669,19680,266645,286325,04/01/2015 12:00:00 AM,105,247,226
Western,Grayson County,51077,187,1086,1273,245,2441,2686,19635,266267,285902,03/01/2015 12:00:00 AM,105,245,225
Western,Grayson County,51077,187,1102,1289,233,2478,2711,17738,271072,288810,10/01/2015 12:00:00 AM,95,246,224
Western,Grayson County,51077,188,1067,1255,249,2412,2661,20266,271926,292192,06/01/2015 12:00:00 AM,108,255,233
Western,Grayson County,51077,189,1137,1326,240,2567,2807,18765,282229,300994,12/01/2014 12:00:00 AM,99,248,227
Western,Grayson County,51077,190,1070,1260,255,2411,2666,20781,267354,288135,05/01/2015 12:00:00 AM,109,250,229
Western,Grayson County,51077,191,1119,1310,266,2502,2768,22550,274845,297395,10/01/2014 12:00:00 AM,118,246,227
Western,Grayson County,51077,195,1107,1302,262,2479,2741,19688,262740,282428,09/01/2014 12:00:00 AM,101,237,217
Western,Grayson County,51077,195,1130,1325,248,2554,2802,18504,272098,290602,08/01/2014 12:00:00 AM,95,241,219
Western,Grayson County,51077,195,1166,1361,243,2639,2882,17403,289670,307073,12/01/2013 12:00:00 AM,89,248,226
Western,Grayson County,51077,198,1177,1375,249,2647,2896,17029,291523,308552,01/01/2014 12:00:00 AM,86,248,224
Western,Grayson County,51077,199,1184,1383,253,2692,2945,18727,298153,316880,11/01/2013 12:00:00 AM,94,252,229
Western,Grayson County,51077,201,1149,1350,260,2595,2855,19800,281723,301523,04/01/2014 12:00:00 AM,99,245,223
Western,Grayson County,51077,203,1129,1332,255,2542,2797,18480,271350,289830,07/01/2014 12:00:00 AM,91,240,218
Western,Grayson County,51077,203,1170,1373,264,2648,2912,19459,288796,308255,03/01/2014 12:00:00 AM,96,247,225
Western,Grayson County,51077,203,1177,1380,255,2666,2921,17479,291935,309414,02/01/2014 12:00:00 AM,86,248,224
Western,Grayson County,51077,204,1173,1377,264,2646,2910,22749,315812,338561,10/01/2013 12:00:00 AM,112,269,246
Western,Grayson County,51077,207,1153,1360,263,2633,2896,19333,284940,304273,05/01/2014 12:00:00 AM,93,247,224
Western,Grayson County,51077,209,1128,1337,264,2571,2835,19215,276635,295850,06/01/2014 12:00:00 AM,92,245,221
Western,Grayson County,51077,209,1182,1391,276,2664,2940,24646,320218,344864,09/01/2013 12:00:00 AM,118,271,248
Western,Grayson County,51077,212,1186,1398,283,2627,2910,26177,321569,347746,06/01/2013 12:00:00 AM,123,271,249
Western,Grayson County,51077,212,1196,1408,278,2696,2974,25316,324847,350163,08/01/2013 12:00:00 AM,119,272,249
Western,Grayson County,51077,213,1179,1392,288,2642,2930,27217,323038,350255,07/01/2013 12:00:00 AM,128,274,252
Western,Grayson County,51077,217,1202,1419,294,2631,2925,27603,322211,349814,05/01/2013 12:00:00 AM,127,268,247
Western,Grayson County,51077,223,1210,1433,305,2639,2944,29057,320055,349112,04/01/2013 12:00:00 AM,130,265,244
Western,Grayson County,51077,231,1200,1431,313,2630,2943,28528,317407,345935,03/01/2013 12:00:00 AM,123,265,242
Western,Grayson County,51077,233,1149,1382,317,2547,2864,29891,302531,332422,06/01/2012 12:00:00 AM,128,263,241
Western,Grayson County,51077,235,1139,1374,330,2501,2831,31732,296137,327869,07/01/2012 12:00:00 AM,135,260,239
Western,Grayson County,51077,235,1206,1441,319,2662,2981,28564,320258,348822,02/01/2013 12:00:00 AM,122,266,242
Western,Grayson County,51077,236,1135,1371,327,2542,2869,31287,299612,330899,03/01/2012 12:00:00 AM,133,264,241
Western,Grayson County,51077,236,1140,1376,327,2548,2875,31233,301505,332738,04/01/2012 12:00:00 AM,132,264,242
Western,Grayson County,51077,236,1178,1414,331,2602,2933,31026,309898,340924,11/01/2012 12:00:00 AM,131,263,241
Western,Grayson County,51077,237,1140,1377,321,2552,2873,30628,302817,333445,05/01/2012 12:00:00 AM,129,266,242
Western,Grayson County,51077,238,1194,1432,333,2628,2961,31349,312359,343708,12/01/2012 12:00:00 AM,132,262,240
Western,Grayson County,51077,239,1145,1384,339,2534,2873,32231,297846,330077,08/01/2012 12:00:00 AM,135,260,238
Western,Grayson County,51077,240,1131,1371,329,2528,2857,31508,292709,324217,01/01/2012 12:00:00 AM,131,259,236
Western,Grayson County,51077,241,1171,1412,343,2600,2943,33771,304150,337921,10/01/2012 12:00:00 AM,140,260,239
Western,Grayson County,51077,241,1199,1440,333,2646,2979,30353,315705,346058,01/01/2013 12:00:00 AM,126,263,240
Western,Grayson County,51077,242,1142,1384,342,2531,2873,33356,298613,331969,09/01/2012 12:00:00 AM,138,261,240
Western,Grayson County,51077,243,1116,1359,344,2497,2841,33649,294112,327761,02/01/2012 12:00:00 AM,138,264,241
Western,Lee County,51105,1002,2161,3163,1540,4679,6219,146831,566049,712880,02/01/2012 12:00:00 AM,147,262,225
Western,Lee County,51105,1005,2371,3376,1569,5028,6597,140690,561485,702175,03/01/2014 12:00:00 AM,140,237,208
Western,Lee County,51105,1006,2158,3164,1550,4671,6221,146984,561525,708509,01/01/2012 12:00:00 AM,146,260,224
Western,Lee County,51105,1006,2375,3381,1571,5039,6610,138095,551142,689237,01/01/2014 12:00:00 AM,137,232,204
Western,Lee County,51105,1007,2145,3152,1553,4644,6197,146397,558231,704628,04/01/2012 12:00:00 AM,145,260,224
Western,Lee County,51105,1007,2337,3344,1567,4967,6534,139942,552549,692491,12/01/2013 12:00:00 AM,139,236,207
Western,Lee County,51105,1010,2342,3352,1569,4978,6547,137954,558613,696567,11/01/2013 12:00:00 AM,137,239,208
Western,Lee County,51105,1011,2159,3170,1547,4681,6228,145602,560575,706177,05/01/2012 12:00:00 AM,144,260,223
Western,Lee County,51105,1011,2181,3192,1541,4724,6265,145360,562022,707382,07/01/2012 12:00:00 AM,144,258,222
Western,Lee County,51105,1013,2307,3320,1568,4943,6511,154649,597312,751961,10/01/2013 12:00:00 AM,153,259,226
Western,Lee County,51105,1016,2142,3158,1564,4648,6212,149164,558601,707765,03/01/2012 12:00:00 AM,147,261,224
Western,Lee County,51105,1016,2155,3171,1554,4673,6227,147515,560011,707526,06/01/2012 12:00:00 AM,145,260,223
Western,Lee County,51105,1016,2367,3383,1587,5040,6627,143879,563044,706923,02/01/2014 12:00:00 AM,142,238,209
Western,Lee County,51105,1018,2332,3350,1574,4994,6568,152830,599491,752321,09/01/2013 12:00:00 AM,150,257,225
Western,Lee County,51105,1021,2308,3329,1588,4992,6580,153609,603420,757029,07/01/2013 12:00:00 AM,150,261,227
Western,Lee County,51105,1024,2186,3210,1558,4698,6256,149265,561364,710629,08/01/2012 12:00:00 AM,146,257,221
Western,Lee County,51105,1030,2194,3224,1564,4741,6305,149882,565125,715007,09/01/2012 12:00:00 AM,146,258,222
Western,Lee County,51105,1031,2308,3339,1604,4968,6572,155501,602503,758004,08/01/2013 12:00:00 AM,151,261,227
Western,Lee County,51105,1036,2296,3332,1614,4919,6533,158127,596261,754388,06/01/2013 12:00:00 AM,153,260,226
Western,Lee County,51105,1042,2285,3327,1613,4848,6461,158264,590761,749025,04/01/2013 12:00:00 AM,152,259,225
Western,Lee County,51105,1044,2219,3263,1587,4783,6370,153354,568343,721697,10/01/2012 12:00:00 AM,147,256,221
Western,Lee County,51105,1044,2291,3335,1616,4876,6492,158185,594612,752797,05/01/2013 12:00:00 AM,152,260,226
Western,Lee County,51105,1046,2286,3332,1620,4838,6458,158978,587428,746406,03/01/2013 12:00:00 AM,152,257,224
Western,Lee County,51105,1050,2266,3316,1631,4803,6434,159269,576845,736114,02/01/2013 12:00:00 AM,152,255,222
Western,Lee County,51105,1054,2275,3329,1631,4820,6451,157960,571500,729460,01/01/2013 12:00:00 AM,150,251,219
Western,Lee County,51105,1055,2225,3280,1632,4780,6412,160321,573915,734236,11/01/2012 12:00:00 AM,152,258,224
Western,Lee County,51105,1057,2232,3289,1646,4780,6426,163664,574488,738152,12/01/2012 12:00:00 AM,155,257,224
Western,Lee County,51105,698,2091,2789,970,4359,5329,73103,513748,586851,07/01/2019 12:00:00 AM,105,246,210
Western,Lee County,51105,700,2077,2777,977,4323,5300,74755,504755,579510,08/01/2019 12:00:00 AM,107,243,209
Western,Lee County,51105,704,2058,2762,983,4324,5307,75659,496452,572111,05/01/2019 12:00:00 AM,107,241,207
Western,Lee County,51105,704,2108,2812,973,4374,5347,79380,516373,595753,10/01/2019 12:00:00 AM,113,245,212
Western,Lee County,51105,706,2088,2794,982,4345,5327,76263,504058,580321,09/01/2019 12:00:00 AM,108,241,208
Western,Lee County,51105,709,2080,2789,989,4332,5321,80312,502461,582773,11/01/2019 12:00:00 AM,113,242,209
Western,Lee County,51105,712,2081,2793,990,4364,5354,74848,502713,577561,06/01/2019 12:00:00 AM,105,242,207
Western,Lee County,51105,713,2118,2831,1004,4391,5395,83689,509950,593639,12/01/2019 12:00:00 AM,117,241,210
Western,Lee County,51105,718,2067,2785,1001,4284,5285,77981,506382,584363,02/01/2020 12:00:00 AM,109,245,210
Western,Lee County,51105,718,2077,2795,996,4318,5314,77902,500575,578477,01/01/2020 12:00:00 AM,108,241,207
Western,Lee County,51105,720,2069,2789,1006,4269,5275,183769,730724,914493,03/01/2020 12:00:00 AM,255,353,328
Western,Lee County,51105,721,2016,2737,1011,4247,5258,80492,493283,573775,02/01/2019 12:00:00 AM,112,245,210
Western,Lee County,51105,721,2076,2797,1013,4329,5342,80411,505053,585464,04/01/2019 12:00:00 AM,112,243,209
Western,Lee County,51105,732,2082,2814,1033,4356,5389,83885,503495,587380,03/01/2019 12:00:00 AM,115,242,209
Western,Lee County,51105,734,2167,2901,1031,4490,5521,187771,778717,966488,04/01/2020 12:00:00 AM,256,359,333
Western,Lee County,51105,736,2078,2814,1022,4350,5372,85446,511667,597113,11/01/2018 12:00:00 AM,116,246,212
Western,Lee County,51105,736,2079,2815,1031,4429,5460,84990,530862,615852,01/01/2019 12:00:00 AM,115,255,219
Western,Lee County,51105,736,2194,2930,1035,4556,5591,190053,790545,980598,05/01/2020 12:00:00 AM,258,360,335
Western,Lee County,51105,736,2197,2933,1031,4535,5566,188804,781177,969981,06/01/2020 12:00:00 AM,257,356,331
Western,Lee County,51105,737,2076,2813,1030,4356,5386,87310,516900,604210,12/01/2018 12:00:00 AM,118,249,215
Western,Lee County,51105,737,2106,2843,1029,4400,5429,86808,505643,592451,09/01/2018 12:00:00 AM,118,240,208
Western,Lee County,51105,738,2117,2855,1026,4422,5448,86107,515720,601827,10/01/2018 12:00:00 AM,117,244,211
Western,Lee County,51105,747,2238,2985,1046,4617,5663,191011,800029,991040,07/01/2020 12:00:00 AM,256,357,332
Western,Lee County,51105,751,2108,2859,1050,4433,5483,85677,507747,593424,06/01/2018 12:00:00 AM,114,241,208
Western,Lee County,51105,753,2100,2853,1061,4434,5495,88469,516879,605348,08/01/2018 12:00:00 AM,117,246,212
Western,Lee County,51105,755,2149,2904,1030,4426,5456,227391,920426,1147817,03/01/2021 12:00:00 AM,301,428,395
Western,Lee County,51105,756,2142,2898,1037,4411,5448,229098,937987,1167085,02/01/2021 12:00:00 AM,303,438,403
Western,Lee County,51105,756,2166,2922,1055,4485,5540,202573,805353,1007926,10/01/2020 12:00:00 AM,268,372,345
Western,Lee County,51105,756,2219,2975,1058,4566,5624,193626,790272.7,983898.7,08/01/2020 12:00:00 AM,256,356,331
Western,Lee County,51105,757,2095,2852,1039,4300,5339,237769,980611,1218380,05/01/2021 12:00:00 AM,314,468,427
Western,Lee County,51105,757,2124,2881,1042,4330,5372,237587,993978,1231565,04/01/2021 12:00:00 AM,314,468,427
Western,Lee County,51105,759,2124,2883,1060,4466,5526,87625,516541,604166,07/01/2018 12:00:00 AM,115,243,210
Western,Lee County,51105,759,2197,2956,1058,4512,5570,194073,783353,977426,09/01/2020 12:00:00 AM,256,357,331
Western,Lee County,51105,762,2088,2850,1075,4422,5497,87715,510895,598610,05/01/2018 12:00:00 AM,115,245,210
Western,Lee County,51105,763,2149,2912,1082,4424,5506,209427,819181,1028608,11/01/2020 12:00:00 AM,274,381,353
Western,Lee County,51105,765,2148,2913,1082,4397,5479,209464,805964,1015428,12/01/2020 12:00:00 AM,274,375,349
Western,Lee County,51105,768,2083,2851,1077,4433,5510,87772,513017,600789,04/01/2018 12:00:00 AM,114,246,211
Western,Lee County,51105,768,2136,2904,1081,4405,5486,238373,930941,1169314,01/01/2021 12:00:00 AM,310,436,403
Western,Lee County,51105,769,2063,2832,1085,4375,5460,89445,511102,600547,03/01/2018 12:00:00 AM,116,248,212
Western,Lee County,51105,769,2085,2854,1058,4274,5332,244343,976275,1220618,06/01/2021 12:00:00 AM,318,468,428
Western,Lee County,51105,785,2077,2862,1105,4408,5513,91873,517712,609585,02/01/2018 12:00:00 AM,117,249,213
Western,Lee County,51105,795,2102,2897,1111,4458,5569,92332,523947,616279,01/01/2018 12:00:00 AM,116,249,213
Western,Lee County,51105,795,2113,2908,1098,4530,5628,95732,525264,620996,10/01/2017 12:00:00 AM,120,249,214
Western,Lee County,51105,796,2123,2919,1116,4536,5652,95344,533499,628843,05/01/2017 12:00:00 AM,120,251,215
Western,Lee County,51105,798,2109,2907,1101,4507,5608,96060,527251,623311,11/01/2017 12:00:00 AM,120,250,214
Western,Lee County,51105,800,2126,2926,1111,4577,5688,93278,530679,623957,09/01/2017 12:00:00 AM,117,250,213
Western,Lee County,51105,802,2104,2906,1115,4465,5580,97395,526258,623653,12/01/2017 12:00:00 AM,121,250,215
Western,Lee County,51105,802,2120,2922,1110,4550,5660,94557,534107,628664,07/01/2017 12:00:00 AM,118,252,215
Western,Lee County,51105,803,2125,2928,1119,4581,5700,96404,535920,632324,08/01/2017 12:00:00 AM,120,252,216
Western,Lee County,51105,806,2118,2924,1123,4531,5654,95019,535617,630636,06/01/2017 12:00:00 AM,118,253,216
Western,Lee County,51105,814,2122,2936,1149,4531,5680,98865,534886,633751,04/01/2017 12:00:00 AM,121,252,216
Western,Lee County,51105,814,2158,2972,1143,4626,5769,97548,541902,639450,03/01/2017 12:00:00 AM,120,251,215
Western,Lee County,51105,833,2203,3036,1191,4826,6017,104320,556140,660460,12/01/2016 12:00:00 AM,125,252,218
Western,Lee County,51105,840,2185,3025,1185,4705,5890,102543,547292,649835,02/01/2017 12:00:00 AM,122,250,215
Western,Lee County,51105,843,2193,3036,1229,4805,6034,108877,553585,662462,10/01/2016 12:00:00 AM,129,252,218
Western,Lee County,51105,843,2195,3038,1196,4751,5947,104401,545811.22,650212.22,01/01/2017 12:00:00 AM,124,249,214
Western,Lee County,51105,849,2188,3037,1216,4816,6032,106987,554657,661644,11/01/2016 12:00:00 AM,126,253,218
Western,Lee County,51105,854,2184,3038,1251,4776,6027,112147,549843,661990,09/01/2016 12:00:00 AM,131,252,218
Western,Lee County,51105,861,2188,3049,1299,4778,6077,120344,546935,667279,07/01/2016 12:00:00 AM,140,250,219
Western,Lee County,51105,862,2192,3054,1287,4793,6080,117578,546537,664115,08/01/2016 12:00:00 AM,136,249,217
Western,Lee County,51105,872,2199,3071,1312,4774,6086,120402,546458,666860,03/01/2016 12:00:00 AM,138,249,217
Western,Lee County,51105,877,2178,3055,1313,4786,6099,119655,544363,664018,01/01/2016 12:00:00 AM,136,250,217
Western,Lee County,51105,877,2187,3064,1319,4807,6126,120126,544845,664971,05/01/2016 12:00:00 AM,137,249,217
Western,Lee County,51105,877,2191,3068,1334,4787,6121,123139,541713,664852,06/01/2016 12:00:00 AM,140,247,217
Western,Lee County,51105,880,2195,3075,1324,4777,6101,121413,546952,668365,04/01/2016 12:00:00 AM,138,249,217
Western,Lee County,51105,884,2180,3064,1322,4761,6083,120461,544541,665002,02/01/2016 12:00:00 AM,136,250,217
Western,Lee County,51105,887,2189,3076,1336,4796,6132,123088,547326,670414,12/01/2015 12:00:00 AM,139,250,218
Western,Lee County,51105,895,2039,2934,1320,4541,5861,118464,504835,623299,05/01/2015 12:00:00 AM,132,248,212
Western,Lee County,51105,896,2018,2914,1327,4473,5800,120221,501826,622047,04/01/2015 12:00:00 AM,134,249,213
Western,Lee County,51105,897,2032,2929,1327,4536,5863,120405,506670,627075,06/01/2015 12:00:00 AM,134,249,214
Western,Lee County,51105,897,2039,2936,1341,4487,5828,119207,498577,617784,03/01/2015 12:00:00 AM,133,245,210
Western,Lee County,51105,902,2052,2954,1352,4584,5936,125831,514228,640059,07/01/2015 12:00:00 AM,140,251,217
Western,Lee County,51105,902,2150,3052,1352,4743,6095,124299,538549,662848,10/01/2015 12:00:00 AM,138,250,217
Western,Lee County,51105,902,2169,3071,1358,4760,6118,124264,539904,664168,11/01/2015 12:00:00 AM,138,249,216
Western,Lee County,51105,903,2090,2993,1340,4674,6014,124255,526554,650809,08/01/2015 12:00:00 AM,138,252,217
Western,Lee County,51105,907,2029,2936,1364,4485,5849,124013,501427,625440,02/01/2015 12:00:00 AM,137,247,213
Western,Lee County,51105,910,2129,3039,1377,4713,6090,127933,531742,659675,09/01/2015 12:00:00 AM,141,250,217
Western,Lee County,51105,913,2084,2997,1368,4565,5933,123507,507881,631388,01/01/2015 12:00:00 AM,135,244,211
Western,Lee County,51105,917,2082,2999,1377,4574,5951,128222,508734,636956,12/01/2014 12:00:00 AM,140,244,212
Western,Lee County,51105,918,2072,2990,1373,4579,5952,125497,514892,640389,11/01/2014 12:00:00 AM,137,249,214
Western,Lee County,51105,925,2114,3039,1364,4671,6035,112660,506538,619198,09/01/2014 12:00:00 AM,122,240,204
Western,Lee County,51105,926,2099,3025,1390,4633,6023,129952,521772,651724,10/01/2014 12:00:00 AM,140,249,215
Western,Lee County,51105,932,2145,3077,1404,4676,6080,119574,511753,631327,08/01/2014 12:00:00 AM,128,239,205
Western,Lee County,51105,946,2200,3146,1433,4748,6181,121128,522944,644072,07/01/2014 12:00:00 AM,128,238,205
Western,Lee County,51105,970,2249,3219,1500,4808,6308,130256,536653,666909,06/01/2014 12:00:00 AM,134,239,207
Western,Lee County,51105,986,2289,3275,1534,4881,6415,138330,543039,681369,05/01/2014 12:00:00 AM,140,237,208
Western,Lee County,51105,996,2343,3339,1554,4970,6524,140433,555819,696252,04/01/2014 12:00:00 AM,141,237,209
Western,Montgomery County,51121,566,2237,2803,814,4808,5622,186163,1099924,1286087,05/01/2021 12:00:00 AM,329,492,459
Western,Montgomery County,51121,568,2240,2808,819,4826,5645,187270,1101279,1288549,06/01/2021 12:00:00 AM,330,492,459
Western,Montgomery County,51121,568,2512,3080,795,5789,6584,77885,667692,745577,05/01/2016 12:00:00 AM,137,266,242
Western,Montgomery County,51121,570,2269,2839,821,5197,6018,83518,617963,701481,04/01/2017 12:00:00 AM,147,272,247
Western,Montgomery County,51121,572,2229,2801,822,4865,5687,180770,1025087,1205857,02/01/2021 12:00:00 AM,316,460,431
Western,Montgomery County,51121,572,2383,2955,809,5470,6279,77809,626968,704777,02/01/2017 12:00:00 AM,136,263,239
Western,Montgomery County,51121,573,2262,2835,829,4859,5688,188592,1113209,1301801,04/01/2021 12:00:00 AM,329,492,459
Western,Montgomery County,51121,573,2316,2889,820,5292,6112,78728,621354.62,700082.62,03/01/2017 12:00:00 AM,137,268,242
Western,Montgomery County,51121,575,2283,2858,837,5212,6049,82453,614957,697410,05/01/2017 12:00:00 AM,143,269,244
Western,Montgomery County,51121,576,2377,2953,824,5512,6336,78332,633522,711854,12/01/2016 12:00:00 AM,136,267,241
Western,Montgomery County,51121,577,2482,3059,822,5729,6551,81494,660198,741692,06/01/2016 12:00:00 AM,141,266,242
Western,Montgomery County,51121,578,1967,2545,845,4424,5269,79709,505185,584894,10/01/2019 12:00:00 AM,138,257,230
Western,Montgomery County,51121,580,2372,2952,829,5461,6290,80928,619653.32,700581.32,01/01/2017 12:00:00 AM,140,261,237
Western,Montgomery County,51121,581,2519,3100,819,5803,6622,79726,670327,750053,04/01/2016 12:00:00 AM,137,266,242
Western,Montgomery County,51121,582,2252,2834,834,4860,5694,181637,1017962,1199599,03/01/2021 12:00:00 AM,312,452,423
Western,Montgomery County,51121,584,2474,3058,827,5714,6541,81814,662670,744484,08/01/2016 12:00:00 AM,140,268,243
Western,Montgomery County,51121,584,2578,3162,834,5906,6740,83013,693528,776541,06/01/2015 12:00:00 AM,142,269,246
Western,Montgomery County,51121,585,2401,2986,861,5569,6430,83161,639225,722386,11/01/2016 12:00:00 AM,142,266,242
Western,Montgomery County,51121,585,2549,3134,848,5813,6661,83330,674874,758204,12/01/2015 12:00:00 AM,142,265,242
Western,Montgomery County,51121,587,2431,3018,861,5644,6505,85681,655530,741211,10/01/2016 12:00:00 AM,146,270,246
Western,Montgomery County,51121,587,2440,3027,836,5633,6469,83254,654625,737879,07/01/2016 12:00:00 AM,142,268,244
Western,Montgomery County,51121,587,2523,3110,837,5776,6613,80491,666840,747331,03/01/2016 12:00:00 AM,137,264,240
Western,Montgomery County,51121,588,2201,2789,857,4838,5695,192294,1008729,1201023,01/01/2021 12:00:00 AM,327,458,431
Western,Montgomery County,51121,588,2574,3162,854,5868,6722,86602,688087,774689,07/01/2015 12:00:00 AM,147,267,245
Western,Montgomery County,51121,588,2590,3178,844,5933,6777,85046,697705,782751,05/01/2015 12:00:00 AM,145,269,246
Western,Montgomery County,51121,588,2625,3213,851,6004,6855,85975,700104,786079,04/01/2015 12:00:00 AM,146,267,245
Western,Montgomery County,51121,589,2252,2841,872,5104,5976,86023,607043,693066,08/01/2017 12:00:00 AM,146,270,244
Western,Montgomery County,51121,590,2580,3170,873,5828,6701,88378,683580,771958,08/01/2015 12:00:00 AM,150,265,244
Western,Montgomery County,51121,591,2069,2660,835,4746,5581,83868,547406,631274,09/01/2018 12:00:00 AM,142,265,237
Western,Montgomery County,51121,592,2444,3036,854,5712,6566,86190,659100,745290,09/01/2016 12:00:00 AM,146,270,245
Western,Montgomery County,51121,592,2539,3131,862,5796,6658,85575,664675,750250,01/01/2016 12:00:00 AM,145,262,240
Western,Montgomery County,51121,593,1972,2565,863,4446,5309,80262,505312,585574,11/01/2019 12:00:00 AM,135,256,228
Western,Montgomery County,51121,593,1974,2567,847,4380,5227,153288,757834,911122,03/01/2020 12:00:00 AM,258,384,355
Western,Montgomery County,51121,593,2037,2630,850,4578,5428,84024,520568,604592,05/01/2019 12:00:00 AM,142,256,230
Western,Montgomery County,51121,593,2056,2649,824,4713,5537,83675,538531,622206,10/01/2018 12:00:00 AM,141,262,235
Western,Montgomery County,51121,593,2284,2877,872,5256,6128,87380,614369,701749,06/01/2017 12:00:00 AM,147,269,244
Western,Montgomery County,51121,593,2532,3125,855,5816,6671,83121,674752,757873,02/01/2016 12:00:00 AM,140,266,243
Western,Montgomery County,51121,594,2232,2826,880,5120,6000,87653,608745,696398,07/01/2017 12:00:00 AM,148,273,246
Western,Montgomery County,51121,594,2548,3142,876,5781,6657,84764,678606,763370,10/01/2015 12:00:00 AM,143,266,243
Western,Montgomery County,51121,594,2631,3225,844,5975,6819,84123,699958,784081,03/01/2015 12:00:00 AM,142,266,243
Western,Montgomery County,51121,595,2038,2633,856,4603,5459,85658,525222,610880,06/01/2019 12:00:00 AM,144,258,232
Western,Montgomery County,51121,595,2079,2674,841,4752,5593,84203,545978,630181,08/01/2018 12:00:00 AM,142,263,236
Western,Montgomery County,51121,595,2571,3166,889,5818,6707,89193,689106,778299,09/01/2015 12:00:00 AM,150,268,246
Western,Montgomery County,51121,597,1981,2578,836,4468,5304,82447,511671,594118,02/01/2019 12:00:00 AM,138,258,230
Western,Montgomery County,51121,597,2074,2671,854,4673,5527,83376,540683,624059,04/01/2019 12:00:00 AM,140,261,234
Western,Montgomery County,51121,597,2532,3129,879,5789,6668,86949,675430,762379,11/01/2015 12:00:00 AM,146,267,244
Western,Montgomery County,51121,598,2067,2665,855,4667,5522,82775,527344,610119,03/01/2019 12:00:00 AM,138,255,229
Western,Montgomery County,51121,599,2077,2676,874,4706,5580,85388,544379,629767,07/01/2018 12:00:00 AM,143,262,235
Western,Montgomery County,51121,600,1983,2583,886,4515,5401,88134,508961,597095,09/01/2019 12:00:00 AM,147,257,231
Western,Montgomery County,51121,600,2008,2608,861,4575,5436,83157,514323,597480,07/01/2019 12:00:00 AM,139,256,229
Western,Montgomery County,51121,600,2183,2783,874,4982,5856,85172,590459,675631,09/01/2017 12:00:00 AM,142,270,243
Western,Montgomery County,51121,601,2001,2602,869,4563,5432,85358,515401,600759,08/01/2019 12:00:00 AM,142,258,231
Western,Montgomery County,51121,601,2840,3441,881,6333,7214,81027,725862,806889,09/01/2014 12:00:00 AM,135,256,234
Western,Montgomery County,51121,602,1939,2541,866,4281,5147,76514,486798,563312,02/01/2020 12:00:00 AM,127,251,222
Western,Montgomery County,51121,603,2120,2723,868,4661,5529,158115,797825,955940,04/01/2020 12:00:00 AM,262,376,351
Western,Montgomery County,51121,603,2142,2745,882,4794,5676,86734,557704,644438,03/01/2018 12:00:00 AM,144,260,235
Western,Montgomery County,51121,603,2220,2823,877,4904,5781,168457,894605,1063062,12/01/2020 12:00:00 AM,279,403,377
Western,Montgomery County,51121,606,2626,3232,879,5936,6815,87796,693010,780806,02/01/2015 12:00:00 AM,145,264,242
Western,Montgomery County,51121,607,2149,2756,897,4850,5747,92569,565213,657782,10/01/2017 12:00:00 AM,153,263,239
Western,Montgomery County,51121,607,2729,3336,878,6154,7032,88508,728130,816638,10/01/2014 12:00:00 AM,146,267,245
Western,Montgomery County,51121,608,1933,2541,886,4330,5216,83210,497173,580383,12/01/2019 12:00:00 AM,137,257,228
Western,Montgomery County,51121,608,2069,2677,876,4704,5580,87779,553982,641761,01/01/2019 12:00:00 AM,144,268,240
Western,Montgomery County,51121,609,2210,2819,886,4877,5763,168186,900547,1068733,11/01/2020 12:00:00 AM,276,407,379
Western,Montgomery County,51121,609,2944,3553,900,6484,7384,85045,749080,834125,07/01/2014 12:00:00 AM,140,254,235
Western,Montgomery County,51121,610,2137,2747,903,4823,5726,93143,557699,650842,12/01/2017 12:00:00 AM,153,261,237
Western,Montgomery County,51121,610,2230,2840,884,4861,5745,161295,835404,996699,06/01/2020 12:00:00 AM,264,375,351
Western,Montgomery County,51121,611,2164,2775,909,4900,5809,94498,572658,667156,11/01/2017 12:00:00 AM,155,265,240
Western,Montgomery County,51121,612,2075,2687,898,4746,5644,87117,547008,634125,06/01/2018 12:00:00 AM,142,264,236
Western,Montgomery County,51121,612,2703,3315,893,6035,6928,91301,718993,810294,11/01/2014 12:00:00 AM,149,266,244
Western,Montgomery County,51121,613,2103,2716,909,4763,5672,89809,554948,644757,04/01/2018 12:00:00 AM,147,264,237
Western,Montgomery County,51121,613,2132,2745,911,4819,5730,92606,564628,657234,01/01/2018 12:00:00 AM,151,265,239
Western,Montgomery County,51121,613,2254,2867,886,4918,5804,159585,854797.53,1014382.53,07/01/2020 12:00:00 AM,260,379,354
Western,Montgomery County,51121,614,2061,2675,877,4735,5612,91567,547135,638702,11/01/2018 12:00:00 AM,149,265,239
Western,Montgomery County,51121,614,2110,2724,917,4722,5639,93317,549644,642961,02/01/2018 12:00:00 AM,152,260,236
Western,Montgomery County,51121,614,2203,2817,891,4804,5695,160856,834297,995153,05/01/2020 12:00:00 AM,262,379,353
Western,Montgomery County,51121,615,2038,2653,880,4641,5521,91172,530261,621433,12/01/2018 12:00:00 AM,148,260,234
Western,Montgomery County,51121,616,1946,2562,893,4279,5172,79765,485083,564848,01/01/2020 12:00:00 AM,129,249,220
Western,Montgomery County,51121,616,2075,2691,906,4684,5590,89463,537012,626475,05/01/2018 12:00:00 AM,145,259,233
Western,Montgomery County,51121,618,2873,3491,917,6348,7265,85980,732037,818017,08/01/2014 12:00:00 AM,139,255,234
Western,Montgomery County,51121,619,2216,2835,900,4878,5778,170179,889902,1060081,10/01/2020 12:00:00 AM,275,402,374
Western,Montgomery County,51121,620,2273,2893,911,4887,5798,163545,845623.15,1009168.15,08/01/2020 12:00:00 AM,264,372,349
Western,Montgomery County,51121,620,2664,3284,916,5980,6896,90090,693315,783405,01/01/2015 12:00:00 AM,145,260,239
Western,Montgomery County,51121,620,2667,3287,926,5977,6903,94063,701998,796061,12/01/2014 12:00:00 AM,152,263,242
Western,Montgomery County,51121,624,2236,2860,914,4879,5793,166134,841635,1007769,09/01/2020 12:00:00 AM,266,376,352
Western,Montgomery County,51121,630,2994,3624,955,6553,7508,92593,758871,851464,06/01/2014 12:00:00 AM,147,253,235
Western,Montgomery County,51121,631,3026,3657,969,6600,7569,91798,771304,863102,05/01/2014 12:00:00 AM,145,255,236
Western,Montgomery County,51121,631,3097,3728,984,6733,7717,90303,783300,873603,12/01/2013 12:00:00 AM,143,253,234
Western,Montgomery County,51121,634,3081,3715,988,6736,7724,94746,784689,879435,02/01/2014 12:00:00 AM,149,255,237
Western,Montgomery County,51121,636,3043,3679,978,6649,7627,95894,779624,875518,04/01/2014 12:00:00 AM,151,256,238
Western,Montgomery County,51121,636,3081,3717,996,6737,7733,92295,771848,864143,01/01/2014 12:00:00 AM,145,251,232
Western,Montgomery County,51121,636,3131,3767,987,6869,7856,98644,861936,960580,07/01/2013 12:00:00 AM,155,275,255
Western,Montgomery County,51121,637,3068,3705,1007,6690,7697,98431,779902,878333,03/01/2014 12:00:00 AM,155,254,237
Western,Montgomery County,51121,638,3097,3735,999,6774,7773,90089,788295,878384,11/01/2013 12:00:00 AM,141,255,235
Western,Montgomery County,51121,644,3118,3762,1000,6823,7823,101220,865680,966900,09/01/2013 12:00:00 AM,157,278,257
Western,Montgomery County,51121,644,3137,3781,992,6854,7846,99228,863982,963210,10/01/2013 12:00:00 AM,154,275,255
Western,Montgomery County,51121,651,3140,3791,1018,6878,7896,103692,868153,971845,08/01/2013 12:00:00 AM,159,276,256
Western,Montgomery County,51121,652,3107,3759,1025,6786,7811,102748,854940,957688,06/01/2013 12:00:00 AM,158,275,255
Western,Montgomery County,51121,659,3105,3764,1037,6782,7819,114021,852485,966506,03/01/2013 12:00:00 AM,173,275,257
Western,Montgomery County,51121,660,3115,3775,1035,6870,7905,111887,858884,970771,12/01/2012 12:00:00 AM,170,276,257
Western,Montgomery County,51121,661,3135,3796,1044,6965,8009,108135,874967,983102,10/01/2012 12:00:00 AM,164,279,259
Western,Montgomery County,51121,662,3101,3763,1053,6790,7843,113911,847971,961882,04/01/2013 12:00:00 AM,172,273,256
Western,Montgomery County,51121,665,3079,3744,1053,6753,7806,110041,846903,956944,05/01/2013 12:00:00 AM,165,275,256
Western,Montgomery County,51121,665,3105,3770,1061,6758,7819,117894,849015,966909,02/01/2013 12:00:00 AM,177,273,256
Western,Montgomery County,51121,667,3088,3755,1059,6779,7838,112562,845310,957872,01/01/2013 12:00:00 AM,169,274,255
Western,Montgomery County,51121,671,3141,3812,1062,6922,7984,114107,866899,981006,11/01/2012 12:00:00 AM,170,276,257
Western,Montgomery County,51121,675,3131,3806,1049,6960,8009,107871,886853,994724,07/01/2012 12:00:00 AM,160,283,261
Western,Montgomery County,51121,677,3112,3789,1072,6896,7968,113934,873584,987518,09/01/2012 12:00:00 AM,168,281,261
Western,Montgomery County,51121,680,3118,3798,1069,6910,7979,110870,874122,984992,08/01/2012 12:00:00 AM,163,280,259
Western,Montgomery County,51121,687,3115,3802,1082,6962,8044,111480,872915,984395,06/01/2012 12:00:00 AM,162,280,259
Western,Montgomery County,51121,691,3127,3818,1103,6967,8070,116169,867933,984102,05/01/2012 12:00:00 AM,168,278,258
Western,Montgomery County,51121,694,3152,3846,1129,7018,8147,119071,881515,1000586,04/01/2012 12:00:00 AM,172,280,260
Western,Montgomery County,51121,700,3134,3834,1151,6941,8092,121957,874201,996158,03/01/2012 12:00:00 AM,174,279,260
Western,Montgomery County,51121,714,3094,3808,1193,6867,8060,126367,869873,996240,02/01/2012 12:00:00 AM,177,281,262
Western,Montgomery County,51121,714,3103,3817,1186,6860,8046,125848,860750,986598,01/01/2012 12:00:00 AM,176,277,258
Western,Norton City,51720,129,367,496,169,739,908,11459,79486,90945,03/01/2019 12:00:00 AM,89,217,183
Western,Norton City,51720,129,405,534,157,806,963,36061,173283,209344,02/01/2021 12:00:00 AM,280,428,392
Western,Norton City,51720,131,350,481,166,729,895,11341,77024,88365,02/01/2018 12:00:00 AM,87,220,184
Western,Norton City,51720,131,355,486,166,736,902,10769,79187,89956,06/01/2019 12:00:00 AM,82,223,185
Western,Norton City,51720,131,364,495,168,742,910,11714,79489,91203,05/01/2019 12:00:00 AM,89,218,184
Western,Norton City,51720,131,370,501,168,753,921,10965,81108,92073,01/01/2018 12:00:00 AM,84,219,184
Western,Norton City,51720,132,359,491,176,728,904,14595,80019,94614,10/01/2018 12:00:00 AM,111,223,193
Western,Norton City,51720,132,364,496,171,742,913,11781,80580,92361,04/01/2019 12:00:00 AM,89,221,186
Western,Norton City,51720,132,364,496,172,744,916,13219,80874,94093,12/01/2018 12:00:00 AM,100,222,190
Western,Norton City,51720,132,406,538,164,815,979,36151,171179,207330,03/01/2021 12:00:00 AM,274,422,385
Western,Norton City,51720,133,342,475,173,688,861,12052,73209,85261,01/01/2020 12:00:00 AM,91,214,179
Western,Norton City,51720,134,352,486,171,738,909,10950,78049,88999,07/01/2019 12:00:00 AM,82,222,183
Western,Norton City,51720,134,363,497,176,742,918,13612,81932,95544,11/01/2018 12:00:00 AM,102,226,192
Western,Norton City,51720,135,338,473,178,701,879,12404,74694,87098,11/01/2019 12:00:00 AM,92,221,184
Western,Norton City,51720,135,342,477,175,700,875,12418,75934,88352,12/01/2019 12:00:00 AM,92,222,185
Western,Norton City,51720,135,346,481,176,719,895,11657,79318,90975,10/01/2019 12:00:00 AM,86,229,189
Western,Norton City,51720,135,347,482,181,699,880,12969,75437,88406,02/01/2019 12:00:00 AM,96,217,183
Western,Norton City,51720,135,362,497,178,750,928,11865,84771,96636,01/01/2019 12:00:00 AM,88,234,194
Western,Norton City,51720,135,397,532,168,811,979,39433,187699,227132,04/01/2021 12:00:00 AM,292,473,427
Western,Norton City,51720,136,353,489,173,733,906,10644,78288,88932,08/01/2019 12:00:00 AM,78,222,182
Western,Norton City,51720,136,360,496,177,733,910,13579,78920,92499,03/01/2018 12:00:00 AM,100,219,186
Western,Norton City,51720,136,364,500,180,723,903,13791,79332,93123,08/01/2018 12:00:00 AM,101,218,186
Western,Norton City,51720,136,365,501,177,741,918,13976,80898,94874,09/01/2018 12:00:00 AM,103,222,189
Western,Norton City,51720,137,344,481,182,682,864,12591,71504,84095,02/01/2020 12:00:00 AM,92,208,175
Western,Norton City,51720,137,353,490,180,715,895,13847,75166,89013,05/01/2018 12:00:00 AM,101,213,182
Western,Norton City,51720,137,354,491,175,716,891,13356,74750,88106,04/01/2018 12:00:00 AM,97,211,179
Western,Norton City,51720,137,365,502,180,750,930,12591,82495,95086,12/01/2017 12:00:00 AM,92,226,189
Western,Norton City,51720,137,367,504,175,737,912,13782,80982,94764,07/01/2018 12:00:00 AM,101,221,188
Western,Norton City,51720,137,397,534,181,813,994,33638,142174,175812,06/01/2020 12:00:00 AM,246,358,329
Western,Norton City,51720,138,352,490,177,738,915,10998,78336,89334,09/01/2019 12:00:00 AM,80,223,182
Western,Norton City,51720,138,361,499,182,730,912,14389,78557,92946,06/01/2018 12:00:00 AM,104,218,186
Western,Norton City,51720,138,379,517,188,794,982,14810,88986,103796,07/01/2017 12:00:00 AM,107,235,201
Western,Norton City,51720,138,382,520,181,746,927,33498,130621,164119,04/01/2020 12:00:00 AM,243,342,316
Western,Norton City,51720,138,392,530,182,780,962,33634,135770,169404,05/01/2020 12:00:00 AM,244,346,320
Western,Norton City,51720,138,399,537,177,794,971,35726,149838,185564,11/01/2020 12:00:00 AM,259,376,346
Western,Norton City,51720,139,400,539,174,805,979,40338,179035,219373,05/01/2021 12:00:00 AM,290,448,407
Western,Norton City,51720,139,400,539,181,805,986,40612,166556,207168,01/01/2021 12:00:00 AM,292,416,384
Western,Norton City,51720,140,350,490,187,689,876,34306,119753,154059,03/01/2020 12:00:00 AM,245,342,314
Western,Norton City,51720,140,379,519,189,773,962,14837,83830,98667,10/01/2017 12:00:00 AM,106,221,190
Western,Norton City,51720,140,393,533,185,806,991,35125,142596,177721,09/01/2020 12:00:00 AM,251,363,333
Western,Norton City,51720,140,399,539,187,808,995,34276,139745,174021,07/01/2020 12:00:00 AM,245,350,323
Western,Norton City,51720,140,401,541,181,797,978,35939,145611,181550,12/01/2020 12:00:00 AM,257,363,336
Western,Norton City,51720,140,406,546,173,810,983,40224,185714,225938,06/01/2021 12:00:00 AM,287,457,414
Western,Norton City,51720,140,407,547,185,817,1002,34362,140844,175206,08/01/2020 12:00:00 AM,245,346,320
Western,Norton City,51720,141,365,506,188,749,937,14311,82007,96318,04/01/2017 12:00:00 AM,101,225,190
Western,Norton City,51720,141,371,512,187,768,955,14032,84206,98238,03/01/2017 12:00:00 AM,100,227,192
Western,Norton City,51720,141,372,513,188,770,958,14054,85519,99573,11/01/2017 12:00:00 AM,100,230,194
Western,Norton City,51720,141,374,515,193,772,965,14745,85475,100220,08/01/2017 12:00:00 AM,105,229,195
Western,Norton City,51720,141,400,541,179,806,985,34510,146220,180730,10/01/2020 12:00:00 AM,245,366,334
Western,Norton City,51720,143,378,521,189,789,978,13957,88939,102896,05/01/2017 12:00:00 AM,98,235,197
Western,Norton City,51720,144,367,511,195,757,952,15415,82871,98286,09/01/2017 12:00:00 AM,107,226,192
Western,Norton City,51720,144,377,521,193,780,973,15494,86961,102455,06/01/2017 12:00:00 AM,108,231,197
Western,Norton City,51720,150,383,533,196,783,979,14901,81478,96379,01/01/2017 12:00:00 AM,99,213,181
Western,Norton City,51720,150,386,536,200,788,988,15331,84880,100211,02/01/2017 12:00:00 AM,102,220,187
Western,Norton City,51720,154,388,542,206,796,1002,15940,83871,99811,12/01/2016 12:00:00 AM,104,216,184
Western,Norton City,51720,157,396,553,213,811,1024,17431,86997,104428,11/01/2016 12:00:00 AM,111,220,189
Western,Norton City,51720,159,366,525,217,782,999,17161,82235,99396,05/01/2015 12:00:00 AM,108,225,189
Western,Norton City,51720,159,394,553,218,820,1038,17128,87557,104685,10/01/2016 12:00:00 AM,108,222,189
Western,Norton City,51720,159,396,555,220,826,1046,18224,88539,106763,09/01/2016 12:00:00 AM,115,224,192
Western,Norton City,51720,160,395,555,217,830,1047,18137,90035,108172,08/01/2016 12:00:00 AM,113,228,195
Western,Norton City,51720,162,375,537,224,807,1031,18750,85902,104652,06/01/2015 12:00:00 AM,116,229,195
Western,Norton City,51720,163,361,524,225,773,998,19246,78444,97690,03/01/2015 12:00:00 AM,118,217,186
Western,Norton City,51720,163,371,534,225,788,1013,18800,83081,101881,08/01/2015 12:00:00 AM,115,224,191
Western,Norton City,51720,163,380,543,222,802,1024,19015,82643,101658,09/01/2015 12:00:00 AM,117,217,187
Western,Norton City,51720,163,382,545,224,814,1038,18910,85856,104766,07/01/2015 12:00:00 AM,116,225,192
Western,Norton City,51720,164,387,551,233,806,1039,19820,85811,105631,03/01/2016 12:00:00 AM,121,222,192
Western,Norton City,51720,164,390,554,234,823,1057,19447,87105,106552,06/01/2016 12:00:00 AM,119,223,192
Western,Norton City,51720,164,391,555,229,819,1048,18891,88414,107305,07/01/2016 12:00:00 AM,115,226,193
Western,Norton City,51720,165,362,527,230,764,994,19338,79838,99176,04/01/2015 12:00:00 AM,117,221,188
Western,Norton City,51720,165,386,551,228,816,1044,19190,86451,105641,10/01/2015 12:00:00 AM,116,224,192
Western,Norton City,51720,165,395,560,238,819,1057,20295,87091,107386,02/01/2016 12:00:00 AM,123,220,192
Western,Norton City,51720,167,380,547,244,786,1030,21487,82167,103654,01/01/2016 12:00:00 AM,129,216,189
Western,Norton City,51720,167,386,553,239,801,1040,20474,84347,104821,11/01/2015 12:00:00 AM,123,219,190
Western,Norton City,51720,167,394,561,237,836,1073,21091,97157,118248,01/01/2012 12:00:00 AM,126,247,211
Western,Norton City,51720,168,396,564,237,829,1066,19628,89229,108857,04/01/2016 12:00:00 AM,117,225,193
Western,Norton City,51720,170,398,568,248,829,1077,22871,99032,121903,03/01/2012 12:00:00 AM,135,249,215
Western,Norton City,51720,171,357,528,250,766,1016,21942,78998,100940,02/01/2015 12:00:00 AM,128,221,191
Western,Norton City,51720,171,390,561,244,809,1053,21563,86180,107743,05/01/2016 12:00:00 AM,126,221,192
Western,Norton City,51720,172,365,537,234,790,1024,21195,85332,106527,10/01/2014 12:00:00 AM,123,234,198
Western,Norton City,51720,172,383,555,250,791,1041,20845,82867,103712,12/01/2015 12:00:00 AM,121,216,187
Western,Norton City,51720,172,399,571,241,830,1071,21568,99941,121509,07/01/2012 12:00:00 AM,125,250,213
Western,Norton City,51720,172,400,572,250,827,1077,22532,98107,120639,02/01/2012 12:00:00 AM,131,245,211
Western,Norton City,51720,172,424,596,244,855,1099,22291,100326,122617,08/01/2013 12:00:00 AM,130,237,206
Western,Norton City,51720,172,430,602,243,862,1105,22469,101788,124257,09/01/2013 12:00:00 AM,131,237,206
Western,Norton City,51720,173,398,571,242,827,1069,22640,99019,121659,06/01/2012 12:00:00 AM,131,249,213
Western,Norton City,51720,173,398,571,243,832,1075,19462,88067,107529,08/01/2014 12:00:00 AM,112,221,188
Western,Norton City,51720,173,420,593,243,857,1100,20799,100244,121043,07/01/2013 12:00:00 AM,120,239,204
Western,Norton City,51720,174,355,529,249,768,1017,22891,78355,101246,01/01/2015 12:00:00 AM,132,221,191
Western,Norton City,51720,174,382,556,237,803,1040,19418,84393,103811,09/01/2014 12:00:00 AM,112,221,187
Western,Norton City,51720,174,390,564,257,804,1061,23997,96237,120234,05/01/2012 12:00:00 AM,138,247,213
Western,Norton City,51720,174,400,574,243,844,1087,22208,99310,121518,08/01/2012 12:00:00 AM,128,248,212
Western,Norton City,51720,175,388,563,263,799,1062,24110,97166,121276,04/01/2012 12:00:00 AM,138,250,215
Western,Norton City,51720,175,405,580,249,832,1081,20642,86948,107590,07/01/2014 12:00:00 AM,118,215,186
Western,Norton City,51720,175,413,588,246,857,1103,21833,102108,123941,06/01/2013 12:00:00 AM,125,247,211
Western,Norton City,51720,176,369,545,241,798,1039,21502,86033,107535,11/01/2014 12:00:00 AM,122,233,197
Western,Norton City,51720,177,407,584,255,819,1074,20550,86319,106869,03/01/2014 12:00:00 AM,116,212,183
Western,Norton City,51720,178,354,532,256,768,1024,24141,81289,105430,12/01/2014 12:00:00 AM,136,230,198
Western,Norton City,51720,178,408,586,257,839,1096,23815,98159,121974,05/01/2013 12:00:00 AM,134,241,208
Western,Norton City,51720,178,415,593,256,841,1097,21654,86740,108394,04/01/2014 12:00:00 AM,122,209,183
Western,Norton City,51720,178,422,600,252,847,1099,22201,98331,120532,10/01/2013 12:00:00 AM,125,233,201
Western,Norton City,51720,179,401,580,249,852,1101,20855,98263,119118,01/01/2013 12:00:00 AM,117,245,205
Western,Norton City,51720,179,418,597,247,841,1088,18891,90595,109486,11/01/2013 12:00:00 AM,106,217,183
Western,Norton City,51720,180,395,575,256,838,1094,23656,98303,121959,09/01/2012 12:00:00 AM,131,249,212
Western,Norton City,51720,180,418,598,261,848,1109,20748,89542,110290,12/01/2013 12:00:00 AM,115,214,184
Western,Norton City,51720,180,421,601,260,862,1122,20313,89960,110273,01/01/2014 12:00:00 AM,113,214,183
Western,Norton City,51720,181,403,584,256,852,1108,22255,98089,120344,03/01/2013 12:00:00 AM,123,243,206
Western,Norton City,51720,181,406,587,264,834,1098,24325,97143,121468,04/01/2013 12:00:00 AM,134,239,207
Western,Norton City,51720,181,407,588,258,831,1089,20350,87275,107625,02/01/2014 12:00:00 AM,112,214,183
Western,Norton City,51720,182,403,585,264,857,1121,24022,97932,121954,10/01/2012 12:00:00 AM,132,243,208
Western,Norton City,51720,183,401,584,262,859,1121,22916,100679,123595,02/01/2013 12:00:00 AM,125,251,212
Western,Norton City,51720,184,395,579,268,845,1113,24321,96208,120529,11/01/2012 12:00:00 AM,132,244,208
Western,Norton City,51720,185,388,573,263,832,1095,23552,93216,116768,12/01/2012 12:00:00 AM,127,240,204
Western,Norton City,51720,185,412,597,269,840,1109,23180,87220,110400,05/01/2014 12:00:00 AM,125,212,185
Western,Norton City,51720,186,407,593,275,827,1102,23678,87090,110768,06/01/2014 12:00:00 AM,127,214,187
Western,Patrick County,51141,197,1085,1282,242,2239,2481,54791,476953,531744,02/01/2021 12:00:00 AM,278,440,415
Western,Patrick County,51141,202,1080,1282,265,2232,2497,51419,411094,462513,11/01/2020 12:00:00 AM,255,381,361
Western,Patrick County,51141,203,1065,1268,255,2153,2408,59574,490274,549848,05/01/2021 12:00:00 AM,293,460,434
Western,Patrick County,51141,203,1080,1283,258,2183,2441,59235,497076,556311,04/01/2021 12:00:00 AM,292,460,434
Western,Patrick County,51141,205,1002,1207,269,2103,2372,22578,226185,248763,01/01/2020 12:00:00 AM,110,226,206
Western,Patrick County,51141,205,1070,1275,278,2199,2477,55040,408597,463637,12/01/2020 12:00:00 AM,268,382,364
Western,Patrick County,51141,205,1086,1291,260,2208,2468,59166,462725,521891,03/01/2021 12:00:00 AM,289,426,404
Western,Patrick County,51141,206,1066,1272,279,2190,2469,60936,445681,506617,01/01/2021 12:00:00 AM,296,418,398
Western,Patrick County,51141,207,1013,1220,287,2152,2439,25308,231142,256450,05/01/2019 12:00:00 AM,122,228,210
Western,Patrick County,51141,207,1027,1234,283,2155,2438,23986,233813,257799,04/01/2019 12:00:00 AM,116,228,209
Western,Patrick County,51141,207,996,1203,281,2078,2359,25061,223100,248161,11/01/2019 12:00:00 AM,121,224,206
Western,Patrick County,51141,208,1003,1211,272,2090,2362,22961,229469,252430,02/01/2020 12:00:00 AM,110,229,208
Western,Patrick County,51141,208,1012,1220,286,2143,2429,24115,233398,257513,06/01/2019 12:00:00 AM,116,231,211
Western,Patrick County,51141,208,1092,1300,272,2253,2525,53809,411969,465778,10/01/2020 12:00:00 AM,259,377,358
Western,Patrick County,51141,209,1006,1215,288,2109,2397,24492,226150,250642,08/01/2019 12:00:00 AM,117,225,206
Western,Patrick County,51141,210,1001,1211,294,2083,2377,26089,226632,252721,07/01/2019 12:00:00 AM,124,226,209
Western,Patrick County,51141,211,1002,1213,281,2089,2370,25579,228617,254196,10/01/2019 12:00:00 AM,121,228,210
Western,Patrick County,51141,211,1010,1221,291,2108,2399,24183,233330,257513,09/01/2019 12:00:00 AM,115,231,211
Western,Patrick County,51141,211,1015,1226,275,2099,2374,51078,361996,413074,03/01/2020 12:00:00 AM,242,357,337
Western,Patrick County,51141,212,1008,1220,294,2092,2386,25086,229528,254614,02/01/2019 12:00:00 AM,118,228,209
Western,Patrick County,51141,212,1028,1240,298,2150,2448,26569,237673,264242,01/01/2019 12:00:00 AM,125,231,213
Western,Patrick County,51141,212,1075,1287,267,2196,2463,63014,499284,562298,06/01/2021 12:00:00 AM,297,464,437
Western,Patrick County,51141,213,1004,1217,285,2111,2396,25292,230873,256165,12/01/2019 12:00:00 AM,119,230,210
Western,Patrick County,51141,213,1075,1288,281,2235,2516,51558,385122,436680,04/01/2020 12:00:00 AM,242,358,339
Western,Patrick County,51141,214,1037,1251,291,2198,2489,26883,238125,265008,12/01/2018 12:00:00 AM,126,230,212
Western,Patrick County,51141,214,1108,1322,282,2296,2578,52519,392411,444930,09/01/2020 12:00:00 AM,245,354,337
Western,Patrick County,51141,214,1108,1322,283,2288,2571,52184,394856,447040,05/01/2020 12:00:00 AM,244,356,338
Western,Patrick County,51141,214,1113,1327,283,2282,2565,52059,393018,445077,06/01/2020 12:00:00 AM,243,353,335
Western,Patrick County,51141,215,1035,1250,303,2188,2491,27362,239003,266365,11/01/2018 12:00:00 AM,127,231,213
Western,Patrick County,51141,216,1032,1248,303,2185,2488,27364,234991,262355,10/01/2018 12:00:00 AM,127,228,210
Western,Patrick County,51141,217,1035,1252,306,2179,2485,26815,238073,264888,03/01/2019 12:00:00 AM,124,230,212
Western,Patrick County,51141,217,1124,1341,282,2319,2601,52452,398288,450740,08/01/2020 12:00:00 AM,242,354,336
Western,Patrick County,51141,219,1131,1350,292,2317,2609,53080,398918,451998,07/01/2020 12:00:00 AM,242,353,335
Western,Patrick County,51141,221,1043,1264,310,2186,2496,27437,236458,263895,08/01/2018 12:00:00 AM,124,227,209
Western,Patrick County,51141,222,1020,1242,305,2135,2440,26775,229377,256152,09/01/2018 12:00:00 AM,121,225,206
Western,Patrick County,51141,226,1030,1256,327,2132,2459,29574,229967,259541,07/01/2018 12:00:00 AM,131,223,207
Western,Patrick County,51141,233,1031,1264,338,2163,2501,30446,230019,260465,05/01/2018 12:00:00 AM,131,223,206
Western,Patrick County,51141,235,1035,1270,345,2200,2545,32685,234751,267436,04/01/2018 12:00:00 AM,139,227,211
Western,Patrick County,51141,235,1076,1311,326,2280,2606,29696,249044,278740,10/01/2017 12:00:00 AM,126,231,213
Western,Patrick County,51141,237,1029,1266,341,2151,2492,30961,231592,262553,06/01/2018 12:00:00 AM,131,225,207
Western,Patrick County,51141,237,1066,1303,344,2286,2630,31773,242153,273926,02/01/2018 12:00:00 AM,134,227,210
Western,Patrick County,51141,238,1052,1290,344,2255,2599,31103.64,239237,270340.64,03/01/2018 12:00:00 AM,131,227,210
Western,Patrick County,51141,238,1053,1291,349,2245,2594,33981,243536,277517,12/01/2017 12:00:00 AM,143,231,215
Western,Patrick County,51141,238,1054,1292,348,2255,2603,34162,234305,268467,01/01/2018 12:00:00 AM,144,222,208
Western,Patrick County,51141,240,1057,1297,353,2265,2618,34683,242527,277210,11/01/2017 12:00:00 AM,145,229,214
Western,Patrick County,51141,244,1078,1322,348,2318,2666,32561,252994,285555,09/01/2017 12:00:00 AM,133,235,216
Western,Patrick County,51141,248,1068,1316,357,2277,2634,34484,246932,281416,06/01/2017 12:00:00 AM,139,231,214
Western,Patrick County,51141,249,1085,1334,365,2307,2672,35522,250348,285870,07/01/2017 12:00:00 AM,143,231,214
Western,Patrick County,51141,250,1082,1332,353,2316,2669,33276,257689,290965,04/01/2017 12:00:00 AM,133,238,218
Western,Patrick County,51141,251,1066,1317,365,2266,2631,33856,246059,279915,08/01/2017 12:00:00 AM,135,231,213
Western,Patrick County,51141,251,1072,1323,362,2291,2653,36170,252961,289131,05/01/2017 12:00:00 AM,144,236,219
Western,Patrick County,51141,251,1099,1350,355,2355,2710,33743,259812,293555,03/01/2017 12:00:00 AM,134,236,217
Western,Patrick County,51141,256,1119,1375,367,2425,2792,35145,259801,294946,02/01/2017 12:00:00 AM,137,232,215
Western,Patrick County,51141,264,1134,1398,380,2442,2822,35504,263345,298849,01/01/2017 12:00:00 AM,134,232,214
Western,Patrick County,51141,266,1129,1395,394,2435,2829,36573,258642,295215,12/01/2016 12:00:00 AM,137,229,212
Western,Patrick County,51141,270,1126,1396,404,2438,2842,38150,261132,299282,11/01/2016 12:00:00 AM,141,232,214
Western,Patrick County,51141,277,1140,1417,412,2467,2879,39204,265671,304875,10/01/2016 12:00:00 AM,142,233,215
Western,Patrick County,51141,279,1145,1424,423,2505,2928,39876,261726,301602,06/01/2016 12:00:00 AM,143,229,212
Western,Patrick County,51141,282,1143,1425,441,2490,2931,42687,259160,301847,05/01/2016 12:00:00 AM,151,227,212
Western,Patrick County,51141,283,1155,1438,421,2505,2926,40036,269014,309050,08/01/2016 12:00:00 AM,141,233,215
Western,Patrick County,51141,285,1144,1429,425,2509,2934,40648,264759,305407,07/01/2016 12:00:00 AM,143,231,214
Western,Patrick County,51141,286,1135,1421,431,2464,2895,41610,263756,305366,09/01/2016 12:00:00 AM,145,232,215
Western,Patrick County,51141,286,1136,1422,443,2481,2924,44772,258605,303377,02/01/2016 12:00:00 AM,157,228,213
Western,Patrick County,51141,288,1140,1428,448,2482,2930,43938,256779,300717,04/01/2016 12:00:00 AM,153,225,211
Western,Patrick County,51141,288,1195,1483,435,2632,3067,42311,271388,313699,09/01/2015 12:00:00 AM,147,227,212
Western,Patrick County,51141,290,1169,1459,453,2542,2995,45050,264037,309087,10/01/2015 12:00:00 AM,155,226,212
Western,Patrick County,51141,290,1198,1488,445,2608,3053,43302,273824,317126,07/01/2015 12:00:00 AM,149,229,213
Western,Patrick County,51141,291,1132,1423,452,2469,2921,45059,257048,302107,03/01/2016 12:00:00 AM,155,227,212
Western,Patrick County,51141,291,1151,1442,441,2511,2952,43074,259518,302592,12/01/2015 12:00:00 AM,148,225,210
Western,Patrick County,51141,294,1149,1443,460,2499,2959,45515,257363,302878,01/01/2016 12:00:00 AM,155,224,210
Western,Patrick County,51141,294,1199,1493,449,2624,3073,44009,275968,319977,05/01/2015 12:00:00 AM,150,230,214
Western,Patrick County,51141,294,1200,1494,443,2617,3060,43238,278800,322038,06/01/2015 12:00:00 AM,147,232,216
Western,Patrick County,51141,295,1165,1460,455,2548,3003,44780,265909,310689,11/01/2015 12:00:00 AM,152,228,213
Western,Patrick County,51141,295,1200,1495,449,2630,3079,44532,277821,322353,11/01/2014 12:00:00 AM,151,232,216
Western,Patrick County,51141,297,1198,1495,455,2613,3068,44380,272278,316658,08/01/2015 12:00:00 AM,149,227,212
Western,Patrick County,51141,300,1199,1499,466,2594,3060,45792,274350,320142,04/01/2015 12:00:00 AM,153,229,214
Western,Patrick County,51141,300,1218,1518,464,2659,3123,47330,280692,328022,12/01/2014 12:00:00 AM,158,230,216
Western,Patrick County,51141,301,1212,1513,465,2648,3113,47407,276262,323669,01/01/2015 12:00:00 AM,157,228,214
Western,Patrick County,51141,303,1206,1509,462,2633,3095,44947,275114,320061,03/01/2015 12:00:00 AM,148,228,212
Western,Patrick County,51141,304,1387,1691,473,2965,3438,48674,338416,387090,06/01/2013 12:00:00 AM,160,244,229
Western,Patrick County,51141,306,1204,1510,474,2633,3107,43383,264898,308281,08/01/2014 12:00:00 AM,142,220,204
Western,Patrick County,51141,306,1395,1701,479,2981,3460,50075,340446,390521,05/01/2013 12:00:00 AM,164,244,230
Western,Patrick County,51141,306,1407,1713,480,3011,3491,48726,339572,388298,07/01/2013 12:00:00 AM,159,241,227
Western,Patrick County,51141,307,1191,1498,480,2582,3062,43586,265060,308646,07/01/2014 12:00:00 AM,142,223,206
Western,Patrick County,51141,308,1384,1692,483,2942,3425,49804,335172,384976,09/01/2013 12:00:00 AM,162,242,228
Western,Patrick County,51141,308,1400,1708,490,2971,3461,50311,342007,392318,08/01/2013 12:00:00 AM,163,244,230
Western,Patrick County,51141,309,1190,1499,490,2620,3110,50308,273113,323421,10/01/2014 12:00:00 AM,163,230,216
Western,Patrick County,51141,309,1199,1508,478,2614,3092,48384,274278,322662,02/01/2015 12:00:00 AM,157,229,214
Western,Patrick County,51141,309,1286,1595,483,2776,3259,43860,284291,328151,04/01/2014 12:00:00 AM,142,221,206
Western,Patrick County,51141,309,1305,1614,493,2815,3308,45502,288965,334467,02/01/2014 12:00:00 AM,147,221,207
Western,Patrick County,51141,310,1197,1507,488,2637,3125,45600,264214,309814,09/01/2014 12:00:00 AM,147,221,206
Western,Patrick County,51141,310,1291,1601,489,2785,3274,45112,287004,332116,03/01/2014 12:00:00 AM,146,222,207
Western,Patrick County,51141,310,1378,1688,514,2945,3459,56173,339541,395714,03/01/2013 12:00:00 AM,181,246,234
Western,Patrick County,51141,310,1387,1697,512,2948,3460,55084,337869,392953,04/01/2013 12:00:00 AM,178,244,232
Western,Patrick County,51141,311,1388,1699,490,2946,3436,52002,334272,386274,10/01/2013 12:00:00 AM,167,241,227
Western,Patrick County,51141,313,1229,1542,490,2656,3146,44864,271920,316784,06/01/2014 12:00:00 AM,143,221,205
Western,Patrick County,51141,313,1267,1580,488,2737,3225,45504,280832,326336,05/01/2014 12:00:00 AM,145,222,207
Western,Patrick County,51141,313,1354,1667,492,2875,3367,46291,298752,345043,11/01/2013 12:00:00 AM,148,221,207
Western,Patrick County,51141,314,1386,1700,528,2958,3486,58640,337866,396506,02/01/2013 12:00:00 AM,187,244,233
Western,Patrick County,51141,317,1308,1625,505,2796,3301,45497,283931,329428,01/01/2014 12:00:00 AM,144,217,203
Western,Patrick County,51141,317,1363,1680,550,2938,3488,60973,341314,402287,06/01/2012 12:00:00 AM,192,250,239
Western,Patrick County,51141,318,1338,1656,507,2843,3350,47538,293075,340613,12/01/2013 12:00:00 AM,149,219,206
Western,Patrick County,51141,319,1381,1700,532,2956,3488,58028,333228,391256,01/01/2013 12:00:00 AM,182,241,230
Western,Patrick County,51141,321,1364,1685,544,2923,3467,60468,337379,397847,12/01/2012 12:00:00 AM,188,247,236
Western,Patrick County,51141,324,1364,1688,545,2941,3486,59653,344475,404128,08/01/2012 12:00:00 AM,184,253,239
Western,Patrick County,51141,324,1371,1695,541,2956,3497,59820,341073,400893,11/01/2012 12:00:00 AM,185,249,237
Western,Patrick County,51141,324,1372,1696,542,2959,3501,58897,344115,403012,09/01/2012 12:00:00 AM,182,251,238
Western,Patrick County,51141,326,1368,1694,562,2956,3518,63620,344901,408521,07/01/2012 12:00:00 AM,195,252,241
Western,Patrick County,51141,328,1379,1707,570,3009,3579,63278,347457,410735,03/01/2012 12:00:00 AM,193,252,241
Western,Patrick County,51141,329,1382,1711,549,2946,3495,60291,341124,401415,10/01/2012 12:00:00 AM,183,247,235
Western,Patrick County,51141,329,1394,1723,586,3035,3621,65355,347123,412478,01/01/2012 12:00:00 AM,199,249,239
Western,Patrick County,51141,331,1357,1688,588,2954,3542,64983,341440,406423,04/01/2012 12:00:00 AM,196,252,241
Western,Patrick County,51141,337,1377,1714,609,2990,3599,68241,344683,412924,02/01/2012 12:00:00 AM,202,250,241
Western,Patrick County,51141,338,1351,1689,600,2914,3514,67624,335604,403228,05/01/2012 12:00:00 AM,200,248,239
Western,Pulaski County,51155,400,2002,2402,474,3869,4343,40698,470003,510701,02/01/2020 12:00:00 AM,102,235,213
Western,Pulaski County,51155,408,2017,2425,479,3883,4362,40669,468911,509580,01/01/2020 12:00:00 AM,100,232,210
Western,Pulaski County,51155,411,2049,2460,488,3930,4418,91906,690187,782093,03/01/2020 12:00:00 AM,224,337,318
Western,Pulaski County,51155,413,2008,2421,490,3933,4423,43110,475431,518541,07/01/2019 12:00:00 AM,104,237,214
Western,Pulaski County,51155,413,2035,2448,493,3945,4438,43425,488213,531638,10/01/2019 12:00:00 AM,105,240,217
Western,Pulaski County,51155,414,2025,2439,491,3965,4456,43539,485301,528840,06/01/2019 12:00:00 AM,105,240,217
Western,Pulaski County,51155,415,2005,2420,501,3944,4445,45929,470364,516293,02/01/2019 12:00:00 AM,111,235,213
Western,Pulaski County,51155,415,2026,2441,495,3980,4475,42810,478323,521133,08/01/2019 12:00:00 AM,103,236,213
Western,Pulaski County,51155,415,2038,2453,492,3925,4417,43125,472601,515726,12/01/2019 12:00:00 AM,104,232,210
Western,Pulaski County,51155,416,2012,2428,497,3948,4445,44829,479511,524340,05/01/2019 12:00:00 AM,108,238,216
Western,Pulaski County,51155,417,2006,2423,499,3916,4415,44200,471389,515589,04/01/2019 12:00:00 AM,106,235,213
Western,Pulaski County,51155,418,2023,2441,498,3926,4424,44574,473311,517885,09/01/2019 12:00:00 AM,107,234,212
Western,Pulaski County,51155,418,2060,2478,507,4066,4573,46262,490901,537163,01/01/2019 12:00:00 AM,111,238,217
Western,Pulaski County,51155,419,2037,2456,507,4006,4513,45570,479601,525171,03/01/2019 12:00:00 AM,109,235,214
Western,Pulaski County,51155,421,2013,2434,502,3858,4360,45068,461631,506699,11/01/2019 12:00:00 AM,107,229,208
Western,Pulaski County,51155,422,2164,2586,514,4171,4685,123407,982898,1106305,04/01/2021 12:00:00 AM,292,454,428
Western,Pulaski County,51155,422,2172,2594,514,4469,4983,51028,537848,588876,12/01/2017 12:00:00 AM,121,248,227
Western,Pulaski County,51155,424,2110,2534,529,4219,4748,49580,507440,557020,06/01/2018 12:00:00 AM,117,240,220
Western,Pulaski County,51155,424,2152,2576,507,4098,4605,94989,721040,816029,04/01/2020 12:00:00 AM,224,335,317
Western,Pulaski County,51155,424,2211,2635,524,4568,5092,47340,549989,597329,01/01/2018 12:00:00 AM,112,249,227
Western,Pulaski County,51155,425,2191,2616,511,4249,4760,117426,918168,1035594,02/01/2021 12:00:00 AM,276,419,396
Western,Pulaski County,51155,426,2178,2604,531,4489,5020,50957,546190,597147,07/01/2017 12:00:00 AM,120,251,229
Western,Pulaski County,51155,426,2200,2626,522,4543,5065,51815,559415,611230,10/01/2017 12:00:00 AM,122,254,233
Western,Pulaski County,51155,426,2235,2661,525,4642,5167,52717,580702,633419,09/01/2017 12:00:00 AM,124,260,238
Western,Pulaski County,51155,427,2070,2497,522,4093,4615,49511,491968,541479,08/01/2018 12:00:00 AM,116,238,217
Western,Pulaski County,51155,427,2146,2573,525,4094,4619,125213,960638,1085851,05/01/2021 12:00:00 AM,293,448,422
Western,Pulaski County,51155,427,2194,2621,511,4246,4757,116209,893357,1009566,03/01/2021 12:00:00 AM,272,407,385
Western,Pulaski County,51155,427,2221,2648,520,4575,5095,50684,570751,621435,06/01/2017 12:00:00 AM,119,257,235
Western,Pulaski County,51155,428,2078,2506,525,4121,4646,49464,494204,543668,07/01/2018 12:00:00 AM,116,238,217
Western,Pulaski County,51155,428,2179,2607,515,4159,4674,97197,735578,832775,05/01/2020 12:00:00 AM,227,338,319
Western,Pulaski County,51155,428,2224,2652,516,4654,5170,49278,575726,625004,04/01/2017 12:00:00 AM,115,259,236
Western,Pulaski County,51155,429,2077,2506,513,4082,4595,48854,491342,540196,12/01/2018 12:00:00 AM,114,237,216
Western,Pulaski County,51155,430,2126,2556,543,4267,4810,51145,515399,566544,05/01/2018 12:00:00 AM,119,242,222
Western,Pulaski County,51155,431,2139,2570,540,4326,4866,51336,521269,572605,04/01/2018 12:00:00 AM,119,244,223
Western,Pulaski County,51155,431,2144,2575,546,4345,4891,52181,523487,575668,03/01/2018 12:00:00 AM,121,244,224
Western,Pulaski County,51155,431,2229,2660,522,4655,5177,48132,570699,618831,03/01/2017 12:00:00 AM,112,256,233
Western,Pulaski County,51155,432,2180,2612,521,4152,4673,99137,729145,828282,06/01/2020 12:00:00 AM,229,334,317
Western,Pulaski County,51155,432,2218,2650,530,4611,5141,51011,572657,623668,05/01/2017 12:00:00 AM,118,258,235
Western,Pulaski County,51155,433,2089,2522,527,4105,4632,51211,494737,545948,10/01/2018 12:00:00 AM,118,237,216
Western,Pulaski County,51155,433,2294,2727,519,4784,5303,47441,584657,632098,02/01/2017 12:00:00 AM,110,255,232
Western,Pulaski County,51155,434,2162,2596,549,4225,4774,121966,892059,1014025,01/01/2021 12:00:00 AM,281,413,391
Western,Pulaski County,51155,434,2233,2667,542,4629,5171,54161,572457,626618,08/01/2017 12:00:00 AM,125,256,235
Western,Pulaski County,51155,435,2075,2510,525,4071,4596,50270,492358,542628,11/01/2018 12:00:00 AM,116,237,216
Western,Pulaski County,51155,435,2154,2589,537,4085,4622,130014,956572,1086586,06/01/2021 12:00:00 AM,299,444,420
Western,Pulaski County,51155,435,2200,2635,537,4544,5081,54786,555217,610003,11/01/2017 12:00:00 AM,126,252,232
Western,Pulaski County,51155,437,2084,2521,532,4112,4644,51103,493922,545025,09/01/2018 12:00:00 AM,117,237,216
Western,Pulaski County,51155,437,2146,2583,545,4399,4944,51532,531775,583307,02/01/2018 12:00:00 AM,118,248,226
Western,Pulaski County,51155,438,2263,2701,528,4748,5276,49265,572195,621460,01/01/2017 12:00:00 AM,112,253,230
Western,Pulaski County,51155,439,2193,2632,558,4301,4859,111205,802896,914101,12/01/2020 12:00:00 AM,253,366,347
Western,Pulaski County,51155,440,2260,2700,532,4767,5299,49426,571099,620525,12/01/2016 12:00:00 AM,112,253,230
Western,Pulaski County,51155,441,2186,2627,555,4268,4823,109410,786946,896356,10/01/2020 12:00:00 AM,248,360,341
Western,Pulaski County,51155,441,2209,2650,537,4266,4803,100288,751413,851701,07/01/2020 12:00:00 AM,227,340,321
Western,Pulaski County,51155,442,2178,2620,559,4270,4829,110825,799635,910460,11/01/2020 12:00:00 AM,251,367,348
Western,Pulaski County,51155,442,2193,2635,537,4247,4784,101422,744699,846121,08/01/2020 12:00:00 AM,229,340,321
Western,Pulaski County,51155,444,2143,2587,535,4553,5088,48453,530438,578891,05/01/2016 12:00:00 AM,109,248,224
Western,Pulaski County,51155,444,2227,2671,541,4727,5268,52680,567495,620175,11/01/2016 12:00:00 AM,119,255,232
Western,Pulaski County,51155,447,2090,2537,560,4504,5064,50651,517653,568304,11/01/2015 12:00:00 AM,113,248,224
Western,Pulaski County,51155,448,2097,2545,573,4471,5044,52381,517994,570375,09/01/2015 12:00:00 AM,117,247,224
Western,Pulaski County,51155,448,2105,2553,559,4477,5036,50752,519159,569911,03/01/2016 12:00:00 AM,113,247,223
Western,Pulaski County,51155,448,2175,2623,550,4208,4758,103760,745242,849002,09/01/2020 12:00:00 AM,232,343,324
Western,Pulaski County,51155,449,2136,2585,548,4578,5126,49281,534595,583876,05/01/2015 12:00:00 AM,110,250,226
Western,Pulaski County,51155,450,2121,2571,569,4556,5125,51438,521556,572994,12/01/2015 12:00:00 AM,114,246,223
Western,Pulaski County,51155,450,2278,2728,547,4821,5368,51744,582157,633901,10/01/2016 12:00:00 AM,115,256,232
Western,Pulaski County,51155,451,2084,2535,566,4465,5031,52225,519219,571444,02/01/2016 12:00:00 AM,116,249,225
Western,Pulaski County,51155,451,2096,2547,589,4450,5039,54818,514201,569019,10/01/2015 12:00:00 AM,122,245,223
Western,Pulaski County,51155,452,2113,2565,564,4483,5047,51770,521221,572991,04/01/2016 12:00:00 AM,115,247,223
Western,Pulaski County,51155,453,2198,2651,539,4678,5217,48796,549541,598337,06/01/2016 12:00:00 AM,108,250,226
Western,Pulaski County,51155,454,2156,2610,561,4636,5197,51601,540487,592088,04/01/2015 12:00:00 AM,114,251,227
Western,Pulaski County,51155,455,2130,2585,569,4532,5101,51422,527223,578645,06/01/2015 12:00:00 AM,113,248,224
Western,Pulaski County,51155,455,2208,2663,542,4722,5264,49763,554380,604143,07/01/2016 12:00:00 AM,109,251,227
Western,Pulaski County,51155,456,2111,2567,578,4508,5086,52594,527588,580182,07/01/2015 12:00:00 AM,115,250,226
Western,Pulaski County,51155,456,2267,2723,550,4796,5346,53086,573321,626407,09/01/2016 12:00:00 AM,116,253,230
Western,Pulaski County,51155,457,2122,2579,580,4532,5112,52945,524183,577128,08/01/2015 12:00:00 AM,116,247,224
Western,Pulaski County,51155,458,2107,2565,585,4525,5110,53579,516518,570097,01/01/2016 12:00:00 AM,117,245,222
Western,Pulaski County,51155,460,2244,2704,547,4821,5368,51691,566471,618162,08/01/2016 12:00:00 AM,112,252,229
Western,Pulaski County,51155,471,2168,2639,613,4634,5247,58692,535482,594174,03/01/2015 12:00:00 AM,125,247,225
Western,Pulaski County,51155,478,2158,2636,624,4600,5224,59212,539161,598373,02/01/2015 12:00:00 AM,124,250,227
Western,Pulaski County,51155,483,2201,2684,639,4637,5276,59751,538371,598122,01/01/2015 12:00:00 AM,124,245,223
Western,Pulaski County,51155,484,2273,2757,654,4704,5358,62550,558099,620649,12/01/2014 12:00:00 AM,129,246,225
Western,Pulaski County,51155,488,2300,2788,653,4771,5424,63415,571985,635400,11/01/2014 12:00:00 AM,130,249,228
Western,Pulaski County,51155,491,2379,2870,647,4930,5577,56378,561848,618226,08/01/2014 12:00:00 AM,115,236,215
Western,Pulaski County,51155,493,2506,2999,667,5128,5795,57470,588085,645555,05/01/2014 12:00:00 AM,117,235,215
Western,Pulaski County,51155,494,2325,2819,656,4814,5470,63264,571152,634416,10/01/2014 12:00:00 AM,128,246,225
Western,Pulaski County,51155,494,2329,2823,650,4853,5503,56387,548352,604739,09/01/2014 12:00:00 AM,114,235,214
Western,Pulaski County,51155,496,2432,2928,666,5001,5667,57564,571860,629424,07/01/2014 12:00:00 AM,116,235,215
Western,Pulaski County,51155,499,2456,2955,677,5017,5694,58933,575393,634326,06/01/2014 12:00:00 AM,118,234,215
Western,Pulaski County,51155,499,2597,3096,663,5242,5905,57443,606553,663996,02/01/2014 12:00:00 AM,115,234,214
Western,Pulaski County,51155,500,2530,3030,680,5139,5819,59311,594114,653425,04/01/2014 12:00:00 AM,119,235,216
Western,Pulaski County,51155,500,2587,3087,675,5220,5895,58423,604125,662548,03/01/2014 12:00:00 AM,117,234,215
Western,Pulaski County,51155,503,2591,3094,657,5237,5894,59459,602990,662449,11/01/2013 12:00:00 AM,118,233,214
Western,Pulaski County,51155,505,2578,3083,669,5185,5854,67447,649402,716849,09/01/2013 12:00:00 AM,134,252,233
Western,Pulaski County,51155,505,2604,3109,676,5250,5926,67458,652707,720165,10/01/2013 12:00:00 AM,134,251,232
Western,Pulaski County,51155,506,2582,3088,660,5237,5897,58574,604020,662594,12/01/2013 12:00:00 AM,116,234,215
Western,Pulaski County,51155,506,2587,3093,663,5244,5907,56369,597939,654308,01/01/2014 12:00:00 AM,111,231,212
Western,Pulaski County,51155,513,2589,3102,712,5163,5875,73970,652628,726598,07/01/2013 12:00:00 AM,144,252,234
Western,Pulaski County,51155,514,2490,3004,734,4990,5724,76949,632381,709330,09/01/2012 12:00:00 AM,150,254,236
Western,Pulaski County,51155,517,2573,3090,708,5168,5876,72944,651352,724296,08/01/2013 12:00:00 AM,141,253,234
Western,Pulaski County,51155,517,2586,3103,706,5088,5794,71221,648393,719614,05/01/2013 12:00:00 AM,138,251,232
Western,Pulaski County,51155,518,2503,3021,752,5025,5777,79324,637053,716377,07/01/2012 12:00:00 AM,153,255,237
Western,Pulaski County,51155,518,2526,3044,757,5054,5811,79476,631903,711379,08/01/2012 12:00:00 AM,153,250,234
Western,Pulaski County,51155,519,2529,3048,780,5113,5893,83845,643917,727762,01/01/2012 12:00:00 AM,162,255,239
Western,Pulaski County,51155,519,2564,3083,706,5044,5750,70533,644796,715329,04/01/2013 12:00:00 AM,136,251,232
Western,Pulaski County,51155,519,2600,3119,711,5138,5849,73576,655432,729008,06/01/2013 12:00:00 AM,142,252,234
Western,Pulaski County,51155,521,2501,3022,762,5041,5803,80586,639412,719998,06/01/2012 12:00:00 AM,155,256,238
Western,Pulaski County,51155,521,2537,3058,737,5095,5832,77508,643101,720609,10/01/2012 12:00:00 AM,149,253,236
Western,Pulaski County,51155,523,2554,3077,730,5036,5766,74525,639528,714053,03/01/2013 12:00:00 AM,142,250,232
Western,Pulaski County,51155,524,2497,3021,763,5036,5799,80664,638729,719393,05/01/2012 12:00:00 AM,154,256,238
Western,Pulaski County,51155,526,2501,3027,779,5052,5831,82752,643041,725793,04/01/2012 12:00:00 AM,157,257,240
Western,Pulaski County,51155,527,2521,3048,791,5073,5864,82046,641162,723208,03/01/2012 12:00:00 AM,156,254,237
Western,Pulaski County,51155,527,2538,3065,737,5101,5838,76713,644155,720868,11/01/2012 12:00:00 AM,146,254,235
Western,Pulaski County,51155,530,2556,3086,745,5082,5827,75489,641624,717113,02/01/2013 12:00:00 AM,142,251,232
Western,Pulaski County,51155,534,2530,3064,763,5013,5776,79464,635423,714887,01/01/2013 12:00:00 AM,149,251,233
Western,Pulaski County,51155,535,2517,3052,757,5053,5810,81194,637427,718621,12/01/2012 12:00:00 AM,152,253,235
Western,Pulaski County,51155,536,2514,3050,828,5055,5883,88615,638390,727005,02/01/2012 12:00:00 AM,165,254,238
Western,Radford City,51750,116,585,701,159,1300,1459,14521,154127,168648,08/01/2016 12:00:00 AM,125,263,241
Western,Radford City,51750,116,605,721,159,1349,1508,14706,161482,176188,09/01/2016 12:00:00 AM,127,267,244
Western,Radford City,51750,117,583,700,165,1297,1462,14523,156088,170611,07/01/2016 12:00:00 AM,124,268,244
Western,Radford City,51750,117,584,701,164,1295,1459,14591,155207,169798,06/01/2016 12:00:00 AM,125,266,242
Western,Radford City,51750,118,573,691,159,1242,1401,15454,153584,169038,04/01/2017 12:00:00 AM,131,268,245
Western,Radford City,51750,118,610,728,169,1337,1506,15445,156562,172007,04/01/2016 12:00:00 AM,131,257,236
Western,Radford City,51750,119,592,711,167,1303,1470,15230,156023,171253,12/01/2016 12:00:00 AM,128,264,241
Western,Radford City,51750,120,570,690,161,1228,1389,15377,149588,164965,03/01/2017 12:00:00 AM,128,262,239
Western,Radford City,51750,120,583,703,160,1272,1432,16128,155786,171914,05/01/2017 12:00:00 AM,134,267,245
Western,Radford City,51750,121,596,717,176,1304,1480,16901,157238,174139,05/01/2016 12:00:00 AM,140,264,243
Western,Radford City,51750,122,555,677,162,1244,1406,16002,150303,166305,12/01/2017 12:00:00 AM,131,271,246
Western,Radford City,51750,122,571,693,171,1267,1438,16828,153112,169940,08/01/2017 12:00:00 AM,138,268,245
Western,Radford City,51750,122,573,695,168,1261,1429,15506,150566,166072,06/01/2017 12:00:00 AM,127,263,239
Western,Radford City,51750,122,598,720,177,1307,1484,17759,156202,173961,11/01/2016 12:00:00 AM,146,261,242
Western,Radford City,51750,123,563,686,160,1275,1435,15039,152898,167937,02/01/2018 12:00:00 AM,122,272,245
Western,Radford City,51750,123,583,706,176,1289,1465,16408,155941.78,172349.78,07/01/2017 12:00:00 AM,133,267,244
Western,Radford City,51750,123,602,725,176,1326,1502,17289,157686,174975,10/01/2016 12:00:00 AM,141,262,241
Western,Radford City,51750,123,620,743,180,1349,1529,16796,159155,175951,03/01/2016 12:00:00 AM,137,257,237
Western,Radford City,51750,123,625,748,182,1360,1542,17095,160438,177533,02/01/2016 12:00:00 AM,139,257,237
Western,Radford City,51750,124,568,692,172,1266,1438,16186,152876,169062,09/01/2017 12:00:00 AM,131,269,244
Western,Radford City,51750,125,550,675,172,1231,1403,16925,148621,165546,11/01/2017 12:00:00 AM,135,270,245
Western,Radford City,51750,125,560,685,165,1261,1426,15434,148353,163787,03/01/2018 12:00:00 AM,123,265,239
Western,Radford City,51750,125,582,707,174,1258,1432,15703,148628,164331,01/01/2017 12:00:00 AM,126,255,232
Western,Radford City,51750,126,550,676,168,1231,1399,17514,150116,167630,01/01/2018 12:00:00 AM,139,273,248
Western,Radford City,51750,126,566,692,174,1259,1433,16877,151727,168604,10/01/2017 12:00:00 AM,134,268,244
Western,Radford City,51750,126,591,717,176,1316,1492,15364,155208,170572,02/01/2017 12:00:00 AM,122,263,238
Western,Radford City,51750,129,611,740,198,1322,1520,20452,153528,173980,12/01/2015 12:00:00 AM,159,251,235
Western,Radford City,51750,130,700,830,229,1470,1699,23305,185930,209235,05/01/2012 12:00:00 AM,179,266,252
Western,Radford City,51750,131,531,662,175,1157,1332,15484,136303,151787,02/01/2020 12:00:00 AM,118,257,229
Western,Radford City,51750,131,538,669,162,1159,1321,14765,137805,152570,11/01/2019 12:00:00 AM,113,256,228
Western,Radford City,51750,131,540,671,175,1170,1345,15792,139689.07,155481.07,01/01/2020 12:00:00 AM,121,259,232
Western,Radford City,51750,131,620,751,198,1357,1555,20828,157581,178409,01/01/2016 12:00:00 AM,159,254,238
Western,Radford City,51750,132,526,658,171,1170,1341,32093,200326,232419,03/01/2020 12:00:00 AM,243,381,353
Western,Radford City,51750,132,569,701,178,1244,1422,17137,148698,165835,05/01/2018 12:00:00 AM,130,261,237
Western,Radford City,51750,132,598,730,167,1259,1426,36809,262327,299136,02/01/2021 12:00:00 AM,279,439,410
Western,Radford City,51750,132,606,738,201,1328,1529,20063,157213,177276,11/01/2015 12:00:00 AM,152,259,240
Western,Radford City,51750,133,518,651,178,1144,1322,16733,136402,153135,12/01/2018 12:00:00 AM,126,263,235
Western,Radford City,51750,133,535,668,185,1191,1376,17324,145519,162843,09/01/2018 12:00:00 AM,130,272,244
Western,Radford City,51750,133,562,695,184,1229,1413,17940,148968,166908,06/01/2018 12:00:00 AM,135,265,240
Western,Radford City,51750,133,572,705,179,1263,1442,17737,147755,165492,04/01/2018 12:00:00 AM,133,258,235
Western,Radford City,51750,133,584,717,174,1258,1432,32287,218790,251077,04/01/2020 12:00:00 AM,243,375,350
Western,Radford City,51750,134,492,626,182,1066,1248,15857,128444,144301,02/01/2019 12:00:00 AM,118,261,231
Western,Radford City,51750,134,695,829,241,1451,1692,26321,181401,207722,04/01/2012 12:00:00 AM,196,261,251
Western,Radford City,51750,135,506,641,179,1130,1309,15879,141220,157099,01/01/2019 12:00:00 AM,118,279,245
Western,Radford City,51750,135,514,649,168,1133,1301,15864,128674,144538,08/01/2019 12:00:00 AM,118,250,223
Western,Radford City,51750,135,542,677,186,1183,1369,18058,141459,159517,07/01/2018 12:00:00 AM,134,261,236
Western,Radford City,51750,135,594,729,174,1268,1442,39535,264863,304398,03/01/2021 12:00:00 AM,293,446,418
Western,Radford City,51750,136,546,682,197,1227,1424,18870,145246,164116,08/01/2018 12:00:00 AM,139,266,241
Western,Radford City,51750,136,596,732,184,1269,1453,33747,219773,253520,05/01/2020 12:00:00 AM,248,369,346
Western,Radford City,51750,137,553,690,184,1186,1370,18388,139734,158122,12/01/2019 12:00:00 AM,134,253,229
Western,Radford City,51750,137,603,740,207,1324,1531,21249,156992,178241,10/01/2015 12:00:00 AM,155,260,241
Western,Radford City,51750,138,522,660,192,1160,1352,17944,140636,158580,10/01/2018 12:00:00 AM,130,269,240
Western,Radford City,51750,138,524,662,176,1133,1309,17227,137549,154776,10/01/2019 12:00:00 AM,125,262,234
Western,Radford City,51750,138,525,663,195,1162,1357,18823,138762,157585,11/01/2018 12:00:00 AM,136,264,238
Western,Radford City,51750,138,611,749,201,1352,1553,18176,160082,178258,09/01/2015 12:00:00 AM,132,262,238
Western,Radford City,51750,138,698,836,229,1478,1707,24292,185184,209476,02/01/2012 12:00:00 AM,176,265,251
Western,Radford City,51750,139,513,652,188,1131,1319,17785,131562,149347,07/01/2019 12:00:00 AM,128,256,229
Western,Radford City,51750,139,514,653,187,1139,1326,16914,134894,151808,03/01/2019 12:00:00 AM,122,262,232
Western,Radford City,51750,139,525,664,177,1135,1312,16119,134446,150565,09/01/2019 12:00:00 AM,116,256,227
Western,Radford City,51750,139,710,849,247,1492,1739,26343,189920,216263,06/01/2012 12:00:00 AM,190,267,255
Western,Radford City,51750,140,495,635,194,1095,1289,17973,126124,144097,05/01/2019 12:00:00 AM,128,255,227
Western,Radford City,51750,140,501,641,190,1122,1312,17293,133782,151075,04/01/2019 12:00:00 AM,124,267,236
Western,Radford City,51750,140,518,658,188,1136,1324,16989,129111,146100,06/01/2019 12:00:00 AM,121,249,222
Western,Radford City,51750,140,616,756,233,1375,1608,23984,168416,192400,02/01/2015 12:00:00 AM,171,273,254
Western,Radford City,51750,140,688,828,226,1467,1693,24448,181177,205625,11/01/2014 12:00:00 AM,175,263,248
Western,Radford City,51750,140,689,829,246,1436,1682,27042,180552,207594,03/01/2012 12:00:00 AM,193,262,250
Western,Radford City,51750,140,706,846,231,1458,1689,24978,182163,207141,01/01/2012 12:00:00 AM,178,258,245
Western,Radford City,51750,140,726,866,248,1524,1772,29044,192648,221692,08/01/2012 12:00:00 AM,207,265,256
Western,Radford City,51750,140,744,884,231,1542,1773,26123,194757,220880,10/01/2012 12:00:00 AM,187,262,250
Western,Radford City,51750,140,765,905,225,1587,1812,24861,203087,227948,12/01/2012 12:00:00 AM,178,265,252
Western,Radford City,51750,141,597,738,189,1254,1443,34402,216627,251029,06/01/2020 12:00:00 AM,244,363,340
Western,Radford City,51750,141,601,742,183,1243,1426,42791,287416,330207,05/01/2021 12:00:00 AM,303,478,445
Western,Radford City,51750,141,608,749,184,1260,1444,44508,285379,329887,04/01/2021 12:00:00 AM,316,469,440
Western,Radford City,51750,141,753,894,238,1560,1798,27091,197617,224708,11/01/2012 12:00:00 AM,192,262,251
Western,Radford City,51750,141,762,903,238,1560,1798,28029,200041,228070,02/01/2013 12:00:00 AM,199,263,253
Western,Radford City,51750,142,601,743,215,1322,1537,20347,156981,177328,08/01/2015 12:00:00 AM,143,261,239
Western,Radford City,51750,142,702,844,231,1498,1729,24130,179599,203729,09/01/2014 12:00:00 AM,170,256,241
Western,Radford City,51750,143,590,733,183,1248,1431,43802,282237,326039,06/01/2021 12:00:00 AM,306,478,445
Western,Radford City,51750,143,615,758,240,1342,1582,25216,166569,191785,03/01/2015 12:00:00 AM,176,271,253
Western,Radford City,51750,143,625,768,239,1368,1607,25049,166154,191203,01/01/2015 12:00:00 AM,175,266,249
Western,Radford City,51750,143,694,837,236,1474,1710,25728,180715,206443,10/01/2014 12:00:00 AM,180,260,247
Western,Radford City,51750,143,760,903,235,1575,1810,26923,196266,223189,01/01/2013 12:00:00 AM,188,258,247
Western,Radford City,51750,144,572,716,188,1203,1391,36288,216342,252630,10/01/2020 12:00:00 AM,252,378,353
Western,Radford City,51750,144,586,730,193,1262,1455,42840,264628,307468,01/01/2021 12:00:00 AM,298,452,421
Western,Radford City,51750,144,596,740,193,1262,1455,35483,218827,254310,07/01/2020 12:00:00 AM,246,367,344
Western,Radford City,51750,145,740,885,259,1540,1799,30119,195083,225202,09/01/2012 12:00:00 AM,208,264,254
Western,Radford City,51750,146,581,727,193,1241,1434,35481,214026,249507,09/01/2020 12:00:00 AM,243,368,343
Western,Radford City,51750,146,584,730,196,1254,1450,37535,229205,266740,12/01/2020 12:00:00 AM,257,392,365
Western,Radford City,51750,146,595,741,242,1319,1561,24734,160520,185254,04/01/2015 12:00:00 AM,169,270,250
Western,Radford City,51750,146,610,756,222,1350,1572,21537,158949,180486,07/01/2015 12:00:00 AM,148,261,239
Western,Radford City,51750,146,655,801,244,1420,1664,26351,172423,198774,12/01/2014 12:00:00 AM,180,263,248
Western,Radford City,51750,146,692,838,240,1471,1711,25159,175134,200293,08/01/2014 12:00:00 AM,172,253,239
Western,Radford City,51750,146,710,856,260,1482,1742,30745,188905,219650,07/01/2012 12:00:00 AM,211,266,257
Western,Radford City,51750,146,740,886,248,1522,1770,29485,195459,224944,05/01/2013 12:00:00 AM,202,264,254
Western,Radford City,51750,146,747,893,239,1532,1771,28467,197962,226429,04/01/2013 12:00:00 AM,195,265,254
Western,Radford City,51750,146,751,897,243,1547,1790,29402,201079,230481,03/01/2013 12:00:00 AM,201,268,257
Western,Radford City,51750,147,563,710,190,1187,1377,37469,221586,259055,11/01/2020 12:00:00 AM,255,394,365
Western,Radford City,51750,147,593,740,197,1262,1459,36213,215268,251481,08/01/2020 12:00:00 AM,246,363,340
Western,Radford City,51750,147,609,756,246,1346,1592,23812,161382,185194,05/01/2015 12:00:00 AM,162,265,245
Western,Radford City,51750,147,735,882,243,1519,1762,27868,198191,226059,07/01/2013 12:00:00 AM,190,270,256
Western,Radford City,51750,150,607,757,239,1336,1575,23629,159582,183211,06/01/2015 12:00:00 AM,158,263,242
Western,Radford City,51750,151,744,895,253,1538,1791,30526,197749,228275,06/01/2013 12:00:00 AM,202,266,255
Western,Radford City,51750,152,729,881,254,1519,1773,27352,184571,211923,05/01/2014 12:00:00 AM,180,253,241
Western,Radford City,51750,152,729,881,256,1535,1791,26780,184136,210916,06/01/2014 12:00:00 AM,176,253,239
Western,Radford City,51750,152,739,891,251,1523,1774,30350,197387,227737,09/01/2013 12:00:00 AM,200,267,256
Western,Radford City,51750,153,707,860,261,1492,1753,28519,179314,207833,07/01/2014 12:00:00 AM,186,254,242
Western,Radford City,51750,155,747,902,255,1563,1818,27925,189047,216972,04/01/2014 12:00:00 AM,180,253,241
Western,Radford City,51750,156,718,874,263,1472,1735,30529,191142,221671,08/01/2013 12:00:00 AM,196,266,254
Western,Radford City,51750,158,727,885,281,1491,1772,31485,176442,207927,11/01/2013 12:00:00 AM,199,243,235
Western,Radford City,51750,158,735,893,270,1526,1796,29348,181227,210575,03/01/2014 12:00:00 AM,186,247,236
Western,Radford City,51750,159,742,901,270,1525,1795,32484,197010,229494,10/01/2013 12:00:00 AM,204,266,255
Western,Radford City,51750,160,734,894,282,1514,1796,31636,178676,210312,12/01/2013 12:00:00 AM,198,243,235
Western,Radford City,51750,162,726,888,281,1494,1775,30930,178522,209452,02/01/2014 12:00:00 AM,191,246,236
Western,Radford City,51750,169,727,896,306,1493,1799,34853,173202,208055,01/01/2014 12:00:00 AM,206,238,232
Western,Russell County,51167,556,2005,2561,712,4319,5031,131228,743534,874762,03/01/2020 12:00:00 AM,236,371,342
Western,Russell County,51167,557,1970,2527,711,4229,4940,54555,485491,540046,02/01/2020 12:00:00 AM,98,246,214
Western,Russell County,51167,558,1961,2519,707,4241,4948,55047,487549,542596,11/01/2019 12:00:00 AM,99,249,215
Western,Russell County,51167,565,2146,2711,700,4702,5402,159115,981903,1141018,02/01/2021 12:00:00 AM,282,458,421
Western,Russell County,51167,566,1972,2538,721,4255,4976,57230,489956,547186,12/01/2019 12:00:00 AM,101,248,216
Western,Russell County,51167,566,2097,2663,704,4581,5285,165294,1038877,1204171,04/01/2021 12:00:00 AM,292,495,452
Western,Russell County,51167,567,1959,2526,722,4232,4954,53946,484538,538484,01/01/2020 12:00:00 AM,95,247,213
Western,Russell County,51167,571,2136,2707,741,4585,5326,137556,788384,925940,05/01/2020 12:00:00 AM,241,369,342
Western,Russell County,51167,572,2146,2718,745,4597,5342,137528,795583,933111,06/01/2020 12:00:00 AM,240,371,343
Western,Russell County,51167,573,2098,2671,741,4506,5247,136417,776233,912650,04/01/2020 12:00:00 AM,238,370,342
Western,Russell County,51167,573,2132,2705,715,4670,5385,160545,972771,1133316,03/01/2021 12:00:00 AM,280,456,419
Western,Russell County,51167,574,1953,2527,736,4208,4944,58613,489466,548079,09/01/2019 12:00:00 AM,102,251,217
Western,Russell County,51167,575,2119,2694,730,4675,5405,163330,974526,1137856,01/01/2021 12:00:00 AM,284,460,422
Western,Russell County,51167,577,1950,2527,736,4208,4944,56782,486729,543511,08/01/2019 12:00:00 AM,98,250,215
Western,Russell County,51167,578,1955,2533,736,4241,4977,60182,488470,548652,10/01/2019 12:00:00 AM,104,250,217
Western,Russell County,51167,578,2082,2660,723,4510,5233,170844,1027448,1198292,06/01/2021 12:00:00 AM,296,493,450
Western,Russell County,51167,578,2146,2724,737,4663,5400,143816,846207,990023,12/01/2020 12:00:00 AM,249,394,363
Western,Russell County,51167,578,2161,2739,741,4717,5458,144383,855540,999923,10/01/2020 12:00:00 AM,250,396,365
Western,Russell County,51167,579,2073,2652,720,4508,5228,167887,1010543,1178430,05/01/2021 12:00:00 AM,290,487,444
Western,Russell County,51167,579,2186,2765,753,4756,5509,138519,823795,962314,09/01/2020 12:00:00 AM,239,377,348
Western,Russell County,51167,580,2163,2743,744,4740,5484,145709,869699,1015408,11/01/2020 12:00:00 AM,251,402,370
Western,Russell County,51167,585,1925,2510,759,4140,4899,59568,478418,537986,06/01/2019 12:00:00 AM,102,249,214
Western,Russell County,51167,585,1949,2534,755,4196,4951,59085.4,484777,543862.4,07/01/2019 12:00:00 AM,101,249,215
Western,Russell County,51167,589,1878,2467,750,4068,4818,56118,463784,519902,02/01/2019 12:00:00 AM,95,247,211
Western,Russell County,51167,589,1917,2506,772,4115,4887,60631,474479,535110,05/01/2019 12:00:00 AM,103,248,214
Western,Russell County,51167,589,2189,2778,772,4685,5457,142365,809795,952160,07/01/2020 12:00:00 AM,242,370,343
Western,Russell County,51167,589,2195,2784,773,4744,5517,142721,812255,954976,08/01/2020 12:00:00 AM,242,370,343
Western,Russell County,51167,594,1929,2523,745,4191,4936,59204,485262,544466,07/01/2018 12:00:00 AM,100,252,216
Western,Russell County,51167,596,1918,2514,775,4098,4873,60787.46,473793,534580.46,04/01/2019 12:00:00 AM,102,247,213
Western,Russell County,51167,598,1971,2569,775,4239,5014,59567,487337,546904,03/01/2019 12:00:00 AM,100,247,213
Western,Russell County,51167,599,1963,2562,751,4254,5005,59160,487673,546833,06/01/2018 12:00:00 AM,99,248,213
Western,Russell County,51167,600,1926,2526,754,4168,4922,60600,483051.98,543651.98,12/01/2018 12:00:00 AM,101,251,215
Western,Russell County,51167,600,1943,2543,755,4213,4968,60700,481579,542279,08/01/2018 12:00:00 AM,101,248,213
Western,Russell County,51167,601,1926,2527,760,4158,4918,60044,483162,543206,09/01/2018 12:00:00 AM,100,251,215
Western,Russell County,51167,601,1974,2575,761,4225,4986,61395,481086,542481,03/01/2018 12:00:00 AM,102,244,211
Western,Russell County,51167,602,1943,2545,774,4196,4970,61739,493328,555067,01/01/2019 12:00:00 AM,103,254,218
Western,Russell County,51167,603,1920,2523,766,4183,4949,63208,487746,550954,11/01/2018 12:00:00 AM,105,254,218
Western,Russell County,51167,603,1965,2568,768,4218,4986,60604,484985,545589,02/01/2018 12:00:00 AM,101,247,212
Western,Russell County,51167,606,1990,2596,769,4251,5020,63238,490329.94,553567.94,04/01/2018 12:00:00 AM,104,246,213
Western,Russell County,51167,607,1955,2562,767,4220,4987,61735,482577,544312,05/01/2018 12:00:00 AM,102,247,212
Western,Russell County,51167,612,2004,2616,775,4273,5048,62013,492609,554622,01/01/2018 12:00:00 AM,101,246,212
Western,Russell County,51167,615,1947,2562,776,4196,4972,63412,495971,559383,10/01/2018 12:00:00 AM,103,255,218
Western,Russell County,51167,618,2007,2625,791,4353,5144,66376,508679,575055,07/01/2017 12:00:00 AM,107,253,219
Western,Russell County,51167,621,1990,2611,794,4348,5142,67983,506236,574219,09/01/2017 12:00:00 AM,109,254,220
Western,Russell County,51167,621,2024,2645,792,4381,5173,67432,514430,581862,08/01/2017 12:00:00 AM,109,254,220
Western,Russell County,51167,622,2009,2631,790,4296,5086,66320,495029,561349,11/01/2017 12:00:00 AM,107,246,213
Western,Russell County,51167,622,2013,2635,789,4322,5111,67662,498762,566424,10/01/2017 12:00:00 AM,109,248,215
Western,Russell County,51167,623,2014,2637,794,4398,5192,67049,513552,580601,06/01/2017 12:00:00 AM,108,255,220
Western,Russell County,51167,624,2026,2650,799,4406,5205,67310,513135,580445,05/01/2017 12:00:00 AM,108,253,219
Western,Russell County,51167,626,2003,2629,800,4265,5065,68779,491499,560278,12/01/2017 12:00:00 AM,110,245,213
Western,Russell County,51167,631,2048,2679,798,4454,5252,67777,520390,588167,04/01/2017 12:00:00 AM,107,254,220
Western,Russell County,51167,643,2059,2702,813,4492,5305,69020,531366,600386,03/01/2017 12:00:00 AM,107,258,222
Western,Russell County,51167,645,2065,2710,821,4508,5329,70091,525949,596040,02/01/2017 12:00:00 AM,109,255,220
Western,Russell County,51167,655,2092,2747,836,4556,5392,71977,529109,601086,01/01/2017 12:00:00 AM,110,253,219
Western,Russell County,51167,662,2046,2708,843,4485,5328,72371,515327,587698,12/01/2016 12:00:00 AM,109,252,217
Western,Russell County,51167,664,2078,2742,853,4567,5420,73003,526406,599409,10/01/2016 12:00:00 AM,110,253,219
Western,Russell County,51167,665,2056,2721,852,4506,5358,73276,518215,591491,11/01/2016 12:00:00 AM,110,252,217
Western,Russell County,51167,665,2110,2775,881,4691,5572,76609,540722,617331,08/01/2016 12:00:00 AM,115,256,222
Western,Russell County,51167,665,2141,2806,888,4841,5729,76579,556011,632590,02/01/2016 12:00:00 AM,115,260,225
Western,Russell County,51167,666,2092,2758,860,4629,5489,74379,528869,603248,09/01/2016 12:00:00 AM,112,253,219
Western,Russell County,51167,668,2132,2800,905,4836,5741,77347,549798,627145,01/01/2016 12:00:00 AM,116,258,224
Western,Russell County,51167,670,2117,2787,896,4745,5641,77746,544350,622096,07/01/2016 12:00:00 AM,116,257,223
Western,Russell County,51167,670,2133,2803,895,4858,5753,75801,549174,624975,12/01/2015 12:00:00 AM,113,257,223
Western,Russell County,51167,671,2154,2825,907,4869,5776,79120,560120,639240,03/01/2016 12:00:00 AM,118,260,226
Western,Russell County,51167,674,2127,2801,915,4830,5745,79556,546188,625744,10/01/2015 12:00:00 AM,118,257,223
Western,Russell County,51167,674,2129,2803,906,4846,5752,78887,551391,630278,11/01/2015 12:00:00 AM,117,259,225
Western,Russell County,51167,674,2141,2815,911,4849,5760,79974,553686,633660,04/01/2016 12:00:00 AM,119,259,225
Western,Russell County,51167,677,2141,2818,908,4831,5739,79981,550693,630674,05/01/2016 12:00:00 AM,118,257,224
Western,Russell County,51167,678,2107,2785,929,4839,5768,80819,552727,633546,08/01/2015 12:00:00 AM,119,262,227
Western,Russell County,51167,679,2126,2805,908,4786,5694,80330,543424,623754,06/01/2016 12:00:00 AM,118,256,222
Western,Russell County,51167,681,2094,2775,918,4827,5745,79738,551277,631015,06/01/2015 12:00:00 AM,117,263,227
Western,Russell County,51167,681,2110,2791,927,4810,5737,80699,547981,628680,09/01/2015 12:00:00 AM,119,260,225
Western,Russell County,51167,687,2090,2777,950,4784,5734,84189,547895,632084,07/01/2015 12:00:00 AM,123,262,228
Western,Russell County,51167,690,2087,2777,945,4790,5735,82613,547937,630550,04/01/2015 12:00:00 AM,120,263,227
Western,Russell County,51167,691,2079,2770,943,4788,5731,83109,546007,629116,05/01/2015 12:00:00 AM,120,263,227
Western,Russell County,51167,697,2117,2814,966,4936,5902,85816,562231,648047,02/01/2015 12:00:00 AM,123,266,230
Western,Russell County,51167,701,2104,2805,962,4878,5840,84415,552571,636986,03/01/2015 12:00:00 AM,120,263,227
Western,Russell County,51167,709,2141,2850,1009,4945,5954,93034,567668,660702,12/01/2014 12:00:00 AM,131,265,232
Western,Russell County,51167,715,2150,2865,1011,4974,5985,90357,559456,649813,01/01/2015 12:00:00 AM,126,260,227
Western,Russell County,51167,717,2135,2852,1022,4915,5937,96885,569245,666130,11/01/2014 12:00:00 AM,135,267,234
Western,Russell County,51167,725,2175,2900,1042,4996,6038,97696,578884,676580,10/01/2014 12:00:00 AM,135,266,233
Western,Russell County,51167,728,2259,2987,1045,5151,6196,89646,583914,673560,08/01/2014 12:00:00 AM,123,258,225
Western,Russell County,51167,732,2221,2953,1056,5067,6123,91914,568501,660415,09/01/2014 12:00:00 AM,126,256,224
Western,Russell County,51167,735,2281,3016,1036,5177,6213,88832,584779,673611,06/01/2014 12:00:00 AM,121,256,223
Western,Russell County,51167,736,2262,2998,1061,5129,6190,91441,581265,672706,07/01/2014 12:00:00 AM,124,257,224
Western,Russell County,51167,744,2043,2787,1067,4728,5795,98368,561985,660353,05/01/2012 12:00:00 AM,132,275,237
Western,Russell County,51167,745,2276,3021,1079,5134,6213,96570,580218,676788,05/01/2014 12:00:00 AM,130,255,224
Western,Russell County,51167,748,2277,3025,1080,5128,6208,94218,577198,671416,04/01/2014 12:00:00 AM,126,253,222
Western,Russell County,51167,752,2292,3044,1101,5145,6246,93410,577867,671277,02/01/2014 12:00:00 AM,124,252,221
Western,Russell County,51167,753,2295,3048,1110,5137,6247,96277,575986,672263,03/01/2014 12:00:00 AM,128,251,221
Western,Russell County,51167,756,2044,2800,1099,4720,5819,102001,559385,661386,04/01/2012 12:00:00 AM,135,274,236
Western,Russell County,51167,758,2066,2824,1125,4795,5920,105802,561691,667493,02/01/2012 12:00:00 AM,140,272,236
Western,Russell County,51167,758,2243,3001,1102,5035,6137,106996,610245,717241,09/01/2013 12:00:00 AM,141,272,239
Western,Russell County,51167,759,2057,2816,1116,4753,5869,103757,558600,662357,03/01/2012 12:00:00 AM,137,272,235
Western,Russell County,51167,760,2050,2810,1121,4782,5903,105383,556504,661887,01/01/2012 12:00:00 AM,139,271,236
Western,Russell County,51167,761,2034,2795,1110,4683,5793,104794,556088,660882,06/01/2012 12:00:00 AM,138,273,236
Western,Russell County,51167,761,2060,2821,1099,4746,5845,103557,569818,673375,07/01/2012 12:00:00 AM,136,277,239
Western,Russell County,51167,762,2240,3002,1118,5072,6190,107018,614617,721635,06/01/2013 12:00:00 AM,140,274,240
Western,Russell County,51167,764,2200,2964,1122,5024,6146,108645,602368,711013,03/01/2013 12:00:00 AM,142,274,240
Western,Russell County,51167,766,2265,3031,1128,5022,6150,101481,563600,665081,12/01/2013 12:00:00 AM,132,249,219
Western,Russell County,51167,766,2296,3062,1121,5081,6202,97769,565839,663608,01/01/2014 12:00:00 AM,128,246,217
Western,Russell County,51167,767,2190,2957,1128,5002,6130,111346,598760,710106,02/01/2013 12:00:00 AM,145,273,240
Western,Russell County,51167,768,2222,2990,1133,5008,6141,108346,605174,713520,07/01/2013 12:00:00 AM,141,272,239
Western,Russell County,51167,769,2219,2988,1128,5010,6138,107674,605935,713609,08/01/2013 12:00:00 AM,140,273,239
Western,Russell County,51167,770,2241,3011,1138,4963,6101,113604,607109,720713,10/01/2013 12:00:00 AM,148,271,239
Western,Russell County,51167,770,2253,3023,1155,4961,6116,105501,562808,668309,11/01/2013 12:00:00 AM,137,250,221
Western,Russell County,51167,776,2201,2977,1150,5009,6159,111024,601720,712744,04/01/2013 12:00:00 AM,143,273,239
Western,Russell County,51167,776,2213,2989,1144,5008,6152,110968,606161,717129,05/01/2013 12:00:00 AM,143,274,240
Western,Russell County,51167,777,2087,2864,1138,4801,5939,107803,578147,685950,08/01/2012 12:00:00 AM,139,277,240
Western,Russell County,51167,777,2120,2897,1153,4858,6011,112157,582463,694620,09/01/2012 12:00:00 AM,144,275,240
Western,Russell County,51167,779,2165,2944,1152,4951,6103,116142,589121,705263,12/01/2012 12:00:00 AM,149,272,240
Western,Russell County,51167,783,2164,2947,1165,4936,6101,115709,584721,700430,01/01/2013 12:00:00 AM,148,270,238
Western,Russell County,51167,784,2165,2949,1162,4940,6102,118046,587573,705619,11/01/2012 12:00:00 AM,151,271,239
Western,Russell County,51167,785,2149,2934,1163,4910,6073,117573,588322,705895,10/01/2012 12:00:00 AM,150,274,241
Western,Scott County,51169,421,1150,1571,530,2566,3096,36908,268161,305069,06/01/2019 12:00:00 AM,88,233,194
Western,Scott County,51169,423,1135,1558,526,2533,3059,36561,266362,302923,05/01/2019 12:00:00 AM,86,235,194
Western,Scott County,51169,423,1138,1561,521,2543,3064,39095,265876,304971,10/01/2019 12:00:00 AM,92,234,195
Western,Scott County,51169,426,1161,1587,534,2597,3131,39285,275683,314968,09/01/2019 12:00:00 AM,92,237,198
Western,Scott County,51169,428,1161,1589,537,2610,3147,41585,268542,310127,11/01/2019 12:00:00 AM,97,231,195
Western,Scott County,51169,428,1178,1606,535,2662,3197,41178,275605,316783,12/01/2019 12:00:00 AM,96,234,197
Western,Scott County,51169,430,1145,1575,540,2555,3095,37946,269529,307475,07/01/2019 12:00:00 AM,88,235,195
Western,Scott County,51169,430,1188,1618,540,2707,3247,41655,282389,324044,06/01/2018 12:00:00 AM,97,238,200
Western,Scott County,51169,431,1156,1587,547,2591,3138,42384,271454,313838,08/01/2019 12:00:00 AM,98,235,198
Western,Scott County,51169,431,1177,1608,541,2617,3158,100880,445629,546509,03/01/2020 12:00:00 AM,234,379,340
Western,Scott County,51169,432,1162,1594,549,2582,3131,40075,269964,310039,02/01/2020 12:00:00 AM,93,232,195
Western,Scott County,51169,433,1174,1607,554,2643,3197,41877,274410,316287,01/01/2020 12:00:00 AM,97,234,197
Western,Scott County,51169,434,1229,1663,513,2747,3260,118634,610029,728663,06/01/2021 12:00:00 AM,273,496,438
Western,Scott County,51169,434,1252,1686,502,2818,3320,115621,587532,703153,02/01/2021 12:00:00 AM,266,469,417
Western,Scott County,51169,436,1136,1572,551,2545,3096,40683,268491,309174,04/01/2019 12:00:00 AM,93,236,197
Western,Scott County,51169,436,1205,1641,554,2722,3276,42981,283791,326772,05/01/2018 12:00:00 AM,99,236,199
Western,Scott County,51169,436,1223,1659,546,2776,3322,41078,289073,330151,04/01/2018 12:00:00 AM,94,236,199
Western,Scott County,51169,436,1265,1701,519,2833,3352,120183,633578,753761,04/01/2021 12:00:00 AM,276,501,443
Western,Scott County,51169,437,1247,1684,520,2800,3320,121083,619156,740239,05/01/2021 12:00:00 AM,277,497,440
Western,Scott County,51169,438,1097,1535,549,2491,3040,40223,260043,300266,02/01/2019 12:00:00 AM,92,237,196
Western,Scott County,51169,438,1200,1638,552,2755,3307,41763,290983,332746,07/01/2018 12:00:00 AM,95,242,203
Western,Scott County,51169,438,1237,1675,565,2891,3456,45492,301400,346892,10/01/2017 12:00:00 AM,104,244,207
Western,Scott County,51169,438,1249,1687,542,2752,3294,100696,472458,573154,04/01/2020 12:00:00 AM,230,378,340
Western,Scott County,51169,438,1283,1721,510,2897,3407,115176,600778,715954,03/01/2021 12:00:00 AM,263,468,416
Western,Scott County,51169,439,1223,1662,549,2794,3343,42126,287003,329129,03/01/2018 12:00:00 AM,96,235,198
Western,Scott County,51169,440,1127,1567,549,2551,3100,39450,265080,304530,03/01/2019 12:00:00 AM,90,235,194
Western,Scott County,51169,440,1196,1636,556,2746,3302,42384,289644,332028,08/01/2018 12:00:00 AM,96,242,203
Western,Scott County,51169,440,1226,1666,556,2821,3377,45992,291292,337284,02/01/2018 12:00:00 AM,105,238,202
Western,Scott County,51169,440,1239,1679,562,2875,3437,44884,311700,356584,09/01/2017 12:00:00 AM,102,252,212
Western,Scott County,51169,441,1236,1677,535,2761,3296,121755,570120,691875,01/01/2021 12:00:00 AM,276,461,413
Western,Scott County,51169,441,1236,1677,555,2866,3421,42739,313747,356486,08/01/2017 12:00:00 AM,97,254,213
Western,Scott County,51169,441,1243,1684,562,2870,3432,44552,295926,340478,01/01/2018 12:00:00 AM,101,238,202
Western,Scott County,51169,443,1184,1627,551,2706,3257,42963,288008,330971,09/01/2018 12:00:00 AM,97,243,203
Western,Scott County,51169,444,1255,1699,570,2873,3443,44176,315434,359610,05/01/2017 12:00:00 AM,99,251,212
Western,Scott County,51169,445,1162,1607,550,2670,3220,44272,284678,328950,11/01/2018 12:00:00 AM,99,245,205
Western,Scott County,51169,446,1157,1603,559,2636,3195,44341,279219,323560,10/01/2018 12:00:00 AM,99,241,202
Western,Scott County,51169,446,1249,1695,582,2897,3479,48646,298646,347292,12/01/2017 12:00:00 AM,109,239,205
Western,Scott County,51169,446,1277,1723,551,2837,3388,103557,491913,595470,05/01/2020 12:00:00 AM,232,385,346
Western,Scott County,51169,447,1244,1691,572,2867,3439,45520,317879,363399,06/01/2017 12:00:00 AM,102,256,215
Western,Scott County,51169,447,1289,1736,551,2836,3387,103127,488690,591817,06/01/2020 12:00:00 AM,231,379,341
Western,Scott County,51169,448,1152,1600,559,2653,3212,44668.55,290629.59,335298.14,12/01/2018 12:00:00 AM,100,252,210
Western,Scott County,51169,448,1223,1671,572,2833,3405,45122,308970,354092,07/01/2017 12:00:00 AM,101,253,212
Western,Scott County,51169,448,1242,1690,548,2752,3300,108088,508541,616629,11/01/2020 12:00:00 AM,241,409,365
Western,Scott County,51169,448,1257,1705,571,2889,3460,43957,309803,353760,04/01/2017 12:00:00 AM,98,246,207
Western,Scott County,51169,449,1292,1741,588,2955,3543,47223,322511,369734,03/01/2017 12:00:00 AM,105,250,212
Western,Scott County,51169,450,1225,1675,557,2742,3299,108309,504729,613038,12/01/2020 12:00:00 AM,241,412,366
Western,Scott County,51169,450,1255,1705,583,2935,3518,47695,309341,357036,11/01/2017 12:00:00 AM,106,246,209
Western,Scott County,51169,450,1303,1753,600,3042,3642,48991,325047,374038,11/01/2016 12:00:00 AM,109,249,213
Western,Scott County,51169,452,1154,1606,565,2622,3187,42748,288022,330770,01/01/2019 12:00:00 AM,95,250,206
Western,Scott County,51169,452,1295,1747,600,3001,3601,48109,320896,369005,02/01/2017 12:00:00 AM,106,248,211
Western,Scott County,51169,454,1302,1756,606,3021,3627,49288,322058,371346,12/01/2016 12:00:00 AM,109,247,211
Western,Scott County,51169,456,1303,1759,607,2995,3602,48925,319698,368623,01/01/2017 12:00:00 AM,107,245,210
Western,Scott County,51169,456,1312,1768,573,2913,3486,106765,500420,607185,07/01/2020 12:00:00 AM,234,381,343
Western,Scott County,51169,459,1289,1748,580,2854,3434,108638,486113,594751,09/01/2020 12:00:00 AM,237,377,340
Western,Scott County,51169,459,1322,1781,586,2932,3518,108021,506531,614552,08/01/2020 12:00:00 AM,235,383,345
Western,Scott County,51169,460,1258,1718,578,2755,3333,113380,501140,614520,10/01/2020 12:00:00 AM,246,398,358
Western,Scott County,51169,462,1301,1763,633,3016,3649,53835,324436,378271,10/01/2016 12:00:00 AM,117,249,215
Western,Scott County,51169,470,1273,1743,637,2975,3612,51944,317096,369040,06/01/2016 12:00:00 AM,111,249,212
Western,Scott County,51169,470,1285,1755,661,2967,3628,56924,318904,375828,09/01/2016 12:00:00 AM,121,248,214
Western,Scott County,51169,471,1267,1738,645,2970,3615,53282,314764,368046,05/01/2016 12:00:00 AM,113,248,212
Western,Scott County,51169,471,1293,1764,663,2968,3631,55236,318095,373331,08/01/2016 12:00:00 AM,117,246,212
Western,Scott County,51169,472,1274,1746,648,2960,3608,54191,318393,372584,07/01/2016 12:00:00 AM,115,250,213
Western,Scott County,51169,475,1279,1754,651,3014,3665,53607,320351,373958,04/01/2016 12:00:00 AM,113,250,213
Western,Scott County,51169,476,1286,1762,661,3027,3688,54628,319281,373909,03/01/2016 12:00:00 AM,115,248,212
Western,Scott County,51169,482,1259,1741,671,3033,3704,56524,321239,377763,10/01/2015 12:00:00 AM,117,255,217
Western,Scott County,51169,483,1249,1732,675,2990,3665,57545,316569,374114,09/01/2015 12:00:00 AM,119,253,216
Western,Scott County,51169,483,1300,1783,675,3079,3754,56211,324838,381049,02/01/2016 12:00:00 AM,116,250,214
Western,Scott County,51169,485,1276,1761,671,3053,3724,56387,323193,379580,11/01/2015 12:00:00 AM,116,253,216
Western,Scott County,51169,487,1277,1764,686,3050,3736,57926,321182,379108,01/01/2016 12:00:00 AM,119,252,215
Western,Scott County,51169,488,1267,1755,693,3044,3737,59810,324564,384374,12/01/2015 12:00:00 AM,123,256,219
Western,Scott County,51169,489,1243,1732,686,2975,3661,57320,310056,367376,08/01/2015 12:00:00 AM,117,249,212
Western,Scott County,51169,496,1237,1733,693,2984,3677,57187,311121,368308,07/01/2015 12:00:00 AM,115,252,213
Western,Scott County,51169,497,1316,1813,710,3187,3897,53609,328182,381791,07/01/2014 12:00:00 AM,108,249,211
Western,Scott County,51169,500,1272,1772,727,3096,3823,56857,317555,374412,09/01/2014 12:00:00 AM,114,250,211
Western,Scott County,51169,500,1344,1844,718,3263,3981,53968,333227,387195,06/01/2014 12:00:00 AM,108,248,210
Western,Scott County,51169,502,1285,1787,722,3137,3859,55505,319027,374532,08/01/2014 12:00:00 AM,111,248,210
Western,Scott County,51169,502,1374,1876,720,3335,4055,55071,346360,401431,05/01/2014 12:00:00 AM,110,252,214
Western,Scott County,51169,504,1204,1708,739,2919,3658,63414,301537,364951,05/01/2015 12:00:00 AM,126,250,214
Western,Scott County,51169,505,1225,1730,730,2949,3679,61847,306461,368308,06/01/2015 12:00:00 AM,122,250,213
Western,Scott County,51169,508,1399,1907,738,3393,4131,56772,350193,406965,04/01/2014 12:00:00 AM,112,250,213
Western,Scott County,51169,509,1213,1722,741,2952,3693,63890,304225,368115,04/01/2015 12:00:00 AM,126,251,214
Western,Scott County,51169,514,1244,1758,757,3040,3797,66365,316821,383186,10/01/2014 12:00:00 AM,129,255,218
Western,Scott County,51169,516,1417,1933,756,3395,4151,59591,349253,408844,03/01/2014 12:00:00 AM,115,246,212
Western,Scott County,51169,518,1244,1762,762,3045,3807,66902,319722,386624,11/01/2014 12:00:00 AM,129,257,219
Western,Scott County,51169,519,1426,1945,763,3406,4169,60458,349120,409578,02/01/2014 12:00:00 AM,116,245,211
Western,Scott County,51169,523,1217,1740,760,2968,3728,66190,307142,373332,03/01/2015 12:00:00 AM,127,252,215
Western,Scott County,51169,529,1232,1761,778,2996,3774,68720,311413,380133,12/01/2014 12:00:00 AM,130,253,216
Western,Scott County,51169,529,1234,1763,775,3015,3790,68594,309423,378017,01/01/2015 12:00:00 AM,130,251,214
Western,Scott County,51169,530,1204,1734,772,2941,3713,68325,306948,375273,02/01/2015 12:00:00 AM,129,255,216
Western,Scott County,51169,531,1420,1951,795,3382,4177,64080,342985,407065,01/01/2014 12:00:00 AM,121,242,209
Western,Scott County,51169,532,1368,1900,777,3342,4119,69326,378866,448192,06/01/2013 12:00:00 AM,130,277,236
Western,Scott County,51169,534,1374,1908,798,3368,4166,71270,383081,454351,05/01/2013 12:00:00 AM,133,279,238
Western,Scott County,51169,536,1424,1960,798,3385,4183,65258,349924,415182,12/01/2013 12:00:00 AM,122,246,212
Western,Scott County,51169,538,1451,1989,798,3464,4262,64152,360158,424310,11/01/2013 12:00:00 AM,119,248,213
Western,Scott County,51169,540,1388,1928,795,3360,4155,70875,382269,453144,07/01/2013 12:00:00 AM,131,275,235
Western,Scott County,51169,542,1379,1921,820,3356,4176,73473,380395,453868,04/01/2013 12:00:00 AM,136,276,236
Western,Scott County,51169,542,1418,1960,800,3404,4204,70575,386609,457184,09/01/2013 12:00:00 AM,130,273,233
Western,Scott County,51169,543,1433,1976,801,3431,4232,70942,393060,464002,10/01/2013 12:00:00 AM,131,274,235
Western,Scott County,51169,544,1237,1781,865,3089,3954,78622,357681,436303,02/01/2012 12:00:00 AM,145,289,245
Western,Scott County,51169,544,1378,1922,825,3381,4206,74194,390291,464485,11/01/2012 12:00:00 AM,136,283,242
Western,Scott County,51169,544,1378,1922,829,3352,4181,75734,383119,458853,03/01/2013 12:00:00 AM,139,278,239
Western,Scott County,51169,545,1324,1869,832,3257,4089,73619,374679,448298,09/01/2012 12:00:00 AM,135,283,240
Western,Scott County,51169,545,1390,1935,821,3398,4219,73048,389080,462128,02/01/2013 12:00:00 AM,134,280,239
Western,Scott County,51169,545,1394,1939,806,3360,4166,71038,378264,449302,08/01/2013 12:00:00 AM,130,271,232
Western,Scott County,51169,546,1349,1895,842,3297,4139,76612,378993,455605,10/01/2012 12:00:00 AM,140,281,240
Western,Scott County,51169,548,1377,1925,837,3372,4209,75417,388740,464157,12/01/2012 12:00:00 AM,138,282,241
Western,Scott County,51169,550,1236,1786,869,3067,3936,78751,352207,430958,03/01/2012 12:00:00 AM,143,285,241
Western,Scott County,51169,554,1242,1796,891,3092,3983,80467,349211,429678,01/01/2012 12:00:00 AM,145,281,239
Western,Scott County,51169,554,1367,1921,845,3348,4193,76157,380416,456573,01/01/2013 12:00:00 AM,137,278,238
Western,Scott County,51169,555,1234,1789,883,3058,3941,80542,350369,430911,04/01/2012 12:00:00 AM,145,284,241
Western,Scott County,51169,555,1271,1826,859,3154,4013,75687,361308,436995,06/01/2012 12:00:00 AM,136,284,239
Western,Scott County,51169,556,1238,1794,877,3067,3944,78985,351174,430159,05/01/2012 12:00:00 AM,142,284,240
Western,Scott County,51169,558,1286,1844,853,3195,4048,76162,369870,446032,07/01/2012 12:00:00 AM,136,288,242
Western,Scott County,51169,563,1293,1856,852,3200,4052,76180,369585,445765,08/01/2012 12:00:00 AM,135,286,240
Western,Smyth County,51173,449,2267,2716,599,4509,5108,48612,513465,562077,11/01/2019 12:00:00 AM,108,226,207
Western,Smyth County,51173,449,2300,2749,597,4579,5176,51320,524935,576255,01/01/2020 12:00:00 AM,114,228,210
Western,Smyth County,51173,452,2250,2702,610,4466,5076,52882,512154,565036,02/01/2020 12:00:00 AM,117,228,209
Western,Smyth County,51173,453,2228,2681,610,4468,5078,51094,509143,560237,02/01/2019 12:00:00 AM,113,229,209
Western,Smyth County,51173,453,2274,2727,611,4509,5120,54994,524252,579246,10/01/2019 12:00:00 AM,121,231,212
Western,Smyth County,51173,455,2288,2743,610,4544,5154,112116,785061,897177,03/01/2020 12:00:00 AM,246,343,327
Western,Smyth County,51173,456,2306,2762,609,4591,5200,52847,529512,582359,12/01/2019 12:00:00 AM,116,230,211
Western,Smyth County,51173,457,2263,2720,607,4533,5140,49577,522204,571781,07/01/2019 12:00:00 AM,108,231,210
Western,Smyth County,51173,458,2275,2733,606,4578,5184,50180,530971,581151,06/01/2019 12:00:00 AM,110,233,213
Western,Smyth County,51173,459,2411,2870,603,4810,5413,110791,842882,953673,04/01/2020 12:00:00 AM,241,350,332
Western,Smyth County,51173,461,2296,2757,595,4686,5281,48575,537922,586497,07/01/2018 12:00:00 AM,105,234,213
Western,Smyth County,51173,462,2253,2715,612,4608,5220,51036,522694,573730,09/01/2018 12:00:00 AM,110,232,211
Western,Smyth County,51173,462,2270,2732,614,4577,5191,50387,520739,571126,04/01/2019 12:00:00 AM,109,229,209
Western,Smyth County,51173,462,2273,2735,626,4641,5267,56524,530023.5,586547.5,11/01/2018 12:00:00 AM,122,233,214
Western,Smyth County,51173,462,2278,2740,618,4572,5190,51114,526135,577249,05/01/2019 12:00:00 AM,111,231,211
Western,Smyth County,51173,464,2248,2712,629,4577,5206,54483,524038,578521,10/01/2018 12:00:00 AM,117,233,213
Western,Smyth County,51173,464,2253,2717,628,4516,5144,53481,518200,571681,09/01/2019 12:00:00 AM,115,230,210
Western,Smyth County,51173,465,2271,2736,628,4579,5207,53167,519640,572807,08/01/2019 12:00:00 AM,114,229,209
Western,Smyth County,51173,467,2289,2756,609,4673,5282,49806,531305,581111,06/01/2018 12:00:00 AM,107,232,211
Western,Smyth County,51173,467,2451,2918,616,4866,5482,113101,849726,962827,05/01/2020 12:00:00 AM,242,347,330
Western,Smyth County,51173,468,2271,2739,645,4571,5216,56346,531709,588055,01/01/2019 12:00:00 AM,120,234,215
Western,Smyth County,51173,469,2292,2761,632,4596,5228,52334,526303,578637,03/01/2019 12:00:00 AM,112,230,210
Western,Smyth County,51173,469,2313,2782,606,4724,5330,52096,543065,595161,04/01/2018 12:00:00 AM,111,235,214
Western,Smyth County,51173,469,2532,3001,620,5016,5636,115812,876453,992265,07/01/2020 12:00:00 AM,247,346,331
Western,Smyth County,51173,470,2271,2741,639,4607,5246,56575,522137,578712,12/01/2018 12:00:00 AM,120,230,211
Western,Smyth County,51173,471,2326,2797,621,4755,5376,52364,545563,597927,03/01/2018 12:00:00 AM,111,235,214
Western,Smyth County,51173,472,2536,3008,625,5043,5668,114996,872901.6,987897.6,08/01/2020 12:00:00 AM,244,344,328
Western,Smyth County,51173,474,2327,2801,618,4799,5417,51101,549030,600131,02/01/2018 12:00:00 AM,108,236,214
Western,Smyth County,51173,474,2494,2968,630,4905,5535,116617,855626,972243,06/01/2020 12:00:00 AM,246,343,328
Western,Smyth County,51173,474,2499,2973,632,4977,5609,115570,863417,978987,09/01/2020 12:00:00 AM,244,346,329
Western,Smyth County,51173,475,2289,2764,608,4661,5269,51436,538228,589664,05/01/2018 12:00:00 AM,108,235,213
Western,Smyth County,51173,475,2291,2766,630,4674,5304,53233,532892,586125,08/01/2018 12:00:00 AM,112,233,212
Western,Smyth County,51173,480,2341,2821,629,4794,5423,53781,545123,598904,01/01/2018 12:00:00 AM,112,233,212
Western,Smyth County,51173,481,2444,2925,625,4891,5516,138446,1044406,1182852,02/01/2021 12:00:00 AM,288,427,404
Western,Smyth County,51173,483,2326,2809,638,4795,5433,56226,546852,603078,11/01/2017 12:00:00 AM,116,235,215
Western,Smyth County,51173,485,2326,2811,645,4780,5425,57095,549556,606651,12/01/2017 12:00:00 AM,118,236,216
Western,Smyth County,51173,485,2345,2830,639,4841,5480,55132,557748,612880,10/01/2017 12:00:00 AM,114,238,217
Western,Smyth County,51173,485,2504,2989,658,4921,5579,126236,911958,1038194,10/01/2020 12:00:00 AM,260,364,347
Western,Smyth County,51173,486,2407,2893,645,4834,5479,143540,1014569,1158109,01/01/2021 12:00:00 AM,295,422,400
Western,Smyth County,51173,486,2433,2919,634,4858,5492,144010,1021973,1165983,03/01/2021 12:00:00 AM,296,420,399
Western,Smyth County,51173,488,2459,2947,648,4895,5543,125450,902296,1027746,12/01/2020 12:00:00 AM,257,367,349
Western,Smyth County,51173,488,2469,2957,647,4889,5536,125814,912838,1038652,11/01/2020 12:00:00 AM,258,370,351
Western,Smyth County,51173,493,2383,2876,642,4707,5349,148484,1097743,1246227,04/01/2021 12:00:00 AM,301,461,433
Western,Smyth County,51173,494,2361,2855,640,4912,5552,53758,575707,629465,08/01/2017 12:00:00 AM,109,244,220
Western,Smyth County,51173,501,2332,2833,668,4845,5513,57989,562544,620533,09/01/2017 12:00:00 AM,116,241,219
Western,Smyth County,51173,501,2398,2899,659,4736,5395,152956,1093483,1246439,05/01/2021 12:00:00 AM,305,456,430
Western,Smyth County,51173,508,2405,2913,676,4705,5381,157397,1098270,1255667,06/01/2021 12:00:00 AM,310,457,431
Western,Smyth County,51173,509,2333,2842,684,4837,5521,59567,564836,624403,07/01/2017 12:00:00 AM,117,242,220
Western,Smyth County,51173,512,2383,2895,675,4958,5633,57672,581039,638711,06/01/2017 12:00:00 AM,113,244,221
Western,Smyth County,51173,518,2457,2975,673,5162,5835,55685,602884,658569,02/01/2017 12:00:00 AM,108,245,221
Western,Smyth County,51173,520,2396,2916,671,4974,5645,56332,590932,647264,04/01/2017 12:00:00 AM,108,247,222
Western,Smyth County,51173,523,2472,2995,673,5211,5884,55558,602848,658406,01/01/2017 12:00:00 AM,106,244,220
Western,Smyth County,51173,524,2371,2895,692,4953,5645,59670,583653,643323,05/01/2017 12:00:00 AM,114,246,222
Western,Smyth County,51173,524,2423,2947,681,5027,5708,59397,594268,653665,03/01/2017 12:00:00 AM,113,245,222
Western,Smyth County,51173,534,2435,2969,697,5158,5855,59576,600011,659587,12/01/2016 12:00:00 AM,112,246,222
Western,Smyth County,51173,541,2393,2934,712,5104,5816,62228,585095,647323,11/01/2016 12:00:00 AM,115,245,221
Western,Smyth County,51173,542,2433,2975,712,5198,5910,60676,604694,665370,10/01/2016 12:00:00 AM,112,249,224
Western,Smyth County,51173,543,2432,2975,708,5212,5920,60994,602707,663701,09/01/2016 12:00:00 AM,112,248,223
Western,Smyth County,51173,547,2409,2956,719,5146,5865,59691,588190,647881,07/01/2016 12:00:00 AM,109,244,219
Western,Smyth County,51173,547,2434,2981,723,5186,5909,60663,593615,654278,06/01/2016 12:00:00 AM,111,244,219
Western,Smyth County,51173,552,2423,2975,729,5228,5957,60922,586736,647658,05/01/2016 12:00:00 AM,110,242,218
Western,Smyth County,51173,554,2423,2977,734,5161,5895,63087,590603,653690,08/01/2016 12:00:00 AM,114,244,220
Western,Smyth County,51173,571,2421,2992,766,5224,5990,64727,597461,662188,04/01/2016 12:00:00 AM,113,247,221
Western,Smyth County,51173,573,2464,3037,783,5322,6105,67973,608237,676210,03/01/2016 12:00:00 AM,119,247,223
Western,Smyth County,51173,575,2458,3033,785,5286,6071,67567,598953,666520,12/01/2015 12:00:00 AM,118,244,220
Western,Smyth County,51173,577,2457,3034,784,5296,6080,67769,598873,666642,01/01/2016 12:00:00 AM,117,244,220
Western,Smyth County,51173,580,2478,3058,798,5329,6127,68900,607364,676264,02/01/2016 12:00:00 AM,119,245,221
Western,Smyth County,51173,590,2445,3035,812,5270,6082,72134,603574,675708,11/01/2015 12:00:00 AM,122,247,223
Western,Smyth County,51173,602,2468,3070,822,5364,6186,71482,602319,673801,10/01/2015 12:00:00 AM,119,244,219
Western,Smyth County,51173,610,2454,3064,844,5425,6269,75507,618131,693638,05/01/2015 12:00:00 AM,124,252,226
Western,Smyth County,51173,610,2470,3080,845,5390,6235,74164,608909,683073,07/01/2015 12:00:00 AM,122,247,222
Western,Smyth County,51173,611,2455,3066,851,5440,6291,76373,622811,699184,04/01/2015 12:00:00 AM,125,254,228
Western,Smyth County,51173,612,2446,3058,856,5367,6223,76825,612922,689747,06/01/2015 12:00:00 AM,126,251,226
Western,Smyth County,51173,613,2474,3087,838,5411,6249,71920,615674,687594,08/01/2015 12:00:00 AM,117,249,223
Western,Smyth County,51173,617,2464,3081,875,5485,6360,79161,628469,707630,02/01/2015 12:00:00 AM,128,255,230
Western,Smyth County,51173,618,2475,3093,885,5492,6377,82846,625855,708701,12/01/2014 12:00:00 AM,134,253,229
Western,Smyth County,51173,620,2446,3066,874,5447,6321,78397,622534,700931,03/01/2015 12:00:00 AM,126,255,229
Western,Smyth County,51173,620,2563,3183,912,5598,6510,76542,613711,690253,06/01/2014 12:00:00 AM,123,239,217
Western,Smyth County,51173,621,2488,3109,890,5501,6391,79514,620305,699819,01/01/2015 12:00:00 AM,128,249,225
Western,Smyth County,51173,624,2438,3062,879,5317,6196,78026,601262,679288,09/01/2015 12:00:00 AM,125,247,222
Western,Smyth County,51173,624,2526,3150,926,5555,6481,78904,603842,682746,07/01/2014 12:00:00 AM,126,239,217
Western,Smyth County,51173,627,2471,3098,901,5475,6376,83869,624463,708332,11/01/2014 12:00:00 AM,134,253,229
Western,Smyth County,51173,628,2512,3140,912,5542,6454,76811,602891,679702,08/01/2014 12:00:00 AM,122,240,216
Western,Smyth County,51173,632,2523,3155,922,5553,6475,78622,607229,685851,09/01/2014 12:00:00 AM,124,241,217
Western,Smyth County,51173,632,2581,3213,939,5607,6546,78769,617571,696340,05/01/2014 12:00:00 AM,125,239,217
Western,Smyth County,51173,634,2594,3228,944,5624,6568,79765,617189,696954,04/01/2014 12:00:00 AM,126,238,216
Western,Smyth County,51173,642,2479,3121,944,5462,6406,88183,627081,715264,10/01/2014 12:00:00 AM,137,253,229
Western,Smyth County,51173,649,2592,3241,958,5620,6578,82256,619081,701337,03/01/2014 12:00:00 AM,127,239,216
Western,Smyth County,51173,653,2649,3302,947,5776,6723,89913,686660,776573,08/01/2013 12:00:00 AM,138,259,235
Western,Smyth County,51173,658,2606,3264,982,5627,6609,83339,625359,708698,02/01/2014 12:00:00 AM,127,240,217
Western,Smyth County,51173,658,2644,3302,968,5869,6837,97339,695821,793160,01/01/2012 12:00:00 AM,148,263,240
Western,Smyth County,51173,659,2643,3302,979,5799,6778,96776,696609,793385,07/01/2012 12:00:00 AM,147,264,240
Western,Smyth County,51173,660,2640,3300,964,5749,6713,91529,689192,780721,07/01/2013 12:00:00 AM,139,261,237
Western,Smyth County,51173,661,2617,3278,986,5660,6646,83390,616594,699984,01/01/2014 12:00:00 AM,126,236,214
Western,Smyth County,51173,664,2617,3281,991,5631,6622,86798,620307,707105,12/01/2013 12:00:00 AM,131,237,216
Western,Smyth County,51173,664,2649,3313,976,5784,6760,93630,695896,789526,06/01/2013 12:00:00 AM,141,263,238
Western,Smyth County,51173,665,2669,3334,997,5806,6803,101343,696629,797972,11/01/2012 12:00:00 AM,152,261,239
Western,Smyth County,51173,666,2641,3307,990,5796,6786,97176,693758,790934,09/01/2012 12:00:00 AM,146,263,239
Western,Smyth County,51173,667,2671,3338,990,5854,6844,99561,695911,795472,10/01/2012 12:00:00 AM,149,261,238
Western,Smyth County,51173,669,2617,3286,1012,5769,6781,100559,686704,787263,06/01/2012 12:00:00 AM,150,262,240
Western,Smyth County,51173,669,2641,3310,988,5830,6818,99319,698983,798302,02/01/2012 12:00:00 AM,148,265,241
Western,Smyth County,51173,670,2651,3321,989,5822,6811,95676,695183,790859,08/01/2012 12:00:00 AM,143,262,238
Western,Smyth County,51173,672,2624,3296,1012,5766,6778,100849,689863,790712,04/01/2012 12:00:00 AM,150,263,240
Western,Smyth County,51173,672,2637,3309,1001,5796,6797,99464,691205,790669,03/01/2012 12:00:00 AM,148,262,239
Western,Smyth County,51173,673,2610,3283,1016,5696,6712,101413,672930,774343,09/01/2013 12:00:00 AM,151,258,236
Western,Smyth County,51173,673,2654,3327,979,5794,6773,94180,700169,794349,05/01/2013 12:00:00 AM,140,264,239
Western,Smyth County,51173,673,2665,3338,1009,5806,6815,97653,695397,793050,04/01/2013 12:00:00 AM,145,261,238
Western,Smyth County,51173,676,2601,3277,1017,5637,6654,89909,619693,709602,11/01/2013 12:00:00 AM,133,238,217
Western,Smyth County,51173,676,2622,3298,1014,5814,6828,100538,698157,798695,05/01/2012 12:00:00 AM,149,266,242
Western,Smyth County,51173,676,2633,3309,1016,5741,6757,102969,690002,792971,12/01/2012 12:00:00 AM,152,262,240
Western,Smyth County,51173,677,2647,3324,1017,5758,6775,97991,683070,781061,03/01/2013 12:00:00 AM,145,258,235
Western,Smyth County,51173,679,2635,3314,1010,5715,6725,101926,676992,778918,10/01/2013 12:00:00 AM,150,257,235
Western,Smyth County,51173,679,2641,3320,1026,5720,6746,101057,688021,789078,02/01/2013 12:00:00 AM,149,261,238
Western,Smyth County,51173,682,2635,3317,1032,5723,6755,103461,681767,785228,01/01/2013 12:00:00 AM,152,259,237
Western,Tazewell County,51185,1011,3045,4056,1357,6960,8317,118700,809689,928389,11/01/2015 12:00:00 AM,117,266,229
Western,Tazewell County,51185,1016,3023,4039,1351,6870,8221,118722,800873,919595,10/01/2015 12:00:00 AM,117,265,228
Western,Tazewell County,51185,1024,3040,4064,1363,6961,8324,116059,817255,933314,04/01/2015 12:00:00 AM,113,269,230
Western,Tazewell County,51185,1025,3161,4186,1408,7082,8490,113435,801638,915073,09/01/2014 12:00:00 AM,111,254,219
Western,Tazewell County,51185,1025,3199,4224,1404,7175,8579,125496,848304,973800,10/01/2014 12:00:00 AM,122,265,231
Western,Tazewell County,51185,1028,3044,4072,1368,6956,8324,118664,816731,935395,09/01/2015 12:00:00 AM,115,268,230
Western,Tazewell County,51185,1032,3172,4204,1404,7138,8542,127438,843146,970584,11/01/2014 12:00:00 AM,123,266,231
Western,Tazewell County,51185,1033,3026,4059,1365,6951,8316,115196,815807,931003,06/01/2015 12:00:00 AM,112,270,229
Western,Tazewell County,51185,1034,3180,4214,1430,7071,8501,114483,806397,920880,08/01/2014 12:00:00 AM,111,254,219
Western,Tazewell County,51185,1035,3017,4052,1386,6902,8288,118320,814557,932877,05/01/2015 12:00:00 AM,114,270,230
Western,Tazewell County,51185,1035,3228,4263,1441,7132,8573,113432,816194,929626,07/01/2014 12:00:00 AM,110,253,218
Western,Tazewell County,51185,1037,3024,4061,1378,6892,8270,119699,807314,927013,08/01/2015 12:00:00 AM,115,267,228
Western,Tazewell County,51185,1039,3168,4207,1409,7134,8543,128149,841435,969584,12/01/2014 12:00:00 AM,123,266,230
Western,Tazewell County,51185,1040,3035,4075,1393,6936,8329,120081,812618,932699,07/01/2015 12:00:00 AM,115,268,229
Western,Tazewell County,51185,1043,3082,4125,1406,6992,8398,122852,822256,945108,02/01/2015 12:00:00 AM,118,267,229
Western,Tazewell County,51185,1043,3137,4180,1408,7063,8471,121167,820246,941413,01/01/2015 12:00:00 AM,116,261,225
Western,Tazewell County,51185,1046,3047,4093,1415,6958,8373,122443,811987,934430,03/01/2015 12:00:00 AM,117,266,228
Western,Tazewell County,51185,1047,3251,4298,1465,7134,8599,116921,819507,936428,06/01/2014 12:00:00 AM,112,252,218
Western,Tazewell County,51185,1055,2949,4004,1506,6467,7973,138585,786319,924904,09/01/2012 12:00:00 AM,131,267,231
Western,Tazewell County,51185,1056,3251,4307,1484,7143,8627,119612,831432,951044,05/01/2014 12:00:00 AM,113,256,221
Western,Tazewell County,51185,1057,3327,4384,1481,7173,8654,120175,832704,952879,03/01/2014 12:00:00 AM,114,250,217
Western,Tazewell County,51185,1059,2919,3978,1502,6423,7925,135632,779145,914777,08/01/2012 12:00:00 AM,128,267,230
Western,Tazewell County,51185,1059,3317,4376,1479,7192,8671,120388,837857,958245,04/01/2014 12:00:00 AM,114,253,219
Western,Tazewell County,51185,1060,2721,3781,1551,6074,7625,142181,742417,884598,03/01/2012 12:00:00 AM,134,273,234
Western,Tazewell County,51185,1062,3233,4295,1500,7059,8559,138349,868031,1006380,05/01/2013 12:00:00 AM,130,268,234
Western,Tazewell County,51185,1063,3245,4308,1497,7105,8602,134350,864592,998942,07/01/2013 12:00:00 AM,126,266,232
Western,Tazewell County,51185,1064,2773,3837,1535,6144,7679,137337,746503,883840,05/01/2012 12:00:00 AM,129,269,230
Western,Tazewell County,51185,1065,2731,3796,1547,6037,7584,140257,736634,876891,04/01/2012 12:00:00 AM,132,270,231
Western,Tazewell County,51185,1065,3219,4284,1495,7076,8571,136582,868841,1005423,06/01/2013 12:00:00 AM,128,270,235
Western,Tazewell County,51185,1065,3301,4366,1497,7199,8696,134778,878817,1013595,08/01/2013 12:00:00 AM,127,266,232
Western,Tazewell County,51185,1066,2859,3925,1544,6295,7839,145961,762741,908702,07/01/2012 12:00:00 AM,137,267,232
Western,Tazewell County,51185,1067,2777,3844,1552,6157,7709,142011,745337,887348,06/01/2012 12:00:00 AM,133,268,231
Western,Tazewell County,51185,1068,3300,4368,1514,7083,8597,120897,806706,927603,01/01/2014 12:00:00 AM,113,244,212
Western,Tazewell County,51185,1070,3055,4125,1526,6702,8228,141089,814513,955602,10/01/2012 12:00:00 AM,132,267,232
Western,Tazewell County,51185,1070,3315,4385,1526,7111,8637,124755,820735,945490,02/01/2014 12:00:00 AM,117,248,216
Western,Tazewell County,51185,1077,3159,4236,1534,6844,8378,139350,839197,978547,02/01/2013 12:00:00 AM,129,266,231
Western,Tazewell County,51185,1077,3197,4274,1545,6949,8494,143516,857609,1001125,04/01/2013 12:00:00 AM,133,268,234
Western,Tazewell County,51185,1078,2710,3788,1589,6030,7619,146116,735707,881823,02/01/2012 12:00:00 AM,136,271,233
Western,Tazewell County,51185,1080,3207,4287,1521,6976,8497,138578,850485,989063,03/01/2013 12:00:00 AM,128,265,231
Western,Tazewell County,51185,1084,3118,4202,1553,6807,8360,145853,838333,984186,11/01/2012 12:00:00 AM,135,269,234
Western,Tazewell County,51185,1089,3288,4377,1552,7096,8648,128105,816622,944727,12/01/2013 12:00:00 AM,118,248,216
Western,Tazewell County,51185,1090,2704,3794,1609,6029,7638,147837,727908,875745,01/01/2012 12:00:00 AM,136,269,231
Western,Tazewell County,51185,1090,3115,4205,1568,6773,8341,144999,836374,981373,12/01/2012 12:00:00 AM,133,268,233
Western,Tazewell County,51185,1090,3285,4375,1541,7113,8654,138832,873283,1012115,09/01/2013 12:00:00 AM,127,266,231
Western,Tazewell County,51185,1091,3305,4396,1544,7099,8643,126006,815483,941489,11/01/2013 12:00:00 AM,115,247,214
Western,Tazewell County,51185,1093,3138,4231,1559,6804,8363,141232,829596,970828,01/01/2013 12:00:00 AM,129,264,229
Western,Tazewell County,51185,1102,3285,4387,1580,7069,8649,142358,871326,1013684,10/01/2013 12:00:00 AM,129,265,231
Western,Tazewell County,51185,838,2848,3686,1083,6047,7130,200240,1044296,1244536,03/01/2020 12:00:00 AM,239,367,338
Western,Tazewell County,51185,843,2790,3633,1088,5961,7049,82811,695433,778244,02/01/2020 12:00:00 AM,98,249,214
Western,Tazewell County,51185,849,2851,3700,1088,6104,7192,83605,712156,795761,01/01/2020 12:00:00 AM,98,250,215
Western,Tazewell County,51185,860,2857,3717,1110,6156,7266,87351,726862,814213,10/01/2019 12:00:00 AM,102,254,219
Western,Tazewell County,51185,861,2837,3698,1113,6094,7207,88942,712099,801041,12/01/2019 12:00:00 AM,103,251,217
Western,Tazewell County,51185,861,2962,3823,1112,6266,7378,206672,1090804,1297476,04/01/2020 12:00:00 AM,240,368,339
Western,Tazewell County,51185,862,2816,3678,1117,6072,7189,88732,707316,796048,11/01/2019 12:00:00 AM,103,251,216
Western,Tazewell County,51185,864,2690,3554,1103,5807,6910,87478,682102,769580,02/01/2019 12:00:00 AM,101,254,217
Western,Tazewell County,51185,876,3009,3885,1127,6366,7493,209337,1104909,1314246,05/01/2020 12:00:00 AM,239,367,338
Western,Tazewell County,51185,877,2823,3700,1135,6140,7275,88229,706766,794995,09/01/2019 12:00:00 AM,101,250,215
Western,Tazewell County,51185,878,2800,3678,1131,6085,7216,85737,707806,793543,08/01/2019 12:00:00 AM,98,253,216
Western,Tazewell County,51185,888,2816,3704,1140,6121,7261,84903,709155,794058,07/01/2019 12:00:00 AM,96,252,214
Western,Tazewell County,51185,888,2819,3707,1146,6087,7233,94062,741675,835737,01/01/2019 12:00:00 AM,106,263,225
Western,Tazewell County,51185,889,2822,3711,1142,6133,7275,86809,711455,798264,06/01/2019 12:00:00 AM,98,252,215
Western,Tazewell County,51185,891,3041,3932,1147,6419,7566,212931,1116369,1329300,06/01/2020 12:00:00 AM,239,367,338
Western,Tazewell County,51185,891,3070,3961,1108,6557,7665,253448,1396597,1650045,02/01/2021 12:00:00 AM,284,455,417
Western,Tazewell County,51185,892,2820,3712,1156,6130,7286,98908,724482,823390,12/01/2018 12:00:00 AM,111,257,222
Western,Tazewell County,51185,895,2811,3706,1150,6123,7273,88904,703423,792327,05/01/2019 12:00:00 AM,99,250,214
Western,Tazewell County,51185,895,2813,3708,1144,6091,7235,88937,714846,803783,04/01/2019 12:00:00 AM,99,254,217
Western,Tazewell County,51185,896,2807,3703,1145,6069,7214,88162,707527,795689,03/01/2019 12:00:00 AM,98,252,215
Western,Tazewell County,51185,900,3101,4001,1162,6614,7776,215437,1148308,1363745,07/01/2020 12:00:00 AM,239,370,341
Western,Tazewell County,51185,901,3115,4016,1151,6653,7804,212520,1147647,1360167,08/01/2020 12:00:00 AM,236,368,339
Western,Tazewell County,51185,902,3028,3930,1146,6342,7488,266937,1448200,1715137,04/01/2021 12:00:00 AM,296,478,436
Western,Tazewell County,51185,903,3120,4023,1160,6677,7837,214528,1159221,1373749,09/01/2020 12:00:00 AM,238,372,341
Western,Tazewell County,51185,904,2890,3794,1159,6360,7519,93400,748954,842354,05/01/2018 12:00:00 AM,103,259,222
Western,Tazewell County,51185,906,2907,3813,1154,6427,7581,93342,761292,854634,04/01/2018 12:00:00 AM,103,262,224
Western,Tazewell County,51185,906,3072,3978,1134,6465,7599,253975,1351187,1605162,03/01/2021 12:00:00 AM,280,440,404
Western,Tazewell County,51185,908,2929,3837,1164,6505,7669,99747,766249,865996,11/01/2017 12:00:00 AM,110,262,226
Western,Tazewell County,51185,909,2881,3790,1168,6347,7515,95318,753950,849268,06/01/2018 12:00:00 AM,105,262,224
Western,Tazewell County,51185,910,3082,3992,1177,6566,7743,230441,1193825,1424266,10/01/2020 12:00:00 AM,253,387,357
Western,Tazewell County,51185,911,2820,3731,1163,6194,7357,97234,730258,827492,07/01/2018 12:00:00 AM,107,259,222
Western,Tazewell County,51185,911,2977,3888,1150,6660,7810,98825,794051,892876,10/01/2017 12:00:00 AM,108,267,230
Western,Tazewell County,51185,914,3027,3941,1170,6359,7529,273436,1458530,1731966,05/01/2021 12:00:00 AM,299,482,439
Western,Tazewell County,51185,915,2812,3727,1181,6157,7338,97910,724934,822844,08/01/2018 12:00:00 AM,107,258,221
Western,Tazewell County,51185,915,2824,3739,1183,6163,7346,98867,737631,836498,09/01/2018 12:00:00 AM,108,261,224
Western,Tazewell County,51185,915,3011,3926,1168,6722,7890,97822,804857,902679,06/01/2017 12:00:00 AM,107,267,230
Western,Tazewell County,51185,916,2819,3735,1186,6136,7322,103021,720453,823474,11/01/2018 12:00:00 AM,112,256,220
Western,Tazewell County,51185,916,2913,3829,1173,6437,7610,95290,759881,855171,01/01/2018 12:00:00 AM,104,261,223
Western,Tazewell County,51185,916,3037,3953,1154,6842,7996,96841,819215,916056,04/01/2017 12:00:00 AM,106,270,232
Western,Tazewell County,51185,916,3038,3954,1194,6432,7626,266584,1331981,1598565,01/01/2021 12:00:00 AM,291,438,404
Western,Tazewell County,51185,917,2981,3898,1171,6691,7862,98815,796139,894954,09/01/2017 12:00:00 AM,108,267,230
Western,Tazewell County,51185,917,3073,3990,1182,6538,7720,232156,1201706,1433862,12/01/2020 12:00:00 AM,253,391,359
Western,Tazewell County,51185,920,2979,3899,1171,6670,7841,98927,788041,886968,07/01/2017 12:00:00 AM,108,265,227
Western,Tazewell County,51185,920,3028,3948,1184,6346,7530,271624,1437454,1709078,06/01/2021 12:00:00 AM,295,475,433
Western,Tazewell County,51185,921,3070,3991,1180,6533,7713,229991,1206889,1436880,11/01/2020 12:00:00 AM,250,393,360
Western,Tazewell County,51185,922,2783,3705,1186,6023,7209,100800,714077,814877,10/01/2018 12:00:00 AM,109,257,220
Western,Tazewell County,51185,922,2998,3920,1175,6684,7859,98213,799420,897633,08/01/2017 12:00:00 AM,107,267,229
Western,Tazewell County,51185,923,2915,3838,1184,6385,7569,95217,760858,856075,03/01/2018 12:00:00 AM,103,261,223
Western,Tazewell County,51185,923,2927,3850,1188,6480,7668,102238.28,760522,862760.28,12/01/2017 12:00:00 AM,111,260,224
Western,Tazewell County,51185,926,3033,3959,1176,6748,7924,97385,816860,914245,05/01/2017 12:00:00 AM,105,269,231
Western,Tazewell County,51185,929,2897,3826,1192,6418,7610,97079,753474,850553,02/01/2018 12:00:00 AM,104,260,222
Western,Tazewell County,51185,933,3083,4016,1177,6876,8053,99187,821072,920259,03/01/2017 12:00:00 AM,106,266,229
Western,Tazewell County,51185,934,3125,4059,1171,7093,8264,96225,845433.85,941658.85,02/01/2017 12:00:00 AM,103,271,232
Western,Tazewell County,51185,939,3120,4059,1187,7080,8267,95639,835676,931315,01/01/2017 12:00:00 AM,102,268,229
Western,Tazewell County,51185,960,3068,4028,1229,7002,8231,101293,823490,924783,11/01/2016 12:00:00 AM,106,268,230
Western,Tazewell County,51185,960,3091,4051,1222,7043,8265,100533,828456,928989,12/01/2016 12:00:00 AM,105,268,229
Western,Tazewell County,51185,965,3090,4055,1232,7024,8256,101484,831494,932978,10/01/2016 12:00:00 AM,105,269,230
Western,Tazewell County,51185,965,3102,4067,1243,7085,8328,102882,827453,930335,09/01/2016 12:00:00 AM,107,267,229
Western,Tazewell County,51185,971,3086,4057,1255,7037,8292,105514,823546,929060,04/01/2016 12:00:00 AM,109,267,229
Western,Tazewell County,51185,971,3100,4071,1261,7067,8328,104802,822519,927321,08/01/2016 12:00:00 AM,108,265,228
Western,Tazewell County,51185,973,3071,4044,1270,7045,8315,106179,820358,926537,06/01/2016 12:00:00 AM,109,267,229
Western,Tazewell County,51185,975,3081,4056,1273,7056,8329,106121,825927,932048,05/01/2016 12:00:00 AM,109,268,230
Western,Tazewell County,51185,978,3083,4061,1268,7080,8348,106465,825665,932130,07/01/2016 12:00:00 AM,109,268,230
Western,Tazewell County,51185,986,3066,4052,1290,6994,8284,108966,819278,928244,03/01/2016 12:00:00 AM,111,267,229
Western,Tazewell County,51185,994,3059,4053,1328,6985,8313,115120,806754,921874,01/01/2016 12:00:00 AM,116,264,227
Western,Tazewell County,51185,994,3074,4068,1326,6994,8320,116508,812909,929417,12/01/2015 12:00:00 AM,117,264,228
Western,Tazewell County,51185,995,3072,4067,1324,6978,8302,112576,815499,928075,02/01/2016 12:00:00 AM,113,265,228
Western,Washington County,51191,592,2669,3261,722,5843,6565,164734,1230713,1395447,02/01/2021 12:00:00 AM,278,461,428
Western,Washington County,51191,596,2358,2954,783,5286,6069,71320,606753,678073,08/01/2019 12:00:00 AM,120,257,230
Western,Washington County,51191,597,2304,2901,803,5153,5956,76965,600334,677299,02/01/2019 12:00:00 AM,129,261,233
Western,Washington County,51191,597,2369,2966,797,5313,6110,72165,618536,690701,03/01/2019 12:00:00 AM,121,261,233
Western,Washington County,51191,601,2374,2975,804,5393,6197,77864,634530,712394,11/01/2018 12:00:00 AM,130,267,239
Western,Washington County,51191,602,2371,2973,816,5308,6124,74752,619283,694035,05/01/2019 12:00:00 AM,124,261,233
Western,Washington County,51191,602,2377,2979,812,5387,6199,78228,635567,713795,10/01/2018 12:00:00 AM,130,267,240
Western,Washington County,51191,602,2384,2986,808,5396,6204,78294,641183,719477,12/01/2018 12:00:00 AM,130,269,241
Western,Washington County,51191,602,2443,3045,811,5626,6437,76274,659677,735951,07/01/2018 12:00:00 AM,127,270,242
Western,Washington County,51191,604,2342,2946,804,5205,6009,71307,601820,673127,11/01/2019 12:00:00 AM,118,257,228
Western,Washington County,51191,604,2345,2949,819,5221,6040,75865,606304,682169,10/01/2019 12:00:00 AM,126,259,231
Western,Washington County,51191,604,2351,2955,822,5269,6091,77342,616698,694040,04/01/2019 12:00:00 AM,128,262,235
Western,Washington County,51191,604,2483,3087,821,5723,6544,78099,677423,755522,06/01/2018 12:00:00 AM,129,273,245
Western,Washington County,51191,605,2356,2961,811,5345,6156,78211,648225,726436,01/01/2019 12:00:00 AM,129,275,245
Western,Washington County,51191,605,2358,2963,804,5249,6053,72930,615137,688067,09/01/2019 12:00:00 AM,121,261,232
Western,Washington County,51191,606,2356,2962,792,5258,6050,68210,614113,682323,01/01/2020 12:00:00 AM,113,261,230
Western,Washington County,51191,606,2689,3295,736,5882,6618,167747,1235032,1402779,03/01/2021 12:00:00 AM,277,459,426
Western,Washington County,51191,607,2374,2981,808,5349,6157,75022,625146,700168,07/01/2019 12:00:00 AM,124,263,235
Western,Washington County,51191,608,2352,2960,802,5248,6050,72287,604380,676667,12/01/2019 12:00:00 AM,119,257,229
Western,Washington County,51191,609,2647,3256,767,5827,6594,172061,1216886,1388947,01/01/2021 12:00:00 AM,283,460,427
Western,Washington County,51191,610,2341,2951,806,5255,6061,148259,896133,1044392,03/01/2020 12:00:00 AM,243,383,354
Western,Washington County,51191,610,2615,3225,816,5999,6815,77055,701187,778242,12/01/2017 12:00:00 AM,126,268,241
Western,Washington County,51191,610,2634,3244,741,5712,6453,174823,1287383,1462206,04/01/2021 12:00:00 AM,287,489,451
Western,Washington County,51191,611,2299,2910,809,5117,5926,70404,592450,662854,02/01/2020 12:00:00 AM,115,258,228
Western,Washington County,51191,612,2383,2995,822,5386,6208,75885,627041,702926,06/01/2019 12:00:00 AM,124,263,235
Western,Washington County,51191,612,2389,3001,832,5439,6271,78511,645574,724085,09/01/2018 12:00:00 AM,128,270,241
Western,Washington County,51191,614,2483,3097,838,5721,6559,77941,677935,755876,08/01/2018 12:00:00 AM,127,273,244
Western,Washington County,51191,614,2615,3229,743,5678,6421,175888,1285814,1461702,05/01/2021 12:00:00 AM,286,492,453
Western,Washington County,51191,615,2684,3299,792,5920,6712,154282,1088274,1242556,10/01/2020 12:00:00 AM,251,405,377
Western,Washington County,51191,618,2556,3174,823,5820,6643,75657,680084,755741,02/01/2018 12:00:00 AM,122,266,238
Western,Washington County,51191,618,2630,3248,791,5818,6609,155584,1076273,1231857,11/01/2020 12:00:00 AM,252,409,379
Western,Washington County,51191,619,2503,3122,831,5741,6572,77464,672678,750142,05/01/2018 12:00:00 AM,125,269,240
Western,Washington County,51191,620,2556,3176,833,5827,6660,78007,671509,749516,01/01/2018 12:00:00 AM,126,263,236
Western,Washington County,51191,620,2662,3282,785,5901,6686,153342,1079134,1232476,12/01/2020 12:00:00 AM,247,405,376
Western,Washington County,51191,623,2510,3133,820,5579,6399,150681,967276,1117957,04/01/2020 12:00:00 AM,242,385,357
Western,Washington County,51191,623,2551,3174,835,5767,6602,76810,683980,760790,04/01/2018 12:00:00 AM,123,268,240
Western,Washington County,51191,623,2579,3202,834,5870,6704,76671,684823,761494,03/01/2018 12:00:00 AM,123,266,238
Western,Washington County,51191,623,2701,3324,818,5929,6747,150941,1027489,1178430,09/01/2020 12:00:00 AM,242,380,355
Western,Washington County,51191,624,2699,3323,815,5951,6766,149701,1024029,1173730,08/01/2020 12:00:00 AM,240,379,353
Western,Washington County,51191,625,2602,3227,837,6022,6859,79732,699467,779199,11/01/2017 12:00:00 AM,128,269,241
Western,Washington County,51191,625,2614,3239,759,5687,6446,179475,1291556,1471031,06/01/2021 12:00:00 AM,287,494,454
Western,Washington County,51191,630,2584,3214,842,5963,6805,77601,707232,784833,08/01/2017 12:00:00 AM,123,274,244
Western,Washington County,51191,633,2590,3223,841,6021,6862,78518,716364,794882,09/01/2017 12:00:00 AM,124,277,247
Western,Washington County,51191,633,2660,3293,838,6173,7011,77075,725243,802318,05/01/2017 12:00:00 AM,122,273,244
Western,Washington County,51191,634,2577,3211,846,5986,6832,80394,701296,781690,10/01/2017 12:00:00 AM,127,272,243
Western,Washington County,51191,635,2601,3236,831,5755,6586,153992,997838,1151830,06/01/2020 12:00:00 AM,243,384,356
Western,Washington County,51191,635,2659,3294,838,6143,6981,77110,732736,809846,06/01/2017 12:00:00 AM,121,276,246
Western,Washington County,51191,636,2559,3195,834,5669,6503,154328,970997,1125325,05/01/2020 12:00:00 AM,243,379,352
Western,Washington County,51191,637,2575,3212,846,5929,6775,78762,708478,787240,07/01/2017 12:00:00 AM,124,275,245
Western,Washington County,51191,638,2668,3306,841,6148,6989,77077,721300.73,798377.73,04/01/2017 12:00:00 AM,121,270,241
Western,Washington County,51191,643,2676,3319,846,5917,6763,157249,1022746,1179995,07/01/2020 12:00:00 AM,245,382,356
Western,Washington County,51191,643,2750,3393,852,6269,7121,75079,717959,793038,12/01/2016 12:00:00 AM,117,261,234
Western,Washington County,51191,646,2699,3345,857,6180,7037,78158,729846,808004,03/01/2017 12:00:00 AM,121,270,242
Western,Washington County,51191,648,2757,3405,841,6292,7133,75965,720861,796826,01/01/2017 12:00:00 AM,117,261,234
Western,Washington County,51191,652,2757,3409,855,6268,7123,78405,726464,804869,02/01/2017 12:00:00 AM,120,263,236
Western,Washington County,51191,654,2788,3442,859,6397,7256,77005,731920,808925,11/01/2016 12:00:00 AM,118,263,235
Western,Washington County,51191,655,2866,3521,870,6644,7514,81878,751230,833108,03/01/2015 12:00:00 AM,125,262,237
Western,Washington County,51191,656,2781,3437,884,6421,7305,79707,735152,814859,05/01/2016 12:00:00 AM,122,264,237
Western,Washington County,51191,656,2829,3485,881,6473,7354,79961,739519,819480,04/01/2016 12:00:00 AM,122,261,235
Western,Washington County,51191,657,2860,3517,873,6661,7534,80993,750534,831527,04/01/2015 12:00:00 AM,123,262,236
Western,Washington County,51191,660,2815,3475,873,6460,7333,77985,736787,814772,07/01/2016 12:00:00 AM,118,262,234
Western,Washington County,51191,660,2990,3650,875,6866,7741,76685,755624,832309,09/01/2014 12:00:00 AM,116,253,228
Western,Washington County,51191,661,2790,3451,880,6446,7326,78520,729639,808159,06/01/2016 12:00:00 AM,119,262,234
Western,Washington County,51191,661,2849,3510,879,6609,7488,83669,747326,830995,02/01/2015 12:00:00 AM,127,262,237
Western,Washington County,51191,661,3013,3674,878,6913,7791,76378,764669,841047,08/01/2014 12:00:00 AM,116,254,229
Western,Washington County,51191,662,2821,3483,893,6563,7456,83326,737189,820515,05/01/2015 12:00:00 AM,126,261,236
Western,Washington County,51191,662,2824,3486,887,6586,7473,81142,743365,824507,06/01/2015 12:00:00 AM,123,263,237
Western,Washington County,51191,662,2836,3498,893,6475,7368,80721,743655,824376,03/01/2016 12:00:00 AM,122,262,236
Western,Washington County,51191,662,2843,3505,884,6621,7505,80061,752589,832650,07/01/2015 12:00:00 AM,121,265,238
Western,Washington County,51191,665,2820,3485,885,6531,7416,79687,746831,826518,10/01/2015 12:00:00 AM,120,265,237
Western,Washington County,51191,665,2853,3518,889,6535,7424,81323,742290,823613,09/01/2016 12:00:00 AM,122,260,234
Western,Washington County,51191,665,3049,3714,890,6993,7883,77922,770027,847949,07/01/2014 12:00:00 AM,117,253,228
Western,Washington County,51191,668,2839,3507,896,6521,7417,81622,745877,827499,02/01/2016 12:00:00 AM,122,263,236
Western,Washington County,51191,668,2846,3514,891,6537,7428,80447,744674,825121,08/01/2016 12:00:00 AM,120,262,235
Western,Washington County,51191,668,2853,3521,893,6669,7562,82287,754824,837111,08/01/2015 12:00:00 AM,123,265,238
Western,Washington County,51191,669,2818,3487,896,6429,7325,81635,736022,817657,10/01/2016 12:00:00 AM,122,261,234
Western,Washington County,51191,669,2820,3489,894,6549,7443,82062,748557,830619,09/01/2015 12:00:00 AM,123,265,238
Western,Washington County,51191,669,2932,3601,899,6773,7672,86133,767155,853288,10/01/2014 12:00:00 AM,129,262,237
Western,Washington County,51191,670,2901,3571,899,6719,7618,85769,760114,845883,11/01/2014 12:00:00 AM,128,262,237
Western,Washington County,51191,670,3058,3728,918,6990,7908,81076,772456,853532,06/01/2014 12:00:00 AM,121,253,229
Western,Washington County,51191,672,2833,3505,904,6536,7440,80842,743021,823863,01/01/2016 12:00:00 AM,120,262,235
Western,Washington County,51191,673,2893,3566,904,6716,7620,86861,758566,845427,12/01/2014 12:00:00 AM,129,262,237
Western,Washington County,51191,673,3133,3806,913,7173,8086,80867,799092,879959,04/01/2014 12:00:00 AM,120,255,231
Western,Washington County,51191,674,2838,3512,898,6542,7440,80021,741434,821455,12/01/2015 12:00:00 AM,119,261,234
Western,Washington County,51191,674,2879,3553,905,6662,7567,86583,746475,833058,01/01/2015 12:00:00 AM,128,259,234
Western,Washington County,51191,678,2817,3495,910,6511,7421,81796,737542,819338,11/01/2015 12:00:00 AM,121,262,234
Western,Washington County,51191,680,3150,3830,929,7218,8147,82616,801109,883725,02/01/2014 12:00:00 AM,121,254,231
Western,Washington County,51191,681,3071,3752,936,7009,7945,83505,776322,859827,05/01/2014 12:00:00 AM,123,253,229
Western,Washington County,51191,682,3156,3838,920,7223,8143,82193,800085,882278,03/01/2014 12:00:00 AM,121,254,230
Western,Washington County,51191,684,2971,3655,896,6921,7817,84736,823621,908357,09/01/2012 12:00:00 AM,124,277,249
Western,Washington County,51191,684,3095,3779,940,7137,8077,84070,783235,867305,11/01/2013 12:00:00 AM,123,253,230
Western,Washington County,51191,686,3012,3698,891,6976,7867,86032,835457,921489,10/01/2012 12:00:00 AM,125,277,249
Western,Washington County,51191,690,2944,3634,920,6833,7753,87072,814140,901212,08/01/2012 12:00:00 AM,126,277,248
Western,Washington County,51191,691,3154,3845,957,7234,8191,84746,787898,872644,01/01/2014 12:00:00 AM,123,250,227
Western,Washington County,51191,695,3031,3726,945,7018,7963,91324,841266,932590,07/01/2013 12:00:00 AM,131,278,250
Western,Washington County,51191,695,3072,3767,931,7121,8052,90629,853258,943887,09/01/2013 12:00:00 AM,130,278,251
Western,Washington County,51191,696,3125,3821,963,7154,8117,87497,786572,874069,12/01/2013 12:00:00 AM,126,252,229
Western,Washington County,51191,699,3085,3784,959,7103,8062,96619,845889,942508,10/01/2013 12:00:00 AM,138,274,249
Western,Washington County,51191,702,3018,3720,976,6919,7895,98540,831343,929883,03/01/2013 12:00:00 AM,140,275,250
Western,Washington County,51191,703,3002,3705,960,6972,7932,92331,843051,935382,06/01/2013 12:00:00 AM,131,281,252
Western,Washington County,51191,705,2907,3612,957,6717,7674,92745,803590,896335,07/01/2012 12:00:00 AM,132,276,248
Western,Washington County,51191,706,3040,3746,938,7021,7959,94000,841160,935160,11/01/2012 12:00:00 AM,133,277,250
Western,Washington County,51191,709,3014,3723,985,6947,7932,96985,836185,933170,04/01/2013 12:00:00 AM,137,277,251
Western,Washington County,51191,709,3046,3755,955,7056,8011,93668,845727,939395,08/01/2013 12:00:00 AM,132,278,250
Western,Washington County,51191,710,3032,3742,981,6963,7944,98085,837043,935128,02/01/2013 12:00:00 AM,138,276,250
Western,Washington County,51191,712,3031,3743,960,6973,7933,92893,834534,927427,01/01/2013 12:00:00 AM,130,275,248
Western,Washington County,51191,713,3004,3717,1001,6954,7955,97951,840141,938092,05/01/2013 12:00:00 AM,137,280,252
Western,Washington County,51191,714,2997,3711,970,6891,7861,99675,824665,924340,12/01/2012 12:00:00 AM,140,275,249
Western,Washington County,51191,718,2890,3608,992,6700,7692,97506,798612,896118,06/01/2012 12:00:00 AM,136,276,248
Western,Washington County,51191,720,2881,3601,1019,6737,7756,100816,801678,902494,04/01/2012 12:00:00 AM,140,278,251
Western,Washington County,51191,721,2869,3590,990,6720,7710,96155,797511,893666,05/01/2012 12:00:00 AM,133,278,249
Western,Washington County,51191,724,2871,3595,1023,6697,7720,105051,795663,900714,02/01/2012 12:00:00 AM,145,277,251
Western,Washington County,51191,725,2854,3579,1045,6656,7701,105570,787998,893568,01/01/2012 12:00:00 AM,146,276,250
Western,Washington County,51191,731,2869,3600,1043,6683,7726,105321,794214,899535,03/01/2012 12:00:00 AM,144,277,250
Western,Wise County,51195,1001,2935,3936,1398,6876,8274,125168,812195,937363,05/01/2016 12:00:00 AM,125,277,238
Western,Wise County,51195,1011,3001,4012,1417,6982,8399,124322,828758,953080,04/01/2016 12:00:00 AM,123,276,238
Western,Wise County,51195,1015,2779,3794,1423,6653,8076,124287,762836,887123,04/01/2015 12:00:00 AM,122,275,234
Western,Wise County,51195,1031,2772,3803,1467,6629,8096,130762,768435,899197,06/01/2015 12:00:00 AM,127,277,236
Western,Wise County,51195,1032,2980,4012,1450,6918,8368,127752,820112,947864,03/01/2016 12:00:00 AM,124,275,236
Western,Wise County,51195,1036,2933,3969,1466,6822,8288,128049,804325,932374,01/01/2016 12:00:00 AM,124,274,235
Western,Wise County,51195,1038,2965,4003,1471,6901,8372,128449,814892,943341,02/01/2016 12:00:00 AM,124,275,236
Western,Wise County,51195,1039,2778,3817,1467,6668,8135,127282,768991,896273,05/01/2015 12:00:00 AM,123,277,235
Western,Wise County,51195,1043,2831,3874,1486,6715,8201,128552,785727,914279,08/01/2015 12:00:00 AM,123,278,236
Western,Wise County,51195,1044,2763,3807,1486,6587,8073,130815,751294,882109,03/01/2015 12:00:00 AM,125,272,232
Western,Wise County,51195,1046,2781,3827,1516,6629,8145,134211,767538,901749,07/01/2015 12:00:00 AM,128,276,236
Western,Wise County,51195,1047,2912,3959,1483,6820,8303,130290,803300,933590,12/01/2015 12:00:00 AM,124,276,236
Western,Wise County,51195,1049,2838,3887,1494,6725,8219,130914,783493,914407,09/01/2015 12:00:00 AM,125,276,235
Western,Wise County,51195,1049,2854,3903,1491,6709,8200,134018,772087,906105,01/01/2015 12:00:00 AM,128,271,232
Western,Wise County,51195,1053,2897,3950,1490,6826,8316,130097,798157,928254,11/01/2015 12:00:00 AM,124,276,235
Western,Wise County,51195,1058,3304,4362,1521,7479,9000,128935,848621,977556,06/01/2014 12:00:00 AM,122,257,224
Western,Wise County,51195,1060,3124,4184,1525,7184,8709,129495,799499,928994,09/01/2014 12:00:00 AM,122,256,222
Western,Wise County,51195,1064,2748,3812,1521,6486,8007,135549,752032,887581,02/01/2015 12:00:00 AM,127,274,233
Western,Wise County,51195,1064,2886,3950,1528,6813,8341,133146,792101,925247,10/01/2015 12:00:00 AM,125,274,234
Western,Wise County,51195,1064,3337,4401,1539,7565,9104,127870,858719,986589,05/01/2014 12:00:00 AM,120,257,224
Western,Wise County,51195,1066,3174,4240,1526,7298,8824,129223,819503,948726,08/01/2014 12:00:00 AM,121,258,224
Western,Wise County,51195,1066,3228,4294,1542,7365,8907,130112,835176,965288,07/01/2014 12:00:00 AM,122,259,225
Western,Wise County,51195,1075,2873,3948,1552,6714,8266,143798,773315,917113,11/01/2014 12:00:00 AM,134,269,232
Western,Wise County,51195,1075,3381,4456,1550,7598,9148,129953,863466,993419,04/01/2014 12:00:00 AM,121,255,223
Western,Wise County,51195,1077,2864,3941,1545,6707,8252,145870,776713,922583,12/01/2014 12:00:00 AM,135,271,234
Western,Wise County,51195,1079,2928,4007,1581,6828,8409,147132,791942,939074,10/01/2014 12:00:00 AM,136,270,234
Western,Wise County,51195,1090,3386,4476,1592,7594,9186,134624,849557,984181,03/01/2014 12:00:00 AM,124,251,220
Western,Wise County,51195,1095,3402,4497,1595,7615,9210,133431,857458,990889,02/01/2014 12:00:00 AM,122,252,220
Western,Wise County,51195,1102,3414,4516,1622,7583,9205,136197,835790,971987,01/01/2014 12:00:00 AM,124,245,215
Western,Wise County,51195,1112,3442,4554,1605,7700,9305,137191,872615,1009806,11/01/2013 12:00:00 AM,123,254,222
Western,Wise County,51195,1119,3419,4538,1642,7612,9254,144243,857878,1002121,12/01/2013 12:00:00 AM,129,251,221
Western,Wise County,51195,1130,3447,4577,1700,7679,9379,165547,937381,1102928,10/01/2013 12:00:00 AM,147,272,241
Western,Wise County,51195,1146,3321,4467,1718,7457,9175,165769,912174,1077943,03/01/2013 12:00:00 AM,145,275,241
Western,Wise County,51195,1149,3368,4517,1722,7600,9322,165085,923405,1088490,06/01/2013 12:00:00 AM,144,274,241
Western,Wise County,51195,1154,3315,4469,1725,7441,9166,165650,905206,1070856,04/01/2013 12:00:00 AM,144,273,240
Western,Wise County,51195,1154,3426,4580,1732,7654,9386,169726,928612,1098338,09/01/2013 12:00:00 AM,147,271,240
Western,Wise County,51195,1157,3421,4578,1747,7679,9426,171197,932436,1103633,08/01/2013 12:00:00 AM,148,273,241
Western,Wise County,51195,1164,3291,4455,1780,7373,9153,172545,903881,1076426,02/01/2013 12:00:00 AM,148,275,242
Western,Wise County,51195,1164,3330,4494,1757,7500,9257,172185,908463,1080648,05/01/2013 12:00:00 AM,148,273,240
Western,Wise County,51195,1165,3379,4544,1752,7642,9394,169165,922604,1091769,07/01/2013 12:00:00 AM,145,273,240
Western,Wise County,51195,1168,3306,4474,1758,7398,9156,167146,895961,1063107,01/01/2013 12:00:00 AM,143,271,238
Western,Wise County,51195,1179,3166,4345,1789,7155,8944,173021,866902,1039923,09/01/2012 12:00:00 AM,147,274,239
Western,Wise County,51195,1185,3230,4415,1807,7261,9068,177268,890934,1068202,12/01/2012 12:00:00 AM,150,276,242
Western,Wise County,51195,1189,3150,4339,1822,7127,8949,177691,855112,1032803,08/01/2012 12:00:00 AM,149,271,238
Western,Wise County,51195,1192,3180,4372,1809,7232,9041,178183,883877,1062060,10/01/2012 12:00:00 AM,149,278,243
Western,Wise County,51195,1192,3208,4400,1808,7232,9040,175954,885071,1061025,11/01/2012 12:00:00 AM,148,276,241
Western,Wise County,51195,1198,3066,4264,1870,6943,8813,186216,835904,1022120,07/01/2012 12:00:00 AM,155,273,240
Western,Wise County,51195,1209,3018,4227,1890,6847,8737,184924,825214,1010138,04/01/2012 12:00:00 AM,153,273,239
Western,Wise County,51195,1217,3040,4257,1899,6881,8780,190366,829022,1019388,06/01/2012 12:00:00 AM,156,273,239
Western,Wise County,51195,1221,3010,4231,1904,6878,8782,188925,827724,1016649,05/01/2012 12:00:00 AM,155,275,240
Western,Wise County,51195,1226,3032,4258,1958,6851,8809,197137,819694,1016831,02/01/2012 12:00:00 AM,161,270,239
Western,Wise County,51195,1227,3020,4247,1947,6823,8770,193971,808184,1002155,01/01/2012 12:00:00 AM,158,268,236
Western,Wise County,51195,1233,3025,4258,1985,6787,8772,197178,812603,1009781,03/01/2012 12:00:00 AM,160,269,237
Western,Wise County,51195,851,2606,3457,1164,5773,6937,214731,987773,1202504,03/01/2020 12:00:00 AM,252,379,348
Western,Wise County,51195,858,2561,3419,1168,5638,6806,85260,662348,747608,02/01/2020 12:00:00 AM,99,259,219
Western,Wise County,51195,879,2600,3479,1202,5757,6959,87763,668492,756255,01/01/2020 12:00:00 AM,100,257,217
Western,Wise County,51195,883,2808,3691,1215,6174,7389,222458,1068483,1290941,04/01/2020 12:00:00 AM,252,381,350
Western,Wise County,51195,896,2601,3497,1244,5779,7023,96403,679534,775937,08/01/2019 12:00:00 AM,108,261,222
Western,Wise County,51195,897,2634,3531,1232,5801,7033,95525,679464,774989,12/01/2019 12:00:00 AM,106,258,219
Western,Wise County,51195,900,2602,3502,1253,5736,6989,97899,676312,774211,09/01/2019 12:00:00 AM,109,260,221
Western,Wise County,51195,901,2625,3526,1240,5814,7054,96473,678733,775206,11/01/2019 12:00:00 AM,107,259,220
Western,Wise County,51195,901,2629,3530,1247,5759,7006,96281,683385,779666,10/01/2019 12:00:00 AM,107,260,221
Western,Wise County,51195,902,2887,3789,1238,6326,7564,228822,1092480,1321302,05/01/2020 12:00:00 AM,254,378,349
Western,Wise County,51195,907,2594,3501,1249,5761,7010,97798,672961,770759,07/01/2019 12:00:00 AM,108,259,220
Western,Wise County,51195,907,2902,3809,1234,6342,7576,228572,1095515,1324087,06/01/2020 12:00:00 AM,252,378,348
Western,Wise County,51195,915,2456,3371,1285,5369,6654,102214,621041,723255,02/01/2019 12:00:00 AM,112,253,215
Western,Wise County,51195,915,2589,3504,1260,5715,6975,99156,678472,777628,06/01/2019 12:00:00 AM,108,262,222
Western,Wise County,51195,925,2848,3773,1280,6633,7913,109217,808929,918146,06/01/2017 12:00:00 AM,118,284,243
Western,Wise County,51195,927,2574,3501,1298,5678,6976,101671,663297,764968,05/01/2019 12:00:00 AM,110,258,218
Western,Wise County,51195,930,2939,3869,1265,6457,7722,232094,1114824,1346918,07/01/2020 12:00:00 AM,250,379,348
Western,Wise County,51195,931,2911,3842,1264,6365,7629,233646,1091711,1325357,08/01/2020 12:00:00 AM,251,375,345
Western,Wise County,51195,932,2623,3555,1315,5760,7075,101844,671482,773326,03/01/2019 12:00:00 AM,109,256,218
Western,Wise County,51195,933,2631,3564,1306,5807,7113,100914,683526,784440,04/01/2019 12:00:00 AM,108,260,220
Western,Wise County,51195,933,2903,3836,1298,6712,8010,114346,805456,919802,03/01/2017 12:00:00 AM,123,277,240
Western,Wise County,51195,934,2849,3783,1218,6197,7415,276444,1315069,1591513,02/01/2021 12:00:00 AM,296,462,421
Western,Wise County,51195,936,2829,3765,1308,6594,7902,114616,795779,910395,05/01/2017 12:00:00 AM,122,281,242
Western,Wise County,51195,937,2615,3552,1326,5800,7126,109547.07,727247,836794.07,01/01/2019 12:00:00 AM,117,278,236
Western,Wise County,51195,937,2869,3806,1307,6643,7950,112495,804672.72,917167.72,04/01/2017 12:00:00 AM,120,280,241
Western,Wise County,51195,938,2807,3745,1286,6528,7814,109108,796173.68,905281.68,07/01/2017 12:00:00 AM,116,284,242
Western,Wise County,51195,943,2814,3757,1309,6529,7838,112675,790701,903376,08/01/2017 12:00:00 AM,119,281,240
Western,Wise County,51195,944,2980,3924,1298,6956,8254,109518,818713,928231,02/01/2017 12:00:00 AM,116,275,237
Western,Wise County,51195,945,2765,3710,1242,5966,7208,289918,1365871,1655789,05/01/2021 12:00:00 AM,307,494,446
Western,Wise County,51195,947,2928,3875,1283,6423,7706,235646,1113935,1349581,09/01/2020 12:00:00 AM,249,380,348
Western,Wise County,51195,948,2623,3571,1361,5806,7167,117509,686423,803932,12/01/2018 12:00:00 AM,124,262,225
Western,Wise County,51195,948,2775,3723,1239,5992,7231,288974,1359704,1648678,04/01/2021 12:00:00 AM,305,490,443
Western,Wise County,51195,948,2946,3894,1306,6866,8172,111837,805303,917140,01/01/2017 12:00:00 AM,118,273,236
Western,Wise County,51195,949,2803,3752,1321,6447,7768,113013,779169,892182,09/01/2017 12:00:00 AM,119,278,238
Western,Wise County,51195,950,2651,3601,1360,5922,7282,117654,695801,813455,11/01/2018 12:00:00 AM,124,262,226
Western,Wise County,51195,950,2756,3706,1247,5946,7193,289824,1352533,1642357,06/01/2021 12:00:00 AM,305,491,443
Western,Wise County,51195,950,2800,3750,1238,6061,7299,279760,1278538,1558298,03/01/2021 12:00:00 AM,294,457,416
Western,Wise County,51195,952,2669,3621,1364,5972,7336,117537,707448,824985,10/01/2018 12:00:00 AM,123,265,228
Western,Wise County,51195,955,2782,3737,1338,6403,7741,116671,767218,883889,10/01/2017 12:00:00 AM,122,276,237
Western,Wise County,51195,956,2882,3838,1283,6279,7562,253071,1155779,1408850,11/01/2020 12:00:00 AM,265,401,367
Western,Wise County,51195,956,2905,3861,1281,6380,7661,248283,1163948,1412231,10/01/2020 12:00:00 AM,260,401,366
Western,Wise County,51195,957,2845,3802,1291,6173,7464,250814,1135936,1386750,12/01/2020 12:00:00 AM,262,399,365
Western,Wise County,51195,960,2826,3786,1294,6150,7444,289148,1288207,1577355,01/01/2021 12:00:00 AM,301,456,417
Western,Wise County,51195,962,2782,3744,1359,6382,7741,119885,755143.75,875028.75,11/01/2017 12:00:00 AM,125,271,234
Western,Wise County,51195,966,2672,3638,1388,6032,7420,117289,709038,826327,09/01/2018 12:00:00 AM,121,265,227
Western,Wise County,51195,967,2755,3722,1352,6296,7648,112684,743181,855865,01/01/2018 12:00:00 AM,117,270,230
Western,Wise County,51195,968,2739,3707,1361,6207,7568,113811,723137,836948,02/01/2018 12:00:00 AM,118,264,226
Western,Wise County,51195,969,2772,3741,1366,6365,7731,119531,752471,872002,12/01/2017 12:00:00 AM,123,271,233
Western,Wise County,51195,970,2670,3640,1384,6030,7414,117228,707507,824735,08/01/2018 12:00:00 AM,121,265,227
Western,Wise County,51195,972,2661,3633,1396,5982,7378,117096,710546,827642,07/01/2018 12:00:00 AM,120,267,228
Western,Wise County,51195,979,2765,3744,1386,6257,7643,118110,734398,852508,03/01/2018 12:00:00 AM,121,266,228
Western,Wise County,51195,981,2935,3916,1375,6834,8209,121705,811368,933073,07/01/2016 12:00:00 AM,124,276,238
Western,Wise County,51195,985,2663,3648,1412,6012,7424,117218,708831.56,826049.56,06/01/2018 12:00:00 AM,119,266,226
Western,Wise County,51195,986,2726,3712,1413,6154,7567,117586,728833,846419,04/01/2018 12:00:00 AM,119,267,228
Western,Wise County,51195,986,2912,3898,1382,6812,8194,117028,808308,925336,12/01/2016 12:00:00 AM,119,278,237
Western,Wise County,51195,986,2971,3957,1381,6935,8316,120524,825859,946383,09/01/2016 12:00:00 AM,122,278,239
Western,Wise County,51195,990,2969,3959,1389,6900,8289,123245,819893,943138,08/01/2016 12:00:00 AM,124,276,238
Western,Wise County,51195,991,2924,3915,1390,6866,8256,118123,809490,927613,11/01/2016 12:00:00 AM,119,277,237
Western,Wise County,51195,992,2970,3962,1394,6941,8335,119385,827630,947015,10/01/2016 12:00:00 AM,120,279,239
Western,Wise County,51195,993,2676,3669,1425,6043,7468,120505,712060,832565,05/01/2018 12:00:00 AM,121,266,227
Western,Wise County,51195,995,2951,3946,1381,6880,8261,122323,816004,938327,06/01/2016 12:00:00 AM,123,277,238
Western,Wythe County,51197,302,1559,1861,403,3274,3677,32845,356859,389704,02/01/2020 12:00:00 AM,109,229,209
Western,Wythe County,51197,303,1555,1858,403,3249,3652,33100,347484,380584,01/01/2020 12:00:00 AM,109,223,205
Western,Wythe County,51197,305,1542,1847,386,3228,3614,33204,349809,383013,09/01/2019 12:00:00 AM,109,227,207
Western,Wythe County,51197,305,1577,1882,405,3280,3685,74268,562819,637087,03/01/2020 12:00:00 AM,244,357,339
Western,Wythe County,51197,308,1573,1881,405,3325,3730,33664,358254,391918,12/01/2019 12:00:00 AM,109,228,208
Western,Wythe County,51197,308,1731,2039,374,3615,3989,85551,770884,856435,02/01/2021 12:00:00 AM,278,445,420
Western,Wythe County,51197,310,1559,1869,398,3266,3664,33343,351703,385046,10/01/2019 12:00:00 AM,108,226,206
Western,Wythe County,51197,311,1567,1878,408,3296,3704,33954,350540,384494,11/01/2019 12:00:00 AM,109,224,205
Western,Wythe County,51197,315,1703,2018,425,3542,3967,78679,621566,700245,04/01/2020 12:00:00 AM,250,365,347
Western,Wythe County,51197,315,1712,2027,397,3557,3954,88965,742889,831854,01/01/2021 12:00:00 AM,282,434,410
Western,Wythe County,51197,316,1730,2046,393,3597,3990,78036,646865,724901,12/01/2020 12:00:00 AM,247,374,354
Western,Wythe County,51197,318,1725,2043,403,3586,3989,74552,621119,695671,09/01/2020 12:00:00 AM,234,360,341
Western,Wythe County,51197,319,1532,1851,407,3202,3609,33852,346343,380195,08/01/2019 12:00:00 AM,106,226,205
Western,Wythe County,51197,319,1722,2041,400,3569,3969,76627,666715,743342,11/01/2020 12:00:00 AM,240,387,364
Western,Wythe County,51197,319,1741,2060,400,3611,4011,79003,655604,734607,10/01/2020 12:00:00 AM,248,377,357
Western,Wythe County,51197,321,1529,1850,404,3177,3581,32587,351512,384099,04/01/2019 12:00:00 AM,102,230,208
Western,Wythe County,51197,321,1728,2049,415,3596,4011,76129,623698,699827,08/01/2020 12:00:00 AM,237,361,342
Western,Wythe County,51197,322,1529,1851,419,3209,3628,33413,347700,381113,07/01/2019 12:00:00 AM,104,227,206
Western,Wythe County,51197,322,1722,2044,421,3596,4017,78225,618003,696228,05/01/2020 12:00:00 AM,243,359,341
Western,Wythe County,51197,323,1721,2044,419,3577,3996,77416,622091,699507,06/01/2020 12:00:00 AM,240,361,342
Western,Wythe County,51197,324,1514,1838,410,3152,3562,33576,347193,380769,06/01/2019 12:00:00 AM,104,229,207
Western,Wythe County,51197,324,1739,2063,427,3619,4046,79033,623572,702605,07/01/2020 12:00:00 AM,244,359,341
Western,Wythe County,51197,325,1693,2018,419,3480,3899,97135,788402,885537,04/01/2021 12:00:00 AM,299,466,439
Western,Wythe County,51197,326,1713,2039,413,3542,3955,93430,735556,828986,03/01/2021 12:00:00 AM,287,429,407
Western,Wythe County,51197,327,1497,1824,426,3109,3535,36283,334981,371264,02/01/2019 12:00:00 AM,111,224,204
Western,Wythe County,51197,328,1523,1851,414,3173,3587,34192,354518,388710,05/01/2019 12:00:00 AM,104,233,210
Western,Wythe County,51197,328,1534,1862,425,3213,3638,38999,349415,388414,11/01/2018 12:00:00 AM,119,228,209
Western,Wythe County,51197,328,1546,1874,414,3256,3670,36794,359541,396335,10/01/2018 12:00:00 AM,112,233,211
Western,Wythe County,51197,328,1679,2007,424,3467,3891,97371,785512,882883,05/01/2021 12:00:00 AM,297,468,440
Western,Wythe County,51197,330,1539,1869,422,3185,3607,34211,356329,390540,03/01/2019 12:00:00 AM,104,232,209
Western,Wythe County,51197,332,1544,1876,418,3267,3685,35630,355124,390754,08/01/2018 12:00:00 AM,107,230,208
Western,Wythe County,51197,335,1539,1874,439,3205,3644,38510,360605,399115,01/01/2019 12:00:00 AM,115,234,213
Western,Wythe County,51197,335,1666,2001,425,3400,3825,98852,765404,864256,06/01/2021 12:00:00 AM,295,459,432
Western,Wythe County,51197,336,1553,1889,435,3333,3768,39459,373496,412955,11/01/2017 12:00:00 AM,117,240,219
Western,Wythe County,51197,338,1528,1866,445,3193,3638,40900,347372,388272,12/01/2018 12:00:00 AM,121,227,208
Western,Wythe County,51197,338,1543,1881,431,3302,3733,36445,362293.98,398738.98,03/01/2018 12:00:00 AM,108,235,212
Western,Wythe County,51197,339,1527,1866,435,3241,3676,37979,353739,391718,09/01/2018 12:00:00 AM,112,232,210
Western,Wythe County,51197,339,1532,1871,427,3267,3694,35454,357506,392960,07/01/2018 12:00:00 AM,105,233,210
Western,Wythe County,51197,339,1559,1898,434,3334,3768,39926,377562,417488,10/01/2017 12:00:00 AM,118,242,220
Western,Wythe County,51197,339,1570,1909,434,3403,3837,35352,378056,413408,04/01/2016 12:00:00 AM,104,241,217
Western,Wythe County,51197,340,1513,1853,439,3235,3674,37616,352377,389993,02/01/2018 12:00:00 AM,111,233,210
Western,Wythe County,51197,340,1550,1890,436,3382,3818,36119,374626,410745,05/01/2016 12:00:00 AM,106,242,217
Western,Wythe County,51197,340,1592,1932,446,3506,3952,38210,379464,417674,07/01/2015 12:00:00 AM,112,238,216
Western,Wythe County,51197,341,1553,1894,437,3342,3779,36231,369746,405977,01/01/2018 12:00:00 AM,106,238,214
Western,Wythe County,51197,341,1556,1897,438,3337,3775,39740,389897,429637,07/01/2017 12:00:00 AM,117,251,226
Western,Wythe County,51197,342,1585,1927,452,3491,3943,37787,382055,419842,10/01/2015 12:00:00 AM,110,241,218
Western,Wythe County,51197,343,1546,1889,434,3335,3769,37331,372181,409512,04/01/2018 12:00:00 AM,109,241,217
Western,Wythe County,51197,343,1563,1906,434,3420,3854,34844,380146,414990,06/01/2016 12:00:00 AM,102,243,218
Western,Wythe County,51197,343,1571,1914,443,3368,3811,40582,387124,427706,09/01/2017 12:00:00 AM,118,246,223
Western,Wythe County,51197,343,1594,1937,452,3522,3974,38665,380001,418666,08/01/2015 12:00:00 AM,113,238,216
Western,Wythe County,51197,344,1523,1867,433,3280,3713,35802,357004,392806,05/01/2018 12:00:00 AM,104,234,210
Western,Wythe County,51197,345,1564,1909,448,3345,3793,40438,373786,414224,12/01/2017 12:00:00 AM,117,239,217
Western,Wythe County,51197,345,1570,1915,447,3414,3861,37049,383919,420968,07/01/2016 12:00:00 AM,107,245,220
Western,Wythe County,51197,345,1572,1917,443,3322,3765,40353,384189,424542,03/01/2017 12:00:00 AM,117,244,221
Western,Wythe County,51197,345,1580,1925,453,3453,3906,37343,375768,413111,11/01/2015 12:00:00 AM,108,238,215
Western,Wythe County,51197,346,1568,1914,451,3417,3868,36554,378017,414571,01/01/2016 12:00:00 AM,106,241,217
Western,Wythe County,51197,346,1576,1922,433,3333,3766,38916,393312,432228,04/01/2017 12:00:00 AM,112,250,225
Western,Wythe County,51197,346,1589,1935,451,3467,3918,37143,383481,420624,12/01/2015 12:00:00 AM,107,241,217
Western,Wythe County,51197,347,1560,1907,447,3345,3792,42079,392401,434480,06/01/2017 12:00:00 AM,121,252,228
Western,Wythe County,51197,347,1564,1911,441,3354,3795,40510,392250,432760,05/01/2017 12:00:00 AM,117,251,226
Western,Wythe County,51197,347,1564,1911,452,3375,3827,37215,380219,417434,08/01/2016 12:00:00 AM,107,243,218
Western,Wythe County,51197,347,1564,1911,452,3391,3843,37759,381188,418947,03/01/2016 12:00:00 AM,109,244,219
Western,Wythe County,51197,348,1580,1928,462,3505,3967,39133,378254,417387,09/01/2015 12:00:00 AM,112,239,216
Western,Wythe County,51197,349,1563,1912,439,3342,3781,36819,378972,415791,09/01/2016 12:00:00 AM,105,242,217
Western,Wythe County,51197,349,1569,1918,456,3431,3887,37344,390321,427665,02/01/2016 12:00:00 AM,107,249,223
Western,Wythe County,51197,349,1607,1956,472,3586,4058,41678,389426,431104,04/01/2015 12:00:00 AM,119,242,220
Western,Wythe County,51197,349,1838,2187,468,3960,4428,37831,425405,463236,05/01/2014 12:00:00 AM,108,231,212
Western,Wythe County,51197,350,1526,1876,443,3284,3727,36943,361043,397986,06/01/2018 12:00:00 AM,106,237,212
Western,Wythe County,51197,350,1553,1903,443,3325,3768,38931,377513,416444,10/01/2016 12:00:00 AM,111,243,219
Western,Wythe County,51197,350,1574,1924,450,3361,3811,40949,391271,432220,08/01/2017 12:00:00 AM,117,249,225
Western,Wythe County,51197,350,1874,2224,466,4035,4501,36980,434592,471572,04/01/2014 12:00:00 AM,106,232,212
Western,Wythe County,51197,350,1905,2255,471,4102,4573,38940,439743,478683,02/01/2014 12:00:00 AM,111,231,212
Western,Wythe County,51197,351,1788,2139,467,3888,4355,37425,408660,446085,06/01/2014 12:00:00 AM,107,229,209
Western,Wythe County,51197,351,1899,2250,488,4068,4556,45000,473240,518240,10/01/2013 12:00:00 AM,128,249,230
Western,Wythe County,51197,352,1919,2271,484,4077,4561,44014,472179,516193,09/01/2013 12:00:00 AM,125,246,227
Western,Wythe County,51197,353,1596,1949,479,3560,4039,41834,384715,426549,06/01/2015 12:00:00 AM,119,241,219
Western,Wythe County,51197,354,1611,1965,483,3573,4056,43088,389372,432460,03/01/2015 12:00:00 AM,122,242,220
Western,Wythe County,51197,354,1692,2046,480,3770,4250,43032,405599,448631,10/01/2014 12:00:00 AM,122,240,219
Western,Wythe County,51197,354,1901,2255,479,4088,4567,39642,436201,475843,03/01/2014 12:00:00 AM,112,229,211
Western,Wythe County,51197,355,1674,2029,482,3746,4228,43927,402220,446147,12/01/2014 12:00:00 AM,124,240,220
Western,Wythe County,51197,355,1756,2111,468,3849,4317,36927,404921,441848,07/01/2014 12:00:00 AM,104,231,209
Western,Wythe County,51197,355,1889,2244,493,4066,4559,42038,427811,469849,12/01/2013 12:00:00 AM,118,226,209
Western,Wythe County,51197,356,1725,2081,476,3799,4275,38485,392880,431365,09/01/2014 12:00:00 AM,108,228,207
Western,Wythe County,51197,356,1904,2260,481,4120,4601,39383,432824,472207,01/01/2014 12:00:00 AM,111,227,209
Western,Wythe County,51197,357,1592,1949,481,3560,4041,42620,386822,429442,05/01/2015 12:00:00 AM,119,243,220
Western,Wythe County,51197,357,1593,1950,459,3414,3873,40168,391655,431823,02/01/2017 12:00:00 AM,113,246,221
Western,Wythe County,51197,357,1686,2043,493,3759,4252,45147,408986,454133,11/01/2014 12:00:00 AM,126,243,222
Western,Wythe County,51197,358,1549,1907,460,3330,3790,39458,373140,412598,01/01/2017 12:00:00 AM,110,241,216
Western,Wythe County,51197,358,1730,2088,484,3834,4318,38440,399940,438380,08/01/2014 12:00:00 AM,107,231,210
Western,Wythe County,51197,358,1901,2259,498,4078,4576,42738,432915,475653,11/01/2013 12:00:00 AM,119,228,211
Western,Wythe County,51197,359,1923,2282,485,4107,4592,44543,472352,516895,08/01/2013 12:00:00 AM,124,246,227
Western,Wythe County,51197,360,1542,1902,461,3291,3752,40360,372867,413227,11/01/2016 12:00:00 AM,112,242,217
Western,Wythe County,51197,360,1605,1965,495,3553,4048,44806,379950,424756,02/01/2015 12:00:00 AM,124,237,216
Western,Wythe County,51197,360,1909,2269,509,4088,4597,45588,472154,517742,05/01/2013 12:00:00 AM,127,247,228
Western,Wythe County,51197,361,1898,2259,490,4053,4543,44250,463326,507576,07/01/2013 12:00:00 AM,123,244,225
Western,Wythe County,51197,362,1544,1906,471,3314,3785,42020,372285,414305,12/01/2016 12:00:00 AM,116,241,217
Western,Wythe County,51197,362,1865,2227,517,4006,4523,50048,459157,509205,12/01/2012 12:00:00 AM,138,246,229
Western,Wythe County,51197,362,1914,2276,499,4128,4627,46401,477566,523967,02/01/2013 12:00:00 AM,128,250,230
Western,Wythe County,51197,363,1845,2208,525,3962,4487,51229,455942,507171,08/01/2012 12:00:00 AM,141,247,230
Western,Wythe County,51197,363,1897,2260,502,4106,4608,47427,476746,524173,03/01/2013 12:00:00 AM,131,251,232
Western,Wythe County,51197,363,1903,2266,520,4061,4581,49948,471836,521784,01/01/2013 12:00:00 AM,138,248,230
Western,Wythe County,51197,363,1911,2274,494,4092,4586,45123,472047,517170,06/01/2013 12:00:00 AM,124,247,227
Western,Wythe County,51197,364,1844,2208,522,3940,4462,52193,452622,504815,09/01/2012 12:00:00 AM,143,245,229
Western,Wythe County,51197,365,1819,2184,535,3944,4479,53788,472310,526098,07/01/2012 12:00:00 AM,147,260,241
Western,Wythe County,51197,365,1841,2206,538,3937,4475,50733,457103,507836,06/01/2012 12:00:00 AM,139,248,230
Western,Wythe County,51197,365,1909,2274,508,4105,4613,47429,477702,525131,04/01/2013 12:00:00 AM,130,250,231
Western,Wythe County,51197,367,1860,2227,530,3975,4505,52572,451006,503578,11/01/2012 12:00:00 AM,143,242,226
Western,Wythe County,51197,370,1636,2006,516,3608,4124,45578,383862,429440,01/01/2015 12:00:00 AM,123,235,214
Western,Wythe County,51197,370,1857,2227,534,4001,4535,53393,456442,509835,10/01/2012 12:00:00 AM,144,246,229
Western,Wythe County,51197,370,1864,2234,543,4006,4549,50842,465710,516552,05/01/2012 12:00:00 AM,137,250,231
Western,Wythe County,51197,372,1910,2282,574,4141,4715,55558,479190,534748,03/01/2012 12:00:00 AM,149,251,234
Western,Wythe County,51197,373,1870,2243,564,4059,4623,53594,471248,524842,04/01/2012 12:00:00 AM,144,252,234
Western,Wythe County,51197,387,1930,2317,591,4173,4764,57586,480949,538535,02/01/2012 12:00:00 AM,149,249,232
Western,Wythe County,51197,389,1929,2318,589,4158,4747,57349,477329,534678,01/01/2012 12:00:00 AM,147,247,231
